"a" = (/turf/unsimulated/wall{color = "black"},/area/psionic_school/outdoor)
"d" = (/obj/effect/wallframe_spawn/reinforced,/turf/simulated/floor/plating,/area/psionic_school/outdoor)
"t" = (/obj/structure/fd/placeholder/better{opacity = 0},/obj/effect/wallframe_spawn/reinforced,/turf/simulated/floor/plating,/area/psionic_school/outdoor)
"w" = (/turf/unsimulated/floor/reinforced,/area/psionic_school/outdoor)
"z" = (/turf/unsimulated/floor/exoplanet/grass,/area/psionic_school/outdoor)
"E" = (/turf/simulated/floor/plating,/area/psionic_school/outdoor)
"L" = (/turf/simulated/wall/r_wall/invincible,/area/psionic_school/outdoor)
"M" = (/obj/structure/fd/placeholder/better{opacity = 0},/turf/unsimulated/floor/reinforced,/area/psionic_school/outdoor)
"R" = (/obj/structure/fd/placeholder/better{opacity = 0},/turf/unsimulated/floor/exoplanet/concrete,/area/psionic_school/outdoor)
"T" = (/turf/unsimulated/floor/exoplanet/concrete,/area/psionic_school/outdoor)
"Z" = (/obj/structure/fd/placeholder/better{opacity = 0},/turf/simulated/floor/plating,/area/psionic_school/outdoor)

(1,1,1) = {"
aaaaaaaaaaaaaaaaaaaaaaaaaaaaaaaaaaaaaaaaaaaaaaaaaaaaaaaaaaaaaaaaaaaaaaaaaaaaaaaaaaaaaaaaaaaaaaaaaaaa
aTTTTTTTTTTTTTTTTTTTTTTTTTTTTTTTTTTTTTTTTTTTTTTTTTTTTTTTTTTTTTTTTTTTTTTTTTTTTTTTTTTTTTTTTTTTTTTTTTTa
aTTTTTTTTTTTTTTTTTTTTTTTTTTTTTTTTTTTTTTTTTTTTTTTTTTTTTTTTTTTTTTTTTTTTTTTTTTTTTTTTTTTTTTTTTTTTTTTTTTa
aTTTTTTTTTTTTTTTTTTTTTTTTTTTTTTTTTTTTTTTTTTTTTTTTTTTTTTTTTTTTTTTTTTTTTTTTTTTTTTTTTTTTTTTTTTTTTTTTTTa
aTTTTTTTTTTTTTTTTTTTTTTTTTTTTTTTTTTTTTTTTTTTTTTTTTTTTTTTTTTTTTTTTTTTTTTTTTTTTTTTTTTTTTTTTTTTTTTTTTTa
aTTTTTTTTTTTTTTTTTTTTTTTTTTTTTTTTTTTTTTTTTTTTTTTTTTTTTTTTTTTTTTTTTTTTTTTTTTTTTTTTTTTTTTTTTTTTTTTTTTa
aTTTTTTTTTTTTTTTTTTTTTTTTTTTTTTTTTTTTTTTTTTTTTTTTTTTTTTTTTTTTTTTTTTTTTTTTTTTTTTTTTTTTTTTTTTTTTTTTTTa
aTTTTTTTTTTTTTTTTTTTTTTTTTTTTTTTTTTTTTTTTTTTTTTTTTTTTTTTTTTTTTTTTTTTTTTTTTTTTTTTTTTTTTTTTTTTTTTTTTTa
aTTTTTTTTTTTTTTTTTTTTTTTTTTTTTTTTTTTTTTTTTTTTTTTTTTTTTTTTTTTTTTTTTTTTTTTTTTTTTTTTTTTTTTTTTTTTTTTTTTa
aTTTTTTTTTTTTTTTTTTTTTTTTTTTTTTTTTTTTTTTTTTTTTTTTTTTTTTTTTTTTTTTTTTTTTTTTTTTTTTTTTTTTTTTTTTTTTTTTTTa
aTTTTTTTTTTTTTTTTTTTTTTTTTTTTTTTTTTTTTTTTTTTTTTTTTTTTTTTTTTTTTTTTTTTTTTTTTTTTTTTTTTTTTTTTTTTTTTTTTTa
aTTTTTTTTTTTTTTTTTTTTTTTTTTTTTTTTTTTTTTTTTTTTTTTTTTTTTTTTTTTTTTTTTTTTTTTTTTTTTTTTTTTTTTTTTTTTTTTTTTa
aTTTTTTTTTTTTTTTTTTTTTTTTTTTTTTTTTTTTTTTTTTTTTTTTTTTTTTTTTTTTTTTTTTTTTTTTTTTTTTTTTTTTTTTTTTTTTTTTTTa
aTTTTTTTTTTTTTTTTTTTTTTTTTTTTTTTTTTTTTTTTTTTTTTTTTTTTTTTTTTTTTTTTTTTTTTTTTTTTTTTTTTTTTTTTTTTTTTTTTTa
aTTTTTTTTTTTTTTTTTTTTTTTTTTTTTTTTTTTTTTTTTTTTTTTTTTTTTTTTTTTTTTTTTTTTTTTTTTTTTTTTTTTTTTTTTTTTTTTTTTa
aTTTTTTTTTTTTTTTTTTTTTTTTTTTTTTTTTTTTTTTTTTTTTTTTTTTTTTTTTTTTTTTTTTTTTTTTTTTTTTTTTTTTTTTTTTTTTTTTTTa
aTTTTTTTTTTTTTTTTTTTTTTTTTTTTTTTTTTTTTTTTTTTTTTTTTTTTTTTTTTTTTTTTTTTTTTTTTTTTTTTTTTTTTTTTTTTTTTTTTTa
aTTTTTTTTTTTTTTTTTTTTTTTTTTTTTTTTTTTTTTTTTTTTTTTTTTTTTTTTTTTTTTTTTTTTTTTTTTTTTTTTTTTTTTTTTTTTTTTTTTa
aTTTTTTTTTTTTTTTTTTTTTTTTTTTTTTTTTTTTTTTTTTTTTTTTTTTTTTTTTTTTTTTTTTTTTTTTTTTTTTTTTTTTTTTTTTTTTTTTTTa
aTTTTTTTTTTTTTTTTTTTTTTTTTTTTTTTTTTTTTTTTTTTTTTTTTTTTTTTTTTTTTTTTTTTTTTTTTTTTTTTTTTTTTTTTTTTTTTTTTTa
aTTTTTTTTTTTTTTTTTTTTTTTTTTTTTTTTTTTTTTTTTTTTTTTTTTTTTTTTTTTTTTTTTTTTTTTTTTTTTTTTTTTTTTTTTTTTTTTTTTa
aTTTTTTTTTTTTTTTTTTTTTTTTTTTTTTTTTTTTTTTTTTTTTTTTTTTTTTTTTTTTTTTTTTTTTTTTTTTTTTTTTTTTTTTTTTTTTTTTTTa
aTTTTTTTTTTTTTTTTTTTTTTTTTTTTTTTTTTTTTTTTTTTTTTTTTTTTTTTTTTTTTTTTTTTTTTTTTTTTTTTTTTTTTTTTTTTTTTTTTTa
aTTTTTTTTTTTTTTTTTTTTTTTTTTTTTTTTTTTTTTTTTTTTTTTTTTTTTTTTTTTTTTTTTTTTTTTTTTTTTTTTTTTTTTTTTTTTTTTTTTa
aTTTTTTTTTTTTTTTTTTTTTTTTTTTTTTTTTTTTTTTTTTTTTTTTTTTTTTTTTTTTTTTTTTTTTTTTTTTTTTTTTTTTTTTTTTTTTTTTTTa
aTTTTTTTTTTTTTTTTTTTTTTTTTTTTTTTTTTTTTTTTTTTTTTTTTTTTTTTTTTTTTTTTTTTTTTTTTTTTTTTTTTTTTTTTTTTTTTTTTTa
aTTTTTTTTTTTTTTTTTTTTTTTTTTTTTTTTTTTTTTTTTTTTTTTTTTTTTTTTTTTTTTTTTTTTTTTTTTTTTTTTTTTTTTTTTTTTTTTTTTa
aTTTTTTTTTTTTTTTTTTTTTTTTTTTTTTTTTTTTTTTTTTTTTTTTTTTTTTTTTTTTTTTTTTTTTTTTTTTTTTTTTTTTTTTTTTTTTTTTTTa
aTTTTTTTTTTTTTTTTTTTTTTTTTTTTTTTTTTTTTTTTTTTTTTTTTTTTTTTTTTTTTTTTTTTTTTTTTTTTTTTTTTTTTTTTTTTTTTTTTTa
aTTTTTTTTTTTTTTTTTTTTTTTTTTTTTTTTTTTTTTTTTTTTTTTTTTTTTTTTTTTTTTTTTTTTTTTTTTTTTTTTTTTTTTTTTTTTTTTTTTa
aTTTTTTTTTTTTTTTTTTTTTTTTTTTTTTTTTTTTTTTTTTTTTTTTTTTTTTTTTTTTTTTTTTTTTTTTTTTTTTTTTTTTTTTTTTTTTTTTTTa
aTTTTTTTTTTTTTTTTTTTTTTTTTTTTTTTTTTTTTTTTTTTTTTTTTTTTTTTTTTTTTTTTTTTTTTTTTTTTTTTTTTTTTTTTTTTTTTTTTTa
aTTTTTTTTTTTTTTTTTTTTTTTTTTTTTTTTTTTTTTTTTTTTTTTTTTTTTTTTTTTTTTTTTTTTTTTTTTTTTTTTTTTTTTTTTTTTTTTTTTa
aTTTTTTTTTTTTTTTTTTTTTTTTTTTTTTTTTTTTTTTTTTTTTTTTTTTTTTTTTTTTTTTTTTTTTTTTTTTTTTTTTTTTTTTTTTTTTTTTTTa
aTTTTTTTTTTTTTTTTTTTTTTTTTTTTTTTTTTTTTTTTTTTTTTTTTTTTTTTTTTTTTTTTTTTTTTTTTTTTTTTTTTTTTTTTTTTTTTTTTTa
aTTTTTTTTTTTTTTTTTTTTTTTTTTTTTTTTTTTTTTTTTTTTTTTTTTTTTTTTTTTTTTTTTTTTTTTTTTTTTTTTTTTTTTTTTTTTTTTTTTa
aTTTTTTTTTTTTTTTTTTTTTTTTTTTTTTTTTTTTTTTTTTTTTTTTTTTTTTTTTTTTTTTTTTTTTTTTTTTTTTTTTTTTTTTTTTTTTTTTTTa
aTTTTTTTTTTTTTTTTTTTTTTTTTTTTTTTTTTTTTTTTTTTTTTTTTTTTTTTTTTTTTTTTTTTTTTTTTTTTTTTTTTTTTTTTTTTTTTTTTTa
aTTTTTTTTTTTTTTTTTTTTTTTTTTTTTTTTTTTTTTTTTTTTTTTTTTTTTTTTTTTTTTTTTTTTTTTTTTTTTTTTTTTTTTTTTTTTTTTTTTa
aTTTTTTTTTTTTTTTTTTTTTTTTTTTTTTTTTTTTTTTTTTTTTTTTTTTTTTTTTTTTTTTTTTTTTTTTTTTTTTTTTTTTTTTTTTTTTTTTTTa
aTTTTTTTTTTTTTTTTTTTTTTTTTTTTTTTTTTTTTTTTTTTTTTTTTTTTTTTTTTTTTTTTTTTTTTTTTTTTTTTTTTTTTTTTTTTTTTTTTTa
aTTTTTTTTTTTTTTTTTTTTTTTTTTTTTTTTTTTTTTTTTTTTTTTTTTTTTTTTTTTTTTTTTTTTTTTTTTTTTTTTTTTTTTTTTTTTTTTTTTa
aTTTTTTTTTTTTTTTTTTTTTTTTTTTTTTTTTTTTTTTTTTTTTTTTTTTTTTTTTTTTTTTTTTTTTTTTTTTTTTTTTTTTTTTTTTTTTTTTTTa
aTTTTTTTTTTTTTTTTTTTTTTTTTTTTTTTTTTTTTTTTTTTTTTTTTTTTTTTTTTTTTTTTTTTTTTTTTTTTTTTTTTTTTTTTTTTTTTTTTTa
aTTTTTTTTTTTTTTTTTTTTTTTTTTTTTTTTTTTTTTTTTTTTTTTTTTTTTTTTTTTTTTTTTTTTTTTTTTTTTTTTTTTTTTTTTTTTTTTTTTa
aTTTTTTTTTTTTTTTTTTTTTTTTTTTTTTTTTTTTTTTTTTTTTTTTTTTTTTTTTTTTTTTTTTTTTTTTTTTTTTTTTTTTTTTTTTTTTTTTTTa
aTTTTTTTTTTTTTTTTTTTTTTTTTTTTTTTTTTTTTTTTTTTTTTTTTTTTTTTTTTTTTTTTTTTTTTTTTTTTTTTTTTTTTTTTTTTTTTTTTTa
aTTTTTTTTTTTTTTTTTTTTTTTTTTTTTTTTTTTTTTTTTTTTTTTTTTTTTTTTTTTTTTTTTTTTTTTTTTTTTTTTTTTTTTTTTTTTTTTTTTa
aTTTTTTTTTTTTTTTTTTTTTTTTTTTTTTTTTTTTTTTTTTTTTTTTTTTTTTTTTTTTTTTTTTTTTTTTTTTTTTTTTTTTTTTTTTTTTTTTTTa
aTTTTTTTTTTTTTTTTTTTTTTTTTTTTTTTTTTTTTTTTTTTTTTTTTTTTTTTTTTTTTTTTTTTTTTTTTTTTTTTTTTTTTTTTTTTTTTTTTTa
aTTTTTTTTTTTTTTTTTTTTTTTTTTTTTTTTTTTTTTTTTTTTwwwwwwwwwwwwwwwwwwwwwwwwwwwwwwTTTTTTTTTTTTTTTTTTTTTTTTa
aTTTTTTTTTTTTTTTTTTTTTTTTTTTTTTTTTTTTTTTTTwwwwwwwwwwwwwwwwwwwwwwwwwwwwwwwwwwwwTTTTTTTTTTTTTTTTTTTTTa
aTTTTTTTTTTTTTTTTTTTTTTTTTTTTTTTTTTTTTTwwwwwwwwwwwwwwwwwwwwwwwwwwwwwwwwwwwwwwwwwwTTTTTTTTTTTTTTTTTTa
awwwwwwwwwwwwwwwwwwwwwwwwwwwwwwwwwwwwwwwwwwwwwwwwwwwwwwwwwwwwwwwwwwwwwwwwwwwwwwwwwwwwwwwwwwwwwwwwwwa
awwwwwwwwwwwwwwwwwwwwwwwwwwwwwwwwwwwwwwwwwwwwwTTTTTTTTTTTTTTTTTTTTTTTTTTTTwwwwwwwwwwwwwwwwwwwwwwwwwa
awwwwwwwwwwwwwwwwwwwwwwwwwwwwwwwwwwwwwwwwwwTTTTzzzzzzzzzzzzzzzzzzzzzzzzzzTTTTwwwwwwwwwwwwwwwwwwwwwwa
awwwwwwwwwwwwwwwwwwwwwwwwwwwwwwwwwwwwwwwTTTTzzzzzzzzzzzzzzzzzzzzzzzzzzzzzzzzTTTTwwwwwwwwwwwwwwwwwwwa
aTTTTTTTTTTTTTTTTTTTTTTTTTTTTTTTTTwwwwwTTTTzzzzzzzzzzzzzzzzzzzzzzzzzzzzzzzzzzTTTTwwwwwTTTTTTTTTTTTTa
awwwwwwwwwwwwwwwwwwwwwwwwwwwwwwwwwwwwwwwTTTTzzzzzzzzzzzzzzzzzzzzzzzzzzzzzzzzTTTTwwwwwwwwwwwwwwwwwwwa
awwwwwwwwwwwwwwwwwwwwwwwwwwwwwwwwwwwwwwwwwwTTTTzzzzzzzzzzzzzzzzzzzzzzzzzzTTTTwwwwwwwwwwwwwwwwwwwwwwa
awwwwwwwwwwwwwwwwwwwwwwwwwwwwwwwwwwwwwwwwwwwwwTTTTTTTTTTTTTTTTTTTTTTTTTTTTwwwwwwwwwwwwwwwwwwwwwwwwwa
awwwwwwwwwwwwwwwwwwwwwwwwwwwwwwwwwwwwwwwwwwwwwwwwwwwwwwwwwwwwwwwwwwwwwwwwwwwwwwwwwwwwwwwwwwwwwwwwwwa
aTTTTTTTTTTTTTTTTwwwwwwTTTTTTTTTTTTTTTTwwwwwwwwwwwwwwwwwwwwwwwwwwwwwwwwwwwwwwwwwwTTTTTTTTTTTTTTTTTTa
aTTTTTTTTTTTTTTTTTwwwwTTTTTTTTTTTTTTTTTTTTwwwwwwwwwwwwwwwwwwwwwwwwwwwwwwwwwwwwTTTTTTTTTTTTTTTTTTTTTa
aLLLLLLLLLLLLLLLRRMMMMRRLLLLLLLLLLLLLLLLRRLRRMMMMMwwwwwwwwwwwwwwwwwwwwwwwwwTTTTTTTTTTLLLLLLLLLLLLLLa
aaaaaaaaaaaaaaaLzTwwwwTTLEEEEEEEEEELEEEdTTTTTwwTTRTTTTTTTTTTTTTTTTTTTTTTTTTTTTTTTTTTTLaaaaaaaaaaaaaa
aaaaaaaaaaaaaaatzTwwwwTTLEEEEEEEEEEEEEEdTTTTTwwTTLLLLLLLLLLLLLLLLTLLLLLLLLLLLLLLLLLTTLaaaaaaaaaaaaaa
aaaaaaaaaaaaaaatzTwwwwTTLEELLLLLLEELEEEdTTTTTwwTTLaaaaaaaaaaaaaaLTLaaaaaaaaaaaaaaaLTTLaaaaaaaaaaaaaa
aaaaaaaaaaaaaaaLzTwwwwTTLEELaaaaLEELEEELEELTTwwTTLaaaaaaaaaaaaaaLTLaaaaaaaaaaaaaaaLTTLaaaaaaaaaaaaaa
aaaaaaaaaaaaaaaLzTwwwwTTLEELLLLLLEEdEEEEEELTTwwTTLLLLZLLaaLLLZLLLTLaaaaaaaaaaaaaaaLTTLaaaaaaaaaaaaaa
aaaaaaaaaaaaaaatzTwwwwTTLEELEEEELEELEEEEEELTTwwTTLEEEEELaaLEEEEELTLaaaaaaaaaaaaaaaLTTLaaaaaaaaaaaaaa
aaaaaaaaaaaaaaatzTwwwwTTLEEdEEEELEEdEEEEEELTTwwTTLEEEEELaaLEEEEELTLaaaaaaaaaaaaaaaLTTLaaaaaaaaaaaaaa
aaaaaaaaaaaaaaaLzTwwwwTTLEEEEEEELEELEEEEEELTTwwTTLEEEEELaaLEEEEELTLaaaaaaaaaaaaaaaLTTLaaaaaaaaaaaaaa
aaaaaaaaLLLLLLLLTTwwwwTTLEELEEEELEELEEEEEELTTwwTTLLEEELLLLLLEEELLTLLLLLLLLLLLLLLLLLTTLaaaaaaaaaaaaaa
aaaaaaaaLTTTTTTRTTwwwwTTLLLLLLLLLEELLLLdEELTTwwTTTTTTTTTTTTTTTTTRTTTTTTTTTTTTTTTTTTTTLaaaaaaaaaaaaaa
aaaaaaaaLTLLLLLLTTwwwwTTLEEEEEEELEEEEEEEEELzTwwTTTTTTTTTTTTTTTTTRTTTTTTTTTTTTTTTTTTTTLaaaaaaaaaaaaaa
aaaaaaaaLTLEEEELTTwwwwTTLEEEEEEEdEEEEEEEEEdzTwwwwwwwwwwwwwwwwwwwMwwwwwwwwwwwwwwwwwwTTLaaaaaaaaaaaaaa
aLLLLLLLLTLEEEEETTwwwwTTLEEEEEEEdEEEEEEEEEdzTwwwwwwwwwwwwwwwwwwwMwwwwwwwwwwwwwwwwwwTTLaaaaaaaaaaaaaa
aTTTTTTTTTLEEEEETTwwwwTTLEEEEEEELEEEEEEEEELzTTTTTwwTTTTTTTTTTTTTRTTTTTTTTTTTTTTTwwwTTLaaaaaaaaaaaaaa
aTTTTTTTTTLZLEEETTwwwwTTLLLLdLELLEEEEEEEEELLLLLTTwwTTTTTTTTTTTTTRTTTTzzzTTzzzTTTTwwTTLaaaaaaaaaaaaaa
aLLLLLLLTTLaLEEETTwwwwTTLLLEEEEEEEEEEEEEEELaaaLTTwwTTLLLLLLLLLLLLTTLLtttLLtttLLTTwwTTLaaaaaaaaaaaaaa
aaaaaaaLTTLaLEELTTwwwwTTLLEEEEEEEEEEEEEEEEZaaaLTTwwTTEEEEELaaaaaLTTLaaaaaaaaaaLTTwwTTLLLLLLLLLLLLLLa
aaaaaaaLTTLLLLLLTTwwwwTTLLEEEEEEEEEEEEEEEELaaaLTTwwTTEEEEELaaaaaLTTLaaaaaaaaaaLTTwwTTTTTTTTTTTTTTTTa
aaaaaaaLTTTTTTTRTTwwwwTTLLLLLLLLLLLLLLLLLLLLLLLTTwwTTEEEEEZaaaaaLTTLaaaaaaaaaaLTTwwwTTTTTTTTTTTTTTTa
aaaaaaaLTTTTTTTRTTwwwwTTTTTTTTTTTTTTTTTTTTTTTTTTTwwTTEEEEELaaaaaLTTLaaaaaaaaaaLTTwwwwwwwwwwwwwwwwwwa
aaaaaaaLLLLLLLLLTTwwwwwTTTTTTTTTTTTTTTTTTTTTTTTTwwwTTLLLLLLaaaaaLTTLaaaaaaaaaaLTTwwwwwwwwwwwwwwwwwwa
aaaaaaaaaaaaaaaLzTwwwwwwwwwwwwwwwwwwwwwwwwwwwwwwwwwTTEEEEELaaaaaLTTLaaaaaaaaaaLTTTTTTTTTTTTTTTTTTTTa
aaaaaaaaaaaaaaatzTwwwwwwwwwwwwwwwwwwwwwwwwwwwwwwwwwTTEEEEELaaaaaLTTLaaaaaaaaaaLTTTTTTTTTTTTTTTTTTTTa
aaaaaaaaaaaaaaatzTwwwwwTTTTTTTTTTTTTTTTTTTTTTTTTTTTTTEEEEELaaaaaLTTLaaaaaaaaaaLLLLLLLLTTTLLLLLLLLLLa
aaaaaaaaaaaaaaaLzTwwwwTTTTTTTTTTTTTTTTTTTTTTTTTTTTTTTEEEEELaaaaaLTTLaaaaaaaaaaaaaaaaaLTTTLaaaaaaaaaa
aaaaaaaaaaaaaaaLTTwwwwTTLLLLLLLLLEEEELLRRRLLELddLLLLLLLLZLLaaaaaLTTLaaaaaaaaaaaaaaaaaLTTTLaaaaaaaaaa
aaaaaaaaaaaaaaaLTTwwwwTTLaaaaaaLEEEEEELTTTLEEEEEELEEELaaaaaaaaaaLTTLaaaaaaaaaaaaaaaaaLTTTLaaaaaaaaaa
aaaaaaaaaaaaaaaLTTwwwwTTtaaaaaaZEEEEEELTTTLEEEEEELEEELaaaaaaaaaaLTTLaaaaaaaaaaaaaaaaaLTTTLaaaaaaaaaa
aaaaaaaaaaaaaaaLTTwwwwTTLaaaaaaLEEEEEELTTTtEEEEEELEEELaaaaaaaaaaLTTLaaaaaaaaaaaaaaaaaLTTTLaaaaaaaaaa
aaaaaaaaaaaaaaaLTTwwwwTTLaaaaaaLLEEEEELTTTtEEELEELEEELaaaaaaaaaaLTTLaaaaaaaaaaaaaaaaaLTTTLaaaaaaaaaa
aaaaaaaaaaaaaaaLzTwwwwTTLaaaaaaaLLLLLLLTTTtEEEEEELEEELaaaaaaaaaaLTTLaaaaaaaaaaaaaaaaaLTTTLaaaaaaaaaa
aaaaaaaaaaaaaaatzTwwwwTTLaaaaaaaaaaaaaLTTTLEEEEEEEEEELaaaaaaaaaaLTTLaaaaaaaaaaaaaaaaaLTTTLaaaaaaaaaa
aaaaaaaaaaaaaaatzTwwwwTTtaaaaaaaaaaaaaLTTTLEEEEEELEEELaaaaaaaaaaLTTLaaaaaaaaaaaaaaaaaLTTTLaaaaaaaaaa
aaaaaaaaaaaaaaaLzTwwwwTTLaaaaaaaaaaaaaLTTTLLLLLLLLLLLLaaaaaaaaaaLTTLaaaaaaaaaaaaaaaaaLTTTLaaaaaaaaaa
aaaaaaaaaaaaaaaaaaaaaaaaaaaaaaaaaaaaaaaaaaaaaaaaaaaaaaaaaaaaaaaaaaaaaaaaaaaaaaaaaaaaaaaaaaaaaaaaaaaa
"}
