"a" = (/turf/simulated/wall/r_wall/invincible/prepainted,/area/template_noop)
"b" = (/turf/simulated/floor/tiled,/area/template_noop)
"g" = (/obj/effect/floor_decal/corner/blue{dir = 8},/turf/simulated/floor/tiled,/area/template_noop)
"j" = (/obj/structure/bed/chair/comfy/blue{dir = 8},/obj/effect/floor_decal/corner/blue{dir = 6},/turf/simulated/floor/tiled,/area/template_noop)
"k" = (/obj/structure/table/standard,/obj/effect/floor_decal/corner/blue/three_quarters{dir = 1},/turf/simulated/floor/tiled,/area/template_noop)
"m" = (/obj/structure/holoplant,/obj/effect/floor_decal/corner/blue/three_quarters,/turf/simulated/floor/tiled,/area/template_noop)
"n" = (/obj/random/facility/mercenary/low,/turf/simulated/floor/tiled,/area/template_noop)
"o" = (/obj/machinery/light/small{dir = 1},/turf/simulated/floor/tiled/steel_grid,/area/template_noop)
"y" = (/obj/machinery/door/airlock/civilian,/turf/simulated/floor/tiled/steel_ridged,/area/template_noop)
"z" = (/turf/simulated/floor/tiled/steel_grid,/area/template_noop)
"G" = (/obj/machinery/light/small{dir = 8},/obj/effect/floor_decal/corner/blue{dir = 10},/turf/simulated/floor/tiled,/area/template_noop)
"H" = (/obj/random/vendor,/obj/machinery/light/small{dir = 1},/obj/effect/floor_decal/industrial/outline/yellow,/turf/simulated/floor/tiled/monotile,/area/template_noop)
"M" = (/obj/machinery/light/small,/obj/effect/floor_decal/corner/blue{dir = 9},/turf/simulated/floor/tiled,/area/template_noop)
"N" = (/obj/structure/holoplant{pixel_y = 9},/obj/machinery/light/small{dir = 4},/obj/effect/floor_decal/corner/blue{dir = 5},/turf/simulated/floor/tiled,/area/template_noop)
"O" = (/obj/effect/floor_decal/corner/blue{dir = 8},/obj/random/trash,/turf/simulated/floor/tiled,/area/template_noop)
"P" = (/obj/structure/table/standard,/obj/effect/floor_decal/corner/blue{dir = 5},/obj/random/junkyard/medical/lite,/turf/simulated/floor/tiled,/area/template_noop)
"T" = (/turf/unsimulated/mineral{color = "#000000"; name = "void"},/area/template_noop)
"U" = (/obj/effect/floor_decal/corner/blue{dir = 4},/obj/random/trash,/turf/simulated/floor/tiled,/area/template_noop)
"W" = (/obj/machinery/light/small,/turf/simulated/floor/tiled/steel_grid,/area/template_noop)

(1,1,1) = {"
TTaayaaTTT
TTTazHaaaT
TTTazUPkaT
aTTazbnjaa
aaaaaWbUNa
yzzoaazzzy
aGOnzaaaaa
aamgzaTTTa
TaaMzaTTTT
TTaayaaTTT
"}
