"a" = (/turf/simulated/wall/r_wall/invincible/prepainted,/area/template_noop)
"b" = (/obj/structure/railing/mapped{dir = 8; icon_state = "railing0-1"},/turf/space,/area/template_noop)
"c" = (/obj/effect/floor_decal/corner/blue/half{dir = 4},/obj/effect/floor_decal/borderfloorblack{dir = 8},/turf/simulated/floor/tiled/dark/monotile,/area/template_noop)
"d" = (/obj/effect/floor_decal/corner/blue/half{dir = 4},/obj/effect/floor_decal/borderfloorblack{dir = 8},/obj/machinery/light/small{dir = 8},/turf/simulated/floor/tiled/dark/monotile,/area/template_noop)
"f" = (/obj/effect/floor_decal/corner/blue/half{dir = 8},/obj/effect/floor_decal/borderfloorblack{dir = 4},/obj/machinery/light/small{dir = 4; icon_state = "bulb1"},/turf/simulated/floor/tiled/dark/monotile,/area/template_noop)
"g" = (/obj/effect/floor_decal/corner/blue/half{dir = 4},/obj/effect/floor_decal/borderfloorblack{dir = 8},/obj/effect/decal/cleanable/dirt,/turf/simulated/floor/tiled/dark/monotile,/area/template_noop)
"i" = (/obj/structure/railing/mapped,/obj/structure/railing/mapped{dir = 4},/turf/space,/area/template_noop)
"j" = (/obj/structure/window/reinforced/crescent,/turf/simulated/floor/tiled/dark,/area/template_noop)
"k" = (/obj/structure/railing/mapped{dir = 1; icon_state = "railing0-1"},/obj/structure/railing/mapped{dir = 4},/turf/space,/area/template_noop)
"l" = (/obj/structure/holoplant{pixel_y = 10},/obj/effect/floor_decal/corner/blue{dir = 8},/obj/effect/floor_decal/borderfloorblack{dir = 5},/turf/simulated/floor/tiled/dark/monotile,/area/template_noop)
"n" = (/obj/structure/window/reinforced/crescent{dir = 8},/turf/simulated/floor/tiled/dark,/area/template_noop)
"o" = (/obj/effect/floor_decal/corner/blue/half{dir = 1},/obj/effect/floor_decal/borderfloorblack,/obj/machinery/light/small,/obj/effect/decal/cleanable/dirt,/turf/simulated/floor/tiled/dark/monotile,/area/template_noop)
"p" = (/obj/effect/floor_decal/corner/blue/half,/obj/effect/floor_decal/borderfloorblack{dir = 1},/obj/machinery/light/small{dir = 1},/obj/effect/decal/cleanable/dirt,/turf/simulated/floor/tiled/dark/monotile,/area/template_noop)
"q" = (/obj/structure/railing/mapped{dir = 1; icon_state = "railing0-1"},/turf/space,/area/template_noop)
"r" = (/obj/structure/window/reinforced/crescent,/obj/effect/decal/cleanable/dirt,/turf/simulated/floor/tiled/dark,/area/template_noop)
"s" = (/obj/effect/decal/cleanable/dirt,/turf/simulated/floor/tiled/dark,/area/template_noop)
"t" = (/obj/effect/decal/cleanable/dirt,/obj/random/facility/mercenary/medium,/turf/simulated/floor/tiled/dark,/area/template_noop)
"u" = (/obj/structure/window/reinforced/crescent{dir = 1},/obj/effect/decal/cleanable/dirt,/turf/simulated/floor/tiled/dark,/area/template_noop)
"v" = (/obj/effect/floor_decal/corner/blue/half,/obj/effect/floor_decal/borderfloorblack{dir = 1},/obj/effect/decal/cleanable/dirt,/turf/simulated/floor/tiled/dark/monotile,/area/template_noop)
"y" = (/obj/effect/floor_decal/corner/blue/half{dir = 1},/obj/effect/floor_decal/borderfloorblack,/obj/effect/decal/cleanable/dirt,/turf/simulated/floor/tiled/dark/monotile,/area/template_noop)
"z" = (/obj/effect/floor_decal/corner/blue,/obj/effect/floor_decal/borderfloorblack{dir = 9},/turf/simulated/floor/tiled/dark/monotile,/area/template_noop)
"A" = (/turf/space,/area/template_noop)
"B" = (/obj/structure/window/reinforced/crescent{dir = 4},/turf/simulated/floor/tiled/dark,/area/template_noop)
"C" = (/obj/effect/floor_decal/corner/blue/half{dir = 8},/obj/effect/floor_decal/borderfloorblack{dir = 4},/obj/machinery/light/small{dir = 4; icon_state = "bulb1"},/obj/effect/decal/cleanable/dirt,/turf/simulated/floor/tiled/dark/monotile,/area/template_noop)
"D" = (/obj/machinery/door/airlock/glass/civilian,/turf/simulated/floor/tiled/dark/monotile,/area/template_noop)
"G" = (/turf/simulated/floor/tiled/dark,/area/template_noop)
"H" = (/obj/structure/railing/mapped{dir = 4},/turf/space,/area/template_noop)
"I" = (/obj/structure/railing/mapped{dir = 8; icon_state = "railing0-1"},/obj/structure/railing/mapped,/turf/space,/area/template_noop)
"J" = (/obj/structure/window/reinforced/crescent{dir = 1},/turf/simulated/floor/tiled/dark,/area/template_noop)
"K" = (/obj/structure/railing/mapped,/turf/space,/area/template_noop)
"L" = (/obj/effect/floor_decal/corner/blue{dir = 1},/obj/effect/floor_decal/borderfloorblack{dir = 6},/turf/simulated/floor/tiled/dark/monotile,/area/template_noop)
"M" = (/obj/effect/floor_decal/corner/blue/half,/obj/effect/floor_decal/borderfloorblack{dir = 1},/obj/machinery/light/small{dir = 1},/turf/simulated/floor/tiled/dark/monotile,/area/template_noop)
"O" = (/obj/effect/floor_decal/corner/blue/half{dir = 8},/obj/effect/floor_decal/borderfloorblack{dir = 4},/turf/simulated/floor/tiled/dark/monotile,/area/template_noop)
"P" = (/obj/structure/railing/mapped{dir = 1; icon_state = "railing0-1"},/obj/structure/railing/mapped{dir = 8; icon_state = "railing0-1"},/turf/space,/area/template_noop)
"Q" = (/obj/effect/floor_decal/corner/blue/half{dir = 1},/obj/effect/floor_decal/borderfloorblack,/obj/machinery/light/small,/turf/simulated/floor/tiled/dark/monotile,/area/template_noop)
"R" = (/obj/effect/floor_decal/corner/blue/half,/obj/effect/floor_decal/borderfloorblack{dir = 1},/turf/simulated/floor/tiled/dark/monotile,/area/template_noop)
"T" = (/obj/structure/window/reinforced/crescent{dir = 8},/obj/effect/decal/cleanable/dirt,/turf/simulated/floor/tiled/dark,/area/template_noop)
"Y" = (/obj/structure/holoplant,/obj/effect/floor_decal/corner/blue{dir = 4},/obj/effect/floor_decal/borderfloorblack{dir = 10},/turf/simulated/floor/tiled/dark/monotile,/area/template_noop)
"Z" = (/obj/effect/floor_decal/corner/blue/half{dir = 1},/obj/effect/floor_decal/borderfloorblack,/turf/simulated/floor/tiled/dark/monotile,/area/template_noop)

(1,1,1) = {"
aaaaDaaaaa
azvpvRMRla
agtjrrjGOa
adBPqqknfa
acBbAAHnOa
DcBbAAHnOD
adBIKKiTCa
acGuJJJsOa
aYyoZZQyLa
aaaaDaaaaa
"}
