"b" = (/obj/effect/floor_decal/corner/blue{dir = 9},/turf/simulated/floor/tiled,/area/template_noop)
"c" = (/turf/simulated/wall/r_wall/invincible/prepainted,/area/template_noop)
"f" = (/obj/random/trash,/turf/simulated/floor/tiled/steel_grid,/area/template_noop)
"h" = (/turf/simulated/floor/tiled/steel_ridged,/area/template_noop)
"k" = (/obj/random/trash,/obj/effect/floor_decal/corner/blue{dir = 6},/turf/simulated/floor/tiled,/area/template_noop)
"x" = (/obj/effect/floor_decal/corner/blue/half{dir = 4},/turf/simulated/floor/tiled/steel_ridged,/area/template_noop)
"y" = (/turf/simulated/floor/tiled/steel_grid,/area/template_noop)
"C" = (/obj/effect/floor_decal/corner/blue/half{dir = 8},/turf/simulated/floor/tiled/steel_ridged,/area/template_noop)
"E" = (/obj/machinery/light/small{dir = 8},/obj/effect/floor_decal/corner/blue{dir = 9},/turf/simulated/floor/tiled,/area/template_noop)
"G" = (/turf/unsimulated/mineral{color = "#000000"; name = "void"},/area/template_noop)
"N" = (/obj/effect/floor_decal/corner/blue{dir = 6},/turf/simulated/floor/tiled,/area/template_noop)
"O" = (/obj/machinery/light/small{dir = 4},/obj/effect/floor_decal/corner/blue{dir = 6},/turf/simulated/floor/tiled,/area/template_noop)
"T" = (/obj/random/trash,/obj/effect/floor_decal/corner/blue{dir = 9},/turf/simulated/floor/tiled,/area/template_noop)
"V" = (/obj/random/facility/mercenary/medium,/turf/simulated/floor/tiled/steel_grid,/area/template_noop)

(1,1,1) = {"
GGcChxcGGG
GGcbyNcGGG
GGcEykcGGG
GGcbyOcGGG
GGcTVNcGGG
GGcbykcGGG
GGcEyNcGGG
GGcbfOcGGG
GGcbyNcGGG
GGcChxcGGG
"}
