"a" = (/turf/unsimulated/mineral{color = "#000000"; name = "void"},/area/template_noop)
"b" = (/obj/effect/floor_decal/corner/blue{dir = 5},/turf/simulated/floor/tiled,/area/template_noop)
"c" = (/turf/simulated/wall/r_wall/invincible/prepainted,/area/template_noop)
"d" = (/obj/machinery/door/airlock/hatch,/turf/simulated/floor/tiled/steel_ridged,/area/template_noop)
"f" = (/obj/random/trash,/turf/simulated/floor/tiled/steel_grid,/area/template_noop)
"g" = (/obj/effect/floor_decal/corner/blue{dir = 10},/turf/simulated/floor/tiled,/area/template_noop)
"h" = (/turf/simulated/floor/tiled/steel_ridged,/area/template_noop)
"k" = (/obj/structure/table/rack,/obj/effect/floor_decal/industrial/outline/yellow,/turf/simulated/floor/plating,/area/template_noop)
"l" = (/obj/structure/railing/mapped{dir = 4},/obj/random/maintenance,/obj/effect/floor_decal/industrial/outline/yellow,/obj/random/trash,/turf/simulated/floor/plating,/area/template_noop)
"r" = (/obj/effect/floor_decal/corner/blue/half,/turf/simulated/floor/tiled/steel_ridged,/area/template_noop)
"w" = (/obj/structure/catwalk,/obj/machinery/light/small/red,/turf/simulated/floor/plating,/area/template_noop)
"y" = (/turf/simulated/floor/tiled/steel_grid,/area/template_noop)
"z" = (/obj/random/maintenance,/obj/random/maintenance,/obj/structure/table/rack,/obj/effect/floor_decal/industrial/outline/yellow,/turf/simulated/floor/plating,/area/template_noop)
"D" = (/obj/effect/floor_decal/corner/blue/half,/obj/random/trash,/turf/simulated/floor/tiled/steel_ridged,/area/template_noop)
"E" = (/obj/effect/floor_decal/corner/blue{dir = 5},/obj/machinery/light/small{dir = 1},/turf/simulated/floor/tiled,/area/template_noop)
"G" = (/turf/unsimulated/mineral,/area/template_noop)
"H" = (/obj/structure/table/rack,/obj/random/maintenance,/obj/random/maintenance,/obj/effect/floor_decal/industrial/outline/yellow,/turf/simulated/floor/plating,/area/template_noop)
"M" = (/obj/structure/railing/mapped{dir = 8; icon_state = "railing0-1"},/obj/effect/floor_decal/industrial/outline/yellow,/obj/random/trash,/turf/simulated/floor/plating,/area/template_noop)
"P" = (/obj/effect/floor_decal/corner/blue{dir = 10},/obj/random/trash,/turf/simulated/floor/tiled,/area/template_noop)
"T" = (/obj/structure/catwalk,/turf/simulated/floor/plating,/area/template_noop)
"V" = (/turf/simulated/mineral/random,/area/template_noop)
"W" = (/obj/random/facility/mercenary/low,/turf/simulated/floor/tiled/steel_grid,/area/template_noop)
"X" = (/obj/effect/floor_decal/corner/blue/half{dir = 1},/obj/random/trash,/turf/simulated/floor/tiled/steel_ridged,/area/template_noop)
"Y" = (/obj/effect/floor_decal/corner/blue/half{dir = 1},/turf/simulated/floor/tiled/steel_ridged,/area/template_noop)

(1,1,1) = {"
aaaaaaaaaa
ccccccccca
cHTTwTTTca
ccdccccdcc
XEbbVVbbEY
hWyVVVVfyh
rPgVVVVggD
ccdcVVcdcc
acwMzklwca
accGGGGcca
"}
