"a" = (/obj/effect/floor_decal/corner/blue{dir = 5},/obj/machinery/light/small{dir = 1},/obj/effect/decal/cleanable/dirt,/turf/simulated/floor/tiled,/area/template_noop)
"b" = (/obj/effect/floor_decal/corner/blue{dir = 5},/obj/effect/decal/cleanable/dirt,/turf/simulated/floor/tiled,/area/template_noop)
"c" = (/turf/simulated/wall/r_wall/invincible/prepainted,/area/template_noop)
"h" = (/obj/effect/decal/cleanable/dirt,/turf/simulated/floor/tiled/steel_ridged,/area/template_noop)
"i" = (/obj/random/trash,/obj/effect/floor_decal/corner/blue{dir = 8},/obj/effect/decal/cleanable/dirt,/turf/simulated/floor/tiled/steel_grid,/area/template_noop)
"j" = (/obj/effect/floor_decal/corner/blue{dir = 5},/obj/random/trash,/turf/simulated/floor/tiled,/area/template_noop)
"m" = (/turf/unsimulated/mineral{color = "#000000"; name = "void"},/area/template_noop)
"n" = (/obj/effect/floor_decal/corner/blue{dir = 10},/obj/effect/decal/cleanable/dirt,/turf/simulated/floor/tiled/steel_grid,/area/template_noop)
"o" = (/obj/effect/floor_decal/corner/blue,/obj/effect/decal/cleanable/dirt,/turf/simulated/floor/tiled/steel_grid,/area/template_noop)
"y" = (/obj/effect/floor_decal/corner/blue/half,/obj/effect/decal/cleanable/dirt,/turf/simulated/floor/tiled/steel_ridged,/area/template_noop)
"A" = (/obj/effect/catwalk_plated,/turf/simulated/floor/plating,/area/template_noop)
"D" = (/obj/effect/catwalk_plated,/obj/effect/decal/cleanable/dirt,/turf/simulated/floor/plating,/area/template_noop)
"G" = (/obj/effect/floor_decal/corner/blue{dir = 10},/obj/random/trash,/obj/effect/decal/cleanable/dirt,/turf/simulated/floor/tiled/steel_grid,/area/template_noop)
"J" = (/obj/machinery/light/small{dir = 1},/obj/effect/floor_decal/corner/blue{dir = 5},/obj/effect/decal/cleanable/dirt,/turf/simulated/floor/tiled,/area/template_noop)
"K" = (/obj/effect/floor_decal/corner/blue{dir = 5},/turf/simulated/floor/tiled,/area/template_noop)
"M" = (/obj/effect/floor_decal/corner/blue/three_quarters{dir = 4},/obj/machinery/light/small,/obj/effect/decal/cleanable/dirt,/turf/simulated/floor/tiled,/area/template_noop)
"P" = (/obj/effect/floor_decal/corner/blue{dir = 5},/obj/effect/decal/cleanable/dirt,/obj/random/facility/mercenary/high,/turf/simulated/floor/tiled,/area/template_noop)
"T" = (/obj/effect/floor_decal/corner/blue/half{dir = 1},/turf/simulated/floor/tiled/steel_ridged,/area/template_noop)
"U" = (/obj/effect/floor_decal/corner/blue/three_quarters,/obj/machinery/light/small,/turf/simulated/floor/tiled,/area/template_noop)
"W" = (/obj/random/facility/hallway_room,/turf/simulated/wall/r_wall/invincible/prepainted,/area/template_noop)
"X" = (/obj/effect/floor_decal/corner/blue/half,/turf/simulated/floor/tiled/steel_ridged,/area/template_noop)

(1,1,1) = {"
mmmmmmmmmm
mmmmmmmmmm
mmmmmmmmmm
Wccccccccc
TjabPKbJKT
hoDAGnDDih
XMccccccUy
cccmmmmccc
cmmmmmmmmc
mmmmmmmmmm
"}
