"a" = (/obj/effect/floor_decal/corner/blue{dir = 5},/obj/machinery/light/small{dir = 1},/turf/simulated/floor/tiled,/area/template_noop)
"b" = (/obj/effect/floor_decal/corner/blue/half,/turf/simulated/floor/tiled/steel_ridged,/area/template_noop)
"d" = (/obj/effect/floor_decal/corner/blue{dir = 6},/obj/structure/extinguisher_cabinet{pixel_x = 32},/obj/structure/filingcabinet/chestdrawer,/turf/simulated/floor/tiled/dark,/area/template_noop)
"f" = (/turf/simulated/floor/tiled/dark,/area/template_noop)
"g" = (/obj/machinery/computer/modular/preset/civilian,/obj/effect/floor_decal/corner/blue/half{dir = 1},/turf/simulated/floor/tiled/dark/monotile,/area/template_noop)
"h" = (/obj/structure/table/standard,/obj/effect/floor_decal/corner/blue/half{dir = 8},/obj/effect/floor_decal/corner/blue{dir = 4},/obj/item/paper_bin,/obj/item/pen,/turf/simulated/floor/tiled/dark/monotile,/area/template_noop)
"i" = (/obj/effect/floor_decal/corner/blue{dir = 10},/turf/simulated/floor/tiled/dark,/area/template_noop)
"k" = (/obj/structure/table/standard,/obj/effect/floor_decal/corner/blue/half,/obj/item/pen,/turf/simulated/floor/tiled/dark/monotile,/area/template_noop)
"m" = (/obj/effect/floor_decal/corner/blue/three_quarters{dir = 1},/obj/structure/sign/warning/nosmoking_1{dir = 8; pixel_x = 32},/turf/simulated/floor/tiled,/area/template_noop)
"n" = (/obj/structure/bed/chair/office/comfy/blue,/turf/simulated/floor/tiled/dark/monotile,/area/template_noop)
"o" = (/obj/effect/floor_decal/corner/blue{dir = 9},/obj/structure/table/standard,/obj/item/paper_bin{pixel_x = -3; pixel_y = 7},/turf/simulated/floor/tiled/dark,/area/template_noop)
"p" = (/turf/unsimulated/mineral{color = "#000000"; name = "void"},/area/template_noop)
"q" = (/obj/random/facility/mercenary/medium,/turf/simulated/floor/tiled/dark,/area/template_noop)
"r" = (/obj/machinery/door/airlock/civilian{name = "Office"},/turf/simulated/floor/tiled/steel_ridged,/area/template_noop)
"t" = (/obj/effect/floor_decal/corner/blue/half{dir = 1},/turf/simulated/floor/tiled/steel_ridged,/area/template_noop)
"z" = (/obj/effect/floor_decal/corner/blue{dir = 6},/turf/simulated/floor/tiled/steel_grid,/area/template_noop)
"B" = (/obj/structure/bed/chair/office/comfy/blue{dir = 1},/turf/simulated/floor/tiled/dark/monotile,/area/template_noop)
"E" = (/obj/effect/floor_decal/corner/blue{dir = 10},/turf/simulated/floor/tiled,/area/template_noop)
"G" = (/obj/effect/floor_decal/corner/blue{dir = 9},/obj/structure/holoplant,/obj/structure/sign/warning/nosmoking_1{dir = 4; pixel_x = -32},/turf/simulated/floor/tiled/dark,/area/template_noop)
"H" = (/obj/effect/floor_decal/corner/blue{dir = 9},/turf/simulated/floor/tiled/dark,/area/template_noop)
"I" = (/obj/effect/floor_decal/corner/blue{dir = 5},/turf/simulated/floor/tiled/dark,/area/template_noop)
"J" = (/obj/effect/floor_decal/corner/blue/three_quarters{dir = 4},/turf/simulated/floor/tiled,/area/template_noop)
"K" = (/obj/effect/floor_decal/corner/blue/half{dir = 8},/obj/machinery/light{dir = 1},/turf/simulated/floor/tiled/dark/monotile,/area/template_noop)
"L" = (/turf/simulated/wall/r_wall/invincible/prepainted,/area/template_noop)
"N" = (/obj/effect/floor_decal/corner/blue/half{dir = 8},/obj/machinery/light,/turf/simulated/floor/tiled/dark/monotile,/area/template_noop)
"O" = (/obj/machinery/computer/modular/preset/civilian{dir = 1},/obj/effect/floor_decal/corner/blue/half,/turf/simulated/floor/tiled/dark/monotile,/area/template_noop)
"P" = (/obj/effect/floor_decal/corner/blue/three_quarters{dir = 8},/obj/effect/floor_decal/industrial/outline/yellow,/obj/machinery/photocopier,/turf/simulated/floor/tiled/dark,/area/template_noop)
"R" = (/obj/structure/table/standard,/obj/effect/floor_decal/corner/blue/half{dir = 8},/obj/effect/floor_decal/corner/blue,/obj/random/junk,/turf/simulated/floor/tiled/dark/monotile,/area/template_noop)
"S" = (/obj/effect/catwalk_plated/dark,/turf/simulated/floor/plating,/area/template_noop)
"T" = (/obj/structure/table/standard,/obj/effect/floor_decal/corner/blue/half{dir = 1},/obj/random/snack,/turf/simulated/floor/tiled/dark/monotile,/area/template_noop)
"U" = (/turf/simulated/floor/tiled/steel_grid,/area/template_noop)
"W" = (/turf/simulated/floor/tiled/steel_ridged,/area/template_noop)
"Y" = (/turf/simulated/floor/tiled/dark/monotile,/area/template_noop)
"Z" = (/obj/effect/floor_decal/corner/blue/three_quarters,/obj/effect/floor_decal/industrial/outline/yellow,/obj/machinery/papershredder,/turf/simulated/floor/tiled/dark,/area/template_noop)

(1,1,1) = {"
Lppppppppp
Lppppppppp
LppLLLLLLL
LLLLPIKnYL
tamLoSRkOL
WUzrHSqfdL
bEJLGShTgL
LLLLZiNBYL
LppLLLLLLL
Lppppppppp
"}
