"a" = (/turf/simulated/wall/r_wall/invincible/prepainted,/area/template_noop)
"c" = (/obj/effect/floor_decal/corner/blue{dir = 6},/obj/machinery/light/small{dir = 4; icon_state = "bulb1"},/turf/simulated/floor/tiled,/area/template_noop)
"e" = (/obj/effect/floor_decal/corner/blue/half{dir = 8},/obj/effect/decal/cleanable/dirt,/turf/simulated/floor/tiled/steel_ridged,/area/template_noop)
"f" = (/obj/effect/floor_decal/corner/blue{dir = 5},/obj/effect/decal/cleanable/dirt,/obj/effect/decal/cleanable/dirt,/turf/simulated/floor/tiled,/area/template_noop)
"g" = (/obj/effect/decal/cleanable/dirt,/obj/effect/decal/cleanable/dirt,/turf/simulated/floor/tiled/steel_grid,/area/template_noop)
"h" = (/obj/effect/floor_decal/corner/blue{dir = 9},/turf/simulated/floor/tiled,/area/template_noop)
"i" = (/obj/structure/table/woodentable,/obj/effect/floor_decal/corner/blue/border{dir = 4},/obj/machinery/light{dir = 4},/obj/effect/decal/cleanable/dirt,/obj/random/maintenance/solgov,/turf/simulated/floor/tiled/monotile,/area/template_noop)
"k" = (/obj/effect/floor_decal/corner/blue{dir = 6},/obj/effect/decal/cleanable/dirt,/obj/effect/decal/cleanable/dirt,/turf/simulated/floor/tiled,/area/template_noop)
"l" = (/obj/effect/floor_decal/corner/blue{dir = 6},/turf/simulated/floor/tiled,/area/template_noop)
"m" = (/turf/simulated/floor/tiled/steel_grid,/area/template_noop)
"n" = (/obj/structure/bed/chair/padded/beige,/obj/effect/floor_decal/corner/blue/border{dir = 8},/turf/simulated/floor/tiled/monotile,/area/template_noop)
"q" = (/obj/effect/floor_decal/corner/blue{dir = 5},/obj/effect/decal/cleanable/dirt,/turf/simulated/floor/tiled,/area/template_noop)
"s" = (/obj/effect/floor_decal/corner/blue{dir = 6},/obj/effect/decal/cleanable/dirt,/turf/simulated/floor/tiled,/area/template_noop)
"t" = (/obj/effect/decal/cleanable/dirt,/turf/simulated/floor/tiled/steel_ridged,/area/template_noop)
"u" = (/obj/effect/floor_decal/corner/blue/half{dir = 4},/obj/effect/decal/cleanable/dirt,/turf/simulated/floor/tiled/steel_ridged,/area/template_noop)
"v" = (/obj/effect/floor_decal/corner/blue,/obj/effect/decal/cleanable/dirt,/turf/simulated/floor/tiled,/area/template_noop)
"x" = (/obj/effect/floor_decal/corner/blue{dir = 6},/obj/random/trash,/obj/effect/decal/cleanable/dirt,/obj/effect/decal/cleanable/dirt,/turf/simulated/floor/tiled,/area/template_noop)
"z" = (/obj/effect/floor_decal/corner/blue{dir = 9},/obj/random/trash,/turf/simulated/floor/tiled,/area/template_noop)
"A" = (/obj/structure/bed/chair/padded/beige{dir = 1},/obj/effect/floor_decal/corner/blue/border{dir = 4},/obj/effect/decal/cleanable/dirt,/turf/simulated/floor/tiled/monotile,/area/template_noop)
"B" = (/obj/effect/floor_decal/corner/blue{dir = 9},/obj/machinery/light/small{dir = 8},/obj/effect/decal/cleanable/dirt,/turf/simulated/floor/tiled,/area/template_noop)
"C" = (/obj/structure/bed/chair/padded/beige,/obj/effect/floor_decal/corner/blue/border{dir = 4},/obj/effect/decal/cleanable/dirt,/turf/simulated/floor/tiled/monotile,/area/template_noop)
"G" = (/obj/effect/floor_decal/corner/blue/three_quarters{dir = 1},/obj/structure/holoplant{pixel_y = 10},/turf/simulated/floor/tiled,/area/template_noop)
"H" = (/obj/effect/floor_decal/corner/blue/three_quarters,/obj/structure/holoplant,/turf/simulated/floor/tiled,/area/template_noop)
"I" = (/obj/structure/bed/chair/padded/beige{dir = 1},/obj/effect/floor_decal/corner/blue/border{dir = 8},/obj/effect/decal/cleanable/dirt,/turf/simulated/floor/tiled/monotile,/area/template_noop)
"J" = (/obj/effect/floor_decal/corner/blue/three_quarters{dir = 8},/obj/random/trash,/turf/simulated/floor/tiled,/area/template_noop)
"K" = (/obj/effect/decal/cleanable/dirt,/turf/simulated/floor/tiled/steel_grid,/area/template_noop)
"N" = (/obj/structure/table/woodentable,/obj/effect/floor_decal/corner/blue/border{dir = 1},/obj/machinery/light{dir = 1},/obj/effect/decal/cleanable/dirt,/obj/random/maintenance/solgov,/turf/simulated/floor/tiled/monotile,/area/template_noop)
"O" = (/obj/effect/floor_decal/corner/blue{dir = 8},/obj/effect/decal/cleanable/dirt,/turf/simulated/floor/tiled,/area/template_noop)
"P" = (/obj/effect/floor_decal/corner/blue{dir = 9},/obj/effect/decal/cleanable/dirt,/obj/effect/decal/cleanable/dirt,/turf/simulated/floor/tiled,/area/template_noop)
"Q" = (/turf/unsimulated/mineral{color = "#000000"; name = "void"},/area/template_noop)
"R" = (/turf/simulated/wall/prepainted,/area/template_noop)
"T" = (/obj/effect/catwalk_plated,/obj/effect/decal/cleanable/dirt,/turf/simulated/floor/plating,/area/template_noop)
"U" = (/obj/structure/table/woodentable,/obj/effect/floor_decal/corner/blue/border{dir = 8},/obj/machinery/light{dir = 8},/obj/effect/decal/cleanable/dirt,/obj/random/maintenance/solgov,/turf/simulated/floor/tiled/monotile,/area/template_noop)
"V" = (/obj/effect/decal/cleanable/dirt,/obj/random/facility/mercenary/low,/turf/simulated/floor/tiled/steel_grid,/area/template_noop)
"X" = (/obj/effect/floor_decal/corner/blue/three_quarters{dir = 4},/turf/simulated/floor/tiled,/area/template_noop)
"Y" = (/obj/structure/bed/chair/padded/beige{dir = 4},/obj/effect/floor_decal/corner/blue/border{dir = 1},/turf/simulated/floor/tiled/monotile,/area/template_noop)
"Z" = (/obj/structure/bed/chair/padded/beige{dir = 8},/obj/effect/floor_decal/corner/blue/border{dir = 1},/obj/effect/decal/cleanable/dirt,/turf/simulated/floor/tiled/monotile,/area/template_noop)

(1,1,1) = {"
QQaaaaaQQQ
QaaYNZaaQQ
aaJqffGaaQ
anPVKglCaQ
aUPgTKxiaQ
aIhgKKkAaQ
aaHOgvXaaQ
QaazmsaaQQ
QQaBRcaQQQ
aaaetuaaaa
"}
