"a" = (/obj/structure/window/reinforced{dir = 4},/turf/simulated/floor/wood,/area/template_noop)
"b" = (/obj/structure/window/reinforced{dir = 1},/turf/simulated/floor/wood,/area/template_noop)
"c" = (/obj/structure/window/reinforced{dir = 4},/obj/effect/decal/cleanable/dirt,/turf/simulated/floor/wood,/area/template_noop)
"d" = (/obj/machinery/light/small,/obj/effect/floor_decal/corner/blue/three_quarters{dir = 1},/obj/effect/decal/cleanable/dirt,/obj/effect/decal/cleanable/dirt,/turf/simulated/floor/tiled,/area/template_noop)
"e" = (/obj/effect/floor_decal/corner/blue{dir = 5},/obj/effect/decal/cleanable/dirt,/obj/effect/decal/cleanable/dirt,/turf/simulated/floor/tiled,/area/template_noop)
"f" = (/turf/simulated/wall/prepainted,/area/template_noop)
"g" = (/obj/structure/flora/ausbushes/leafybush,/obj/machinery/light{dir = 4},/turf/simulated/floor/grass,/area/template_noop)
"i" = (/obj/structure/flora/ausbushes/lavendergrass,/obj/structure/flora/ausbushes/ywflowers,/turf/simulated/floor/grass,/area/template_noop)
"j" = (/obj/structure/flora/ausbushes,/turf/simulated/floor/grass,/area/template_noop)
"l" = (/obj/structure/window/reinforced{dir = 4},/obj/structure/window/reinforced{dir = 1},/turf/simulated/floor/wood,/area/template_noop)
"m" = (/obj/machinery/door/airlock/civilian{name = "Observatory"},/turf/simulated/floor/tiled/steel_ridged,/area/template_noop)
"n" = (/obj/structure/flora/ausbushes/grassybush,/obj/machinery/light{dir = 1},/turf/simulated/floor/grass,/area/template_noop)
"o" = (/obj/structure/flora/ausbushes/fullgrass,/obj/structure/flora/ausbushes/sparsegrass,/turf/simulated/floor/grass,/area/template_noop)
"p" = (/obj/structure/flora/ausbushes/fernybush,/turf/simulated/floor/grass,/area/template_noop)
"q" = (/obj/structure/bed/chair/armchair/black,/turf/simulated/floor/wood,/area/template_noop)
"r" = (/turf/unsimulated/mineral{color = "#000000"; name = "void"},/area/template_noop)
"s" = (/obj/structure/flora/ausbushes/genericbush,/turf/simulated/floor/grass,/area/template_noop)
"t" = (/obj/structure/flora/ausbushes/fullgrass,/obj/machinery/light{dir = 4},/turf/simulated/floor/grass,/area/template_noop)
"u" = (/obj/structure/flora/ausbushes/grassybush,/turf/simulated/floor/grass,/area/template_noop)
"v" = (/obj/structure/flora/ausbushes/grassybush,/obj/machinery/light{dir = 8},/turf/simulated/floor/grass,/area/template_noop)
"w" = (/obj/structure/window/reinforced{dir = 8},/obj/effect/decal/cleanable/dirt,/turf/simulated/floor/wood,/area/template_noop)
"x" = (/turf/simulated/floor/grass,/area/template_noop)
"y" = (/obj/structure/flora/ausbushes/sparsegrass,/turf/simulated/floor/grass,/area/template_noop)
"B" = (/obj/effect/floor_decal/corner/blue{dir = 10},/obj/effect/decal/cleanable/dirt,/obj/effect/decal/cleanable/dirt,/turf/simulated/floor/tiled/steel_ridged,/area/template_noop)
"E" = (/obj/structure/flora/ausbushes/lavendergrass,/obj/structure/flora/ausbushes/ppflowers,/turf/simulated/floor/grass,/area/template_noop)
"F" = (/obj/effect/floor_decal/corner/blue/three_quarters{dir = 4},/obj/effect/decal/cleanable/dirt,/turf/simulated/floor/tiled/steel_ridged,/area/template_noop)
"G" = (/obj/structure/flora/ausbushes/palebush,/turf/simulated/floor/grass,/area/template_noop)
"H" = (/obj/structure/flora/ausbushes,/obj/machinery/light{dir = 8},/turf/simulated/floor/grass,/area/template_noop)
"I" = (/obj/structure/flora/ausbushes/sunnybush,/turf/simulated/floor/grass,/area/template_noop)
"J" = (/obj/structure/flora/ausbushes/ppflowers,/turf/simulated/floor/grass,/area/template_noop)
"K" = (/obj/structure/flora/ausbushes/pointybush,/turf/simulated/floor/grass,/area/template_noop)
"M" = (/obj/structure/flora/ausbushes/ywflowers,/turf/simulated/floor/grass,/area/template_noop)
"N" = (/obj/structure/flora/ausbushes/leafybush,/turf/simulated/floor/grass,/area/template_noop)
"O" = (/obj/structure/bed/chair/armchair/black{dir = 1},/turf/simulated/floor/wood,/area/template_noop)
"P" = (/obj/structure/flora/ausbushes/ppflowers,/obj/structure/flora/ausbushes/sparsegrass,/turf/simulated/floor/grass,/area/template_noop)
"Q" = (/turf/simulated/wall/r_wall/invincible/prepainted,/area/template_noop)
"T" = (/obj/structure/table/woodentable,/obj/random/drinkbottle,/obj/effect/decal/cleanable/dirt,/turf/simulated/floor/wood,/area/template_noop)
"U" = (/obj/structure/window/reinforced{dir = 8},/turf/simulated/floor/wood,/area/template_noop)
"V" = (/obj/machinery/light/small{dir = 1},/obj/effect/floor_decal/corner/blue/three_quarters,/turf/simulated/floor/tiled/steel_ridged,/area/template_noop)
"W" = (/obj/structure/flora/ausbushes/fullgrass,/obj/structure/flora/ausbushes/ywflowers,/turf/simulated/floor/grass,/area/template_noop)
"X" = (/obj/effect/floor_decal/corner/blue/three_quarters{dir = 8},/obj/effect/decal/cleanable/dirt,/turf/simulated/floor/tiled,/area/template_noop)
"Y" = (/obj/structure/flora/ausbushes/lavendergrass,/turf/simulated/floor/grass,/area/template_noop)
"Z" = (/obj/structure/window/reinforced{dir = 8},/obj/structure/window/reinforced{dir = 1},/turf/simulated/floor/wood,/area/template_noop)

(1,1,1) = {"
QQQQQQQQQr
QNsJnEjWQr
QHYxoxIgQr
QWGZbluMQr
QPpwqaKyQr
QvYwTaJtQr
QNWUOcpiQr
QQQXedQQQr
rrQfmfQrrr
QQQVBFQQQQ
"}
