"af" = (/obj/random/junk,/obj/random/maintenance,/turf/simulated/floor/tiled/techfloor,/area/map_template/facility/room20/medbay)
"aA" = (/turf/simulated/floor/plating,/area/map_template/facility/room20/medbay)
"aQ" = (/obj/effect/floor_decal/corner/paleblue{dir = 8},/turf/simulated/floor/tiled/white,/area/map_template/facility/room20/medbay)
"bs" = (/obj/structure/table/standard,/obj/effect/floor_decal/floordetail/edgedrain{dir = 6},/obj/effect/floor_decal/corner/paleblue{dir = 1},/obj/random/masks,/turf/simulated/floor/tiled/white,/area/map_template/facility/room20/medbay)
"bz" = (/obj/effect/wallframe_spawn/reinforced,/turf/simulated/floor/plating,/area/map_template/facility/room20/medbay)
"bD" = (/obj/effect/floor_decal/spline/plain/blue,/obj/machinery/light,/turf/simulated/floor/lino,/area/map_template/facility/room20/medbay)
"bI" = (/turf/simulated/wall/r_wall/invincible/prepainted,/area/map_template/facility/room20/medbay)
"bR" = (/obj/effect/floor_decal/corner/paleblue/three_quarters{dir = 4},/turf/simulated/floor/tiled/white,/area/map_template/facility/room20/medbay)
"cG" = (/turf/simulated/wall/prepainted,/area/map_template/facility/room20/medbay/back)
"dm" = (/obj/effect/floor_decal/corner/blue/three_quarters{dir = 4},/obj/effect/floor_decal/industrial/outline/yellow,/obj/structure/table/rack,/obj/random/medical/lite,/turf/simulated/floor/tiled/dark,/area/map_template/facility/room20/medbay/back)
"dO" = (/obj/effect/floor_decal/spline/plain/blue{dir = 4},/obj/structure/bed/roller,/turf/simulated/floor/tiled/white/monotile,/area/map_template/facility/room20/medbay)
"dY" = (/obj/structure/table/rack,/obj/effect/floor_decal/corner/blue/mono,/obj/random/medical,/obj/random/medical/lite,/turf/simulated/floor/tiled/dark/monotile,/area/map_template/facility/room20/medbay)
"el" = (/obj/effect/floor_decal/spline/plain/blue{dir = 9},/turf/simulated/floor/lino,/area/map_template/facility/room20/medbay)
"en" = (/obj/effect/floor_decal/corner/blue/three_quarters{dir = 8},/obj/effect/floor_decal/industrial/outline/yellow,/obj/structure/table/rack,/obj/item/bodybag,/obj/item/bodybag,/obj/item/bodybag,/obj/item/bodybag,/turf/simulated/floor/tiled/dark,/area/map_template/facility/room20/medbay/back)
"eo" = (/obj/item/stack/material/rods,/turf/simulated/floor/plating,/area/map_template/facility/room20/medbay)
"eD" = (/obj/structure/table/standard,/obj/effect/floor_decal/corner/blue/mono,/obj/machinery/light{dir = 8},/obj/item/folder/blue,/turf/simulated/floor/tiled/dark/monotile,/area/map_template/facility/room20/medbay)
"eM" = (/obj/machinery/sleeper{dir = 4},/obj/effect/floor_decal/corner/paleblue/mono,/obj/machinery/light{dir = 1},/turf/simulated/floor/tiled/white/monotile,/area/map_template/facility/room20/medbay)
"eP" = (/obj/effect/floor_decal/corner/paleblue{dir = 9},/turf/simulated/floor/tiled/white,/area/map_template/facility/room20/medbay)
"fa" = (/obj/effect/floor_decal/spline/plain/blue{dir = 10},/obj/structure/iv_drip,/turf/simulated/floor/tiled/dark/monotile,/area/map_template/facility/room20/medbay)
"fG" = (/obj/effect/floor_decal/corner/paleblue/mono,/obj/effect/floor_decal/industrial/outline/blue,/obj/item/caution/cone,/turf/simulated/floor/tiled/monotile,/area/map_template/facility/room20/medbay)
"fO" = (/obj/effect/floor_decal/corner/paleblue{dir = 10},/obj/random/bomb_supply,/turf/simulated/floor/tiled/dark,/area/map_template/facility/room20/medbay)
"fP" = (/obj/structure/holoplant{pixel_y = 10},/obj/structure/noticeboard{pixel_y = 32},/obj/machinery/light{dir = 4},/turf/simulated/floor/tiled/dark/monotile,/area/map_template/facility/room20/medbay)
"gQ" = (/obj/structure/table/reinforced,/obj/machinery/door/window/southright,/obj/item/material/bell/glass,/turf/simulated/floor/tiled/dark/monotile,/area/map_template/facility/room20/medbay)
"hy" = (/obj/effect/floor_decal/corner/blue{dir = 9},/obj/machinery/light{dir = 8},/turf/simulated/floor/tiled/dark,/area/map_template/facility/room20/medbay)
"hA" = (/obj/effect/floor_decal/corner/paleblue{dir = 1},/turf/simulated/floor/tiled,/area/map_template/facility/room20/medbay)
"ie" = (/obj/random/loot,/obj/structure/railing/mapped{dir = 4; icon_state = "railing0-1"},/obj/structure/table/rack,/turf/simulated/floor/plating,/area/map_template/facility/room20/medbay/back)
"iE" = (/obj/effect/floor_decal/spline/plain/blue{dir = 5},/turf/simulated/floor/tiled/white/monotile,/area/map_template/facility/room20/medbay)
"iU" = (/turf/simulated/floor/tiled/dark,/area/map_template/facility/room20/medbay)
"iV" = (/obj/effect/floor_decal/corner/yellow{dir = 9},/turf/simulated/floor/tiled/white,/area/map_template/facility/room20/medbay)
"jj" = (/obj/structure/bed/chair/padded/blue,/obj/effect/floor_decal/corner/blue{dir = 10},/turf/simulated/floor/tiled/dark,/area/map_template/facility/room20/medbay)
"jk" = (/obj/effect/floor_decal/corner/blue{dir = 5},/obj/effect/floor_decal/industrial/outline/yellow,/obj/structure/table/rack,/obj/item/clothing/glasses/hud/health,/obj/machinery/light{dir = 1},/turf/simulated/floor/tiled/dark,/area/map_template/facility/room20/medbay/back)
"jn" = (/obj/structure/table/reinforced,/obj/machinery/door/window/holowindoor,/turf/simulated/floor/tiled/dark/monotile,/area/map_template/facility/room20/medbay)
"jq" = (/obj/structure/catwalk,/obj/machinery/light/small{dir = 8},/turf/simulated/floor/plating,/area/map_template/facility/room20/medbay)
"jL" = (/obj/effect/floor_decal/corner/yellow{dir = 1},/turf/simulated/floor/tiled/white,/area/map_template/facility/room20/medbay)
"kA" = (/obj/structure/table/woodentable/maple,/obj/effect/floor_decal/spline/plain/blue,/turf/simulated/floor/lino,/area/map_template/facility/room20/medbay)
"kI" = (/obj/effect/floor_decal/corner/blue{dir = 9},/obj/structure/sign/warning/nosmoking_1{dir = 4; pixel_x = -32},/turf/simulated/floor/tiled/dark,/area/map_template/facility/room20/medbay)
"lf" = (/obj/machinery/hologram/holopad,/obj/effect/floor_decal/industrial/outline/yellow,/turf/simulated/floor/tiled/dark/monotile,/area/map_template/facility/room20/medbay)
"lk" = (/obj/machinery/door/airlock/glass/medical{name = "Treatment Center"},/turf/simulated/floor/tiled/steel_ridged,/area/map_template/facility/room20/medbay)
"lq" = (/obj/effect/floor_decal/corner/paleblue{dir = 5},/obj/random/facility/mercenary/low,/turf/simulated/floor/tiled/white,/area/map_template/facility/room20/medbay)
"lE" = (/obj/random/junk,/turf/simulated/floor/plating,/area/map_template/facility/room20/medbay)
"lI" = (/obj/item/stack/material/steel,/turf/simulated/floor/plating,/area/map_template/facility/room20/medbay)
"lM" = (/obj/structure/bed/sofa/black/left{dir = 10},/obj/effect/floor_decal/spline/plain/blue{dir = 5},/turf/simulated/floor/lino,/area/map_template/facility/room20/medbay)
"lP" = (/obj/effect/floor_decal/corner/paleblue/three_quarters,/turf/simulated/floor/tiled/white,/area/map_template/facility/room20/medbay)
"lW" = (/obj/structure/table/rack,/obj/item/roller,/obj/item/roller,/obj/item/roller,/obj/effect/floor_decal/corner/blue/mono,/turf/simulated/floor/tiled/dark/monotile,/area/map_template/facility/room20/medbay)
"mb" = (/obj/structure/table/standard,/obj/effect/floor_decal/corner/blue/mono,/obj/random/clipboard,/turf/simulated/floor/tiled/dark/monotile,/area/map_template/facility/room20/medbay)
"mK" = (/obj/random/trash,/turf/simulated/floor/tiled,/area/map_template/facility/room20/medbay)
"na" = (/obj/structure/table/standard,/obj/item/grenade/frag,/turf/simulated/floor/tiled/white,/area/map_template/facility/room20/medbay)
"nV" = (/obj/structure/table/standard,/obj/effect/floor_decal/corner/blue/mono,/obj/item/modular_computer/laptop/preset/custom_loadout/cheap,/obj/machinery/recharger/wallcharger{dir = 4; pixel_x = -23; pixel_y = -3},/turf/simulated/floor/tiled/dark/monotile,/area/map_template/facility/room20/medbay)
"nZ" = (/obj/structure/bed/padded,/obj/item/bedsheet/medical,/turf/simulated/floor/tiled/dark/monotile,/area/map_template/facility/room20/medbay)
"ob" = (/turf/simulated/floor/tiled/dark/monotile,/area/map_template/facility/room20/medbay/back)
"oP" = (/obj/machinery/body_scanconsole{dir = 8},/obj/effect/floor_decal/corner/red/bordercee{dir = 8},/turf/simulated/floor/tiled/white/monotile,/area/map_template/facility/room20/medbay)
"oY" = (/obj/effect/floor_decal/corner/red{dir = 8},/obj/effect/floor_decal/corner/paleblue,/obj/machinery/light,/turf/simulated/floor/tiled/white,/area/map_template/facility/room20/medbay)
"px" = (/obj/effect/floor_decal/corner/blue{dir = 5},/obj/effect/floor_decal/industrial/outline/yellow,/obj/structure/table/rack,/obj/item/clothing/accessory/stethoscope,/turf/simulated/floor/tiled/dark,/area/map_template/facility/room20/medbay/back)
"qI" = (/obj/structure/iv_drip,/obj/effect/floor_decal/industrial/outline/yellow,/obj/item/material/shard,/turf/simulated/floor/tiled/white/monotile,/area/map_template/facility/room20/medbay)
"qV" = (/obj/effect/floor_decal/corner/paleblue{dir = 6},/obj/structure/bed/chair/padded/blue{dir = 8},/turf/simulated/floor/tiled,/area/map_template/facility/room20/medbay)
"rl" = (/obj/structure/table/standard,/obj/machinery/light{dir = 8},/obj/item/glass_jar,/turf/simulated/floor/tiled/white,/area/map_template/facility/room20/medbay)
"rC" = (/obj/effect/catwalk_plated,/turf/simulated/floor/plating,/area/map_template/facility/room20/medbay)
"rN" = (/obj/structure/bed/padded,/obj/effect/floor_decal/corner/paleblue/half,/obj/random/facility/gun/rare,/obj/item/bedsheet/medical,/turf/simulated/floor/tiled/dark/monotile,/area/map_template/facility/room20/medbay)
"sk" = (/obj/machinery/door/airlock/medical{name = "Equipment Storage"},/turf/simulated/floor/tiled/dark/monotile,/area/map_template/facility/room20/medbay/back)
"sH" = (/obj/machinery/door/airlock/medical{name = "Infirmary Reception"},/turf/simulated/floor/tiled/dark/monotile,/area/map_template/facility/room20/medbay)
"sK" = (/obj/effect/floor_decal/floordetail/edgedrain,/obj/effect/floor_decal/corner/paleblue{dir = 5},/turf/simulated/floor/tiled/white,/area/map_template/facility/room20/medbay)
"sY" = (/obj/effect/catwalk_plated/white,/turf/simulated/floor/plating,/area/map_template/facility/room20/medbay)
"tk" = (/turf/simulated/wall/r_wall/prepainted,/area/map_template/facility/room20/medbay/back)
"tp" = (/obj/effect/floor_decal/corner/paleblue/half{dir = 4},/obj/effect/floor_decal/corner/paleblue{dir = 1},/obj/machinery/light{dir = 8},/turf/simulated/floor/tiled/monotile,/area/map_template/facility/room20/medbay)
"tt" = (/obj/effect/floor_decal/corner/blue{dir = 10},/obj/effect/floor_decal/industrial/outline/yellow,/obj/structure/table/rack,/obj/random/medical/lite,/obj/random/medical/lite,/turf/simulated/floor/tiled/dark,/area/map_template/facility/room20/medbay/back)
"tv" = (/obj/structure/bed/chair/padded/blue{dir = 8},/turf/simulated/floor/tiled/dark,/area/map_template/facility/room20/medbay)
"tE" = (/obj/random/junk,/obj/structure/railing/mapped{dir = 4; icon_state = "railing0-1"},/obj/machinery/light/small{dir = 8},/turf/simulated/floor/plating,/area/map_template/facility/room20/medbay/back)
"vh" = (/obj/effect/floor_decal/corner/paleblue/three_quarters{dir = 1},/turf/simulated/floor/tiled/white,/area/map_template/facility/room20/medbay)
"vw" = (/obj/machinery/light,/obj/item/stack/material/rods,/turf/simulated/floor/plating,/area/map_template/facility/room20/medbay)
"vS" = (/turf/unsimulated/mineral,/area/map_template/facility/room20/medbay)
"vW" = (/obj/structure/bed/sofa/black/left{dir = 8},/obj/effect/floor_decal/spline/plain/blue{dir = 4},/turf/simulated/floor/lino,/area/map_template/facility/room20/medbay)
"wx" = (/obj/effect/wallframe_spawn/no_grille,/turf/simulated/floor/plating,/area/map_template/facility/room20/medbay)
"wI" = (/obj/structure/table/woodentable/maple,/obj/item/grenade/chem_grenade/cleaner,/turf/simulated/floor/lino,/area/map_template/facility/room20/medbay)
"xs" = (/obj/effect/floor_decal/corner/blue/half,/turf/simulated/floor/tiled/dark/monotile,/area/map_template/facility/room20/medbay/back)
"yA" = (/obj/structure/railing/mapped{dir = 4; icon_state = "railing0-1"},/obj/random/maintenance,/turf/simulated/floor/plating,/area/map_template/facility/room20/medbay/back)
"yJ" = (/obj/machinery/organ_printer/robot/mapped,/obj/effect/floor_decal/floordetail/edgedrain,/obj/effect/floor_decal/corner/paleblue{dir = 5},/turf/simulated/floor/tiled/white,/area/map_template/facility/room20/medbay)
"yN" = (/turf/simulated/floor/lino,/area/map_template/facility/room20/medbay)
"yW" = (/obj/structure/reagent_dispensers/water_cooler,/obj/effect/floor_decal/floordetail/edgedrain{dir = 1},/obj/effect/floor_decal/corner/paleblue/half,/turf/simulated/floor/tiled/white/monotile,/area/map_template/facility/room20/medbay)
"zb" = (/obj/structure/catwalk,/turf/simulated/floor/plating,/area/map_template/facility/room20/medbay)
"zJ" = (/obj/structure/bed/sofa/black,/obj/effect/floor_decal/spline/plain/blue{dir = 1},/obj/machinery/light{dir = 1},/turf/simulated/floor/lino,/area/map_template/facility/room20/medbay)
"zO" = (/turf/simulated/wall/r_wall/invincible/prepainted,/area/map_template/facility/room20/medbay/back)
"zU" = (/obj/effect/floor_decal/corner/paleblue{dir = 10},/obj/machinery/light/small,/turf/simulated/floor/tiled/white,/area/map_template/facility/room20/medbay)
"Ad" = (/obj/effect/floor_decal/spline/plain/blue{dir = 8},/obj/structure/bed/roller,/obj/structure/sign/warning/nosmoking_1{dir = 8; pixel_x = 32},/turf/simulated/floor/tiled/white/monotile,/area/map_template/facility/room20/medbay)
"Am" = (/obj/item/material/shard,/turf/simulated/floor/tiled,/area/map_template/facility/room20/medbay)
"AC" = (/obj/random/junk,/turf/simulated/floor/tiled/white,/area/map_template/facility/room20/medbay)
"AG" = (/obj/effect/floor_decal/corner/paleblue{dir = 1},/turf/simulated/floor/tiled/white,/area/map_template/facility/room20/medbay)
"AR" = (/obj/effect/floor_decal/corner/blue/three_quarters{dir = 4},/obj/effect/floor_decal/industrial/outline/yellow,/obj/structure/table/rack,/obj/item/reagent_containers/spray/cleaner{pixel_x = -5},/obj/random/medical/lite,/obj/random/medical/lite,/turf/simulated/floor/tiled/dark,/area/map_template/facility/room20/medbay/back)
"Bt" = (/obj/effect/floor_decal/corner/paleblue{dir = 10},/obj/random/junk,/turf/simulated/floor/tiled/white,/area/map_template/facility/room20/medbay)
"BA" = (/obj/machinery/sleeper{dir = 8},/obj/effect/floor_decal/corner/paleblue/mono,/turf/simulated/floor/tiled/white/monotile,/area/map_template/facility/room20/medbay)
"BE" = (/obj/machinery/jukebox,/turf/simulated/floor/lino,/area/map_template/facility/room20/medbay)
"BR" = (/obj/machinery/door/airlock/medical{name = "Facility Hospital"},/turf/simulated/floor/tiled/steel_ridged,/area/map_template/facility/room20/medbay)
"Cv" = (/obj/structure/iv_drip,/turf/simulated/floor/plating,/area/map_template/facility/room20/medbay)
"Da" = (/obj/random/junk,/obj/structure/railing/mapped{dir = 1; icon_state = "railing0-1"},/obj/structure/table/rack,/obj/random/facility/ammo,/turf/simulated/floor/plating,/area/map_template/facility/room20/medbay/back)
"Dv" = (/obj/effect/floor_decal/spline/plain/blue{dir = 9},/turf/simulated/floor/tiled/white/monotile,/area/map_template/facility/room20/medbay)
"Dx" = (/obj/structure/bed/chair/comfy/beige{dir = 8},/obj/effect/floor_decal/spline/plain/blue,/turf/simulated/floor/lino,/area/map_template/facility/room20/medbay)
"DK" = (/obj/machinery/light{dir = 4},/turf/simulated/floor/tiled/dark,/area/map_template/facility/room20/medbay)
"El" = (/obj/machinery/optable,/obj/effect/floor_decal/floordetail/edgedrain{dir = 1},/obj/effect/floor_decal/corner/paleblue{dir = 10},/turf/simulated/floor/tiled/white,/area/map_template/facility/room20/medbay)
"En" = (/obj/item/stack/material/rods,/turf/simulated/floor/tiled,/area/map_template/facility/room20/medbay)
"Eo" = (/obj/effect/floor_decal/corner/red{dir = 10},/turf/simulated/floor/tiled/white,/area/map_template/facility/room20/medbay)
"Eu" = (/obj/structure/bed/sofa/black,/obj/effect/floor_decal/spline/plain/blue{dir = 1},/turf/simulated/floor/lino,/area/map_template/facility/room20/medbay)
"Ex" = (/obj/machinery/door/airlock/hatch/maintenance,/turf/simulated/floor/tiled/steel_ridged,/area/map_template/facility/room20/medbay/back)
"EI" = (/obj/machinery/vitals_monitor,/obj/effect/floor_decal/floordetail/edgedrain{dir = 1},/obj/effect/floor_decal/corner/paleblue{dir = 10},/turf/simulated/floor/tiled/white,/area/map_template/facility/room20/medbay)
"ES" = (/obj/effect/floor_decal/corner/beige/full,/turf/simulated/floor/tiled/steel_grid,/area/map_template/facility/room20/medbay)
"Ga" = (/obj/structure/bed/sofa/black/left,/obj/effect/floor_decal/spline/plain/blue{dir = 1},/obj/structure/sign/warning/smoking{pixel_y = 32},/turf/simulated/floor/lino,/area/map_template/facility/room20/medbay)
"Gr" = (/obj/structure/table/standard,/obj/effect/floor_decal/floordetail/edgedrain{dir = 1},/obj/effect/floor_decal/corner/paleblue/half,/obj/machinery/light{dir = 1},/obj/random/medical,/turf/simulated/floor/tiled/white/monotile,/area/map_template/facility/room20/medbay)
"GE" = (/obj/effect/floor_decal/corner/blue/three_quarters{dir = 8},/obj/effect/floor_decal/industrial/outline/yellow,/obj/structure/table/rack,/obj/item/storage/box/lights/bulbs,/obj/structure/extinguisher_cabinet{pixel_y = 32},/turf/simulated/floor/tiled/dark,/area/map_template/facility/room20/medbay/back)
"GR" = (/obj/effect/floor_decal/corner/paleblue,/turf/simulated/floor/tiled/white,/area/map_template/facility/room20/medbay)
"Hu" = (/obj/structure/bed/chair/comfy/beige{dir = 4},/obj/effect/floor_decal/spline/plain/blue{dir = 10},/turf/simulated/floor/lino,/area/map_template/facility/room20/medbay)
"HB" = (/obj/machinery/constructable_frame/machine_frame,/obj/item/material/shard,/turf/simulated/floor/plating,/area/map_template/facility/room20/medbay)
"HU" = (/obj/structure/table/standard,/obj/item/storage/firstaid/surgery,/obj/effect/floor_decal/floordetail/edgedrain{dir = 5},/obj/effect/floor_decal/corner/paleblue{dir = 8},/turf/simulated/floor/tiled/white,/area/map_template/facility/room20/medbay)
"Ii" = (/obj/structure/table/standard,/obj/effect/floor_decal/floordetail/edgedrain{dir = 4},/obj/effect/floor_decal/corner/paleblue{dir = 9},/obj/random/medical,/turf/simulated/floor/tiled/white,/area/map_template/facility/room20/medbay)
"Jn" = (/obj/effect/floor_decal/spline/plain/blue{dir = 10},/turf/simulated/floor/tiled/white/monotile,/area/map_template/facility/room20/medbay)
"Jv" = (/obj/random/facility/mercenary/low,/turf/simulated/floor/tiled/dark,/area/map_template/facility/room20/medbay)
"Jz" = (/obj/effect/floor_decal/spline/plain/blue{dir = 8},/turf/simulated/floor/lino,/area/map_template/facility/room20/medbay)
"JB" = (/obj/random/junk,/turf/simulated/floor/lino,/area/map_template/facility/room20/medbay)
"JC" = (/obj/effect/floor_decal/corner/paleblue{dir = 5},/turf/simulated/floor/tiled/dark,/area/map_template/facility/room20/medbay)
"KD" = (/obj/structure/table/reinforced,/obj/structure/window/reinforced,/obj/item/paper_bin,/obj/item/pen,/turf/simulated/floor/tiled/dark/monotile,/area/map_template/facility/room20/medbay)
"KI" = (/obj/effect/floor_decal/corner/paleblue{dir = 6},/obj/machinery/light{dir = 4},/turf/simulated/floor/tiled/white,/area/map_template/facility/room20/medbay)
"KT" = (/obj/effect/floor_decal/corner/paleblue{dir = 10},/turf/simulated/floor/tiled/dark,/area/map_template/facility/room20/medbay)
"Lg" = (/obj/structure/bed/padded,/obj/effect/floor_decal/corner/paleblue/half,/obj/item/bedsheet/medical,/obj/item/bonesetter,/turf/simulated/floor/tiled/dark/monotile,/area/map_template/facility/room20/medbay)
"Ly" = (/obj/structure/table/standard,/obj/structure/bedsheetbin{pixel_y = 7},/turf/simulated/floor/tiled/white,/area/map_template/facility/room20/medbay)
"MP" = (/obj/effect/floor_decal/corner/paleblue{dir = 9},/obj/structure/sign/warning/nosmoking_1{dir = 4; pixel_x = -32},/turf/simulated/floor/tiled/white,/area/map_template/facility/room20/medbay)
"MQ" = (/obj/effect/floor_decal/corner/paleblue/bordercee{dir = 8},/turf/simulated/floor/tiled/white/monotile,/area/map_template/facility/room20/medbay)
"MS" = (/obj/effect/floor_decal/corner/blue{dir = 9},/obj/structure/extinguisher_cabinet{pixel_x = -32},/turf/simulated/floor/tiled/dark,/area/map_template/facility/room20/medbay)
"MT" = (/obj/effect/floor_decal/corner/paleblue{dir = 8},/turf/simulated/floor/tiled/monotile,/area/map_template/facility/room20/medbay)
"MV" = (/obj/structure/table/standard,/obj/effect/floor_decal/floordetail/edgedrain{dir = 1},/obj/effect/floor_decal/corner/paleblue/half,/obj/random/medical/lite,/turf/simulated/floor/tiled/white/monotile,/area/map_template/facility/room20/medbay)
"Ns" = (/obj/random/facility/gun/uncommon,/obj/structure/closet/crate/freezer,/turf/simulated/floor/plating,/area/map_template/facility/room20/medbay/back)
"Nw" = (/obj/random/facility/mercenary/low,/turf/simulated/floor/tiled/steel_ridged,/area/map_template/facility/room20/medbay/back)
"NP" = (/obj/effect/floor_decal/corner/paleblue/three_quarters{dir = 8},/turf/simulated/floor/tiled/white,/area/map_template/facility/room20/medbay)
"NZ" = (/obj/structure/table/standard,/obj/effect/floor_decal/floordetail/edgedrain{dir = 4},/obj/effect/floor_decal/corner/paleblue{dir = 9},/obj/item/reagent_containers/spray/cleaner{pixel_x = -5},/obj/item/reagent_containers/spray/sterilizine{pixel_x = 3},/turf/simulated/floor/tiled/white,/area/map_template/facility/room20/medbay)
"Oj" = (/obj/effect/floor_decal/corner/paleblue,/obj/structure/bed/chair/padded/blue{dir = 1},/turf/simulated/floor/tiled,/area/map_template/facility/room20/medbay)
"Ok" = (/obj/effect/floor_decal/spline/plain/blue{dir = 5},/obj/structure/bed/roller,/turf/simulated/floor/tiled/white/monotile,/area/map_template/facility/room20/medbay)
"Op" = (/obj/effect/catwalk_plated/dark,/turf/simulated/floor/plating,/area/map_template/facility/room20/medbay)
"Ow" = (/obj/random/advdevice,/turf/simulated/floor/tiled/dark,/area/map_template/facility/room20/medbay)
"Oy" = (/obj/effect/floor_decal/corner/paleblue,/obj/machinery/light{dir = 4},/obj/structure/bed/chair/padded/blue{dir = 8},/turf/simulated/floor/tiled/monotile,/area/map_template/facility/room20/medbay)
"OJ" = (/turf/simulated/wall/r_wall/prepainted,/area/map_template/facility/room20/medbay)
"OU" = (/obj/effect/floor_decal/corner/blue/mono,/obj/structure/filingcabinet/chestdrawer,/obj/item/folder/white,/turf/simulated/floor/tiled/dark/monotile,/area/map_template/facility/room20/medbay)
"Pn" = (/obj/effect/floor_decal/corner/paleblue/mono,/obj/effect/floor_decal/industrial/outline/blue,/turf/simulated/floor/tiled/monotile,/area/map_template/facility/room20/medbay)
"Pw" = (/obj/effect/floor_decal/spline/plain/blue{dir = 6},/turf/simulated/floor/tiled/white/monotile,/area/map_template/facility/room20/medbay)
"PP" = (/turf/simulated/floor/tiled/white,/area/map_template/facility/room20/medbay)
"PU" = (/obj/machinery/door/airlock/hatch/maintenance,/turf/simulated/floor/tiled/steel_ridged,/area/map_template/facility/room20/medbay)
"PV" = (/obj/machinery/constructable_frame/machine_frame,/turf/simulated/floor/plating,/area/map_template/facility/room20/medbay)
"QI" = (/obj/effect/floor_decal/corner/paleblue{dir = 6},/obj/item/modular_computer/telescreen/preset/medical{pixel_y = 32},/turf/simulated/floor/tiled/white,/area/map_template/facility/room20/medbay)
"Rm" = (/obj/effect/floor_decal/corner/blue{dir = 10},/obj/effect/floor_decal/industrial/outline/yellow,/obj/structure/table/rack,/obj/item/storage/box/syringes{pixel_y = 7},/turf/simulated/floor/tiled/dark,/area/map_template/facility/room20/medbay/back)
"Ru" = (/obj/effect/floor_decal/corner/paleblue{dir = 4},/turf/simulated/floor/tiled/white,/area/map_template/facility/room20/medbay)
"RI" = (/obj/machinery/door/airlock/medical{name = "Operating Room 1"},/turf/simulated/floor/tiled/white/monotile,/area/map_template/facility/room20/medbay)
"RU" = (/obj/effect/floor_decal/corner/blue{dir = 10},/turf/simulated/floor/tiled/dark,/area/map_template/facility/room20/medbay)
"RX" = (/obj/effect/floor_decal/corner/paleblue{dir = 5},/obj/machinery/light/small{dir = 1},/turf/simulated/floor/tiled,/area/map_template/facility/room20/medbay)
"Sc" = (/obj/effect/floor_decal/corner/paleblue{dir = 10},/turf/simulated/floor/tiled/white,/area/map_template/facility/room20/medbay)
"Ss" = (/obj/effect/floor_decal/corner/paleblue{dir = 6},/turf/simulated/floor/tiled,/area/map_template/facility/room20/medbay)
"SE" = (/obj/effect/floor_decal/corner/paleblue{dir = 6},/turf/simulated/floor/tiled/white,/area/map_template/facility/room20/medbay)
"SO" = (/obj/structure/holoplant,/obj/effect/floor_decal/spline/plain/blue{dir = 6},/turf/simulated/floor/lino,/area/map_template/facility/room20/medbay)
"Ty" = (/obj/machinery/floodlight,/turf/simulated/floor/plating,/area/map_template/facility/room20/medbay)
"TW" = (/obj/effect/floor_decal/corner/paleblue{dir = 5},/turf/simulated/floor/tiled/white,/area/map_template/facility/room20/medbay)
"UD" = (/turf/simulated/floor/tiled/steel_grid,/area/map_template/facility/room20/medbay)
"Vi" = (/obj/structure/table/woodentable/maple,/obj/random/drinkbottle,/turf/simulated/floor/lino,/area/map_template/facility/room20/medbay)
"Vs" = (/obj/structure/iv_drip,/obj/effect/floor_decal/industrial/outline/yellow,/turf/simulated/floor/tiled/white/monotile,/area/map_template/facility/room20/medbay)
"VA" = (/obj/random/facility/mercenary/low,/turf/simulated/floor/tiled/steel_ridged,/area/map_template/facility/room20/medbay)
"Wx" = (/obj/effect/floor_decal/spline/plain/blue{dir = 9},/obj/structure/bed/roller,/turf/simulated/floor/tiled/white/monotile,/area/map_template/facility/room20/medbay)
"WD" = (/obj/effect/floor_decal/corner/paleblue{dir = 10},/obj/item/stack/material/steel,/turf/simulated/floor/tiled/white,/area/map_template/facility/room20/medbay)
"WY" = (/obj/effect/floor_decal/spline/plain/blue{dir = 4},/turf/simulated/floor/lino,/area/map_template/facility/room20/medbay)
"Xd" = (/obj/item/stack/material/steel,/turf/simulated/floor/tiled,/area/map_template/facility/room20/medbay)
"Xn" = (/obj/structure/curtain/black,/turf/simulated/floor/tiled/dark/monotile,/area/map_template/facility/room20/medbay)
"XI" = (/obj/item/caution/cone,/turf/simulated/floor/plating,/area/map_template/facility/room20/medbay)
"Ye" = (/obj/item/caution/cone,/turf/simulated/floor/tiled/white,/area/map_template/facility/room20/medbay)
"Yx" = (/obj/structure/sign/warning/nosmoking_1{dir = 8; pixel_x = 32},/turf/simulated/floor/tiled/white,/area/map_template/facility/room20/medbay)
"YI" = (/obj/effect/floor_decal/corner/blue/half{dir = 1},/turf/simulated/floor/tiled/dark/monotile,/area/map_template/facility/room20/medbay/back)
"YJ" = (/obj/machinery/bodyscanner{dir = 8},/obj/effect/floor_decal/corner/red/mono,/obj/machinery/light{dir = 1},/turf/simulated/floor/tiled/white/monotile,/area/map_template/facility/room20/medbay)
"Zv" = (/obj/random/junk,/obj/effect/floor_decal/industrial/outline/yellow,/obj/random/facility/ammo,/obj/structure/closet/crate/freezer,/turf/simulated/floor/tiled/techfloor,/area/map_template/facility/room20/medbay/back)
"ZP" = (/obj/effect/floor_decal/corner/paleblue/half{dir = 8},/obj/effect/floor_decal/corner/paleblue{dir = 4},/turf/simulated/floor/tiled/monotile,/area/map_template/facility/room20/medbay)
"ZS" = (/obj/effect/floor_decal/corner/paleblue/bordercee{dir = 4},/turf/simulated/floor/tiled/white/monotile,/area/map_template/facility/room20/medbay)
"ZU" = (/obj/structure/catwalk,/turf/simulated/floor/plating,/area/map_template/facility/room20/medbay/back)
"ZX" = (/turf/simulated/wall/prepainted,/area/map_template/facility/room20/medbay)

(1,1,1) = {"
zOzOzOzONwzOzOzOzOzOzOzObIbIbIbIbIbIbIbI
zOieZUZUZUZvtkGEpxjkencGyWGrMVZXEIElHUbI
zOtEZUcGcGcGtkobxsYIobskePPPSEwxDviENZbI
zOyAZUExiVYxtkdmRmttARcGMPsYSERIJnPwIibI
zONsDacGjLsYtktktktktktkAGsYKIZXyJsKbsbI
zOcGcGcGrlsYZSeMQIePYJoPPPsYRuZXwxwxwxbI
bIdYlWZXnasYPPScbRlPScACPPPPPVeovSvSvSbI
bIhyOpwxLyPPPPTWvhNPlqPPPPVsqICvvSvSvSvS
bIMSOpwxEooYBtaQSEePBAMQPPYeeoTyHBvSvSvS
bIkIOpZXsHZXZXlPaQGRSczUBtScWDvwlEaAvSbI
bIeDJviUiUfPZXOkePSEWxZXZXXnZXZXZXXnZXbI
bInVtvlfOpiUwxdOePSEAdZXJCJCfaZXJCJCfabI
bImbRUjjRUOUOJwxlklkwxOJOwOpDKZXiUOpDKbI
bIOJKDjngQOJOJMTUDUDOyOJrNKTnZZXnZfOLgbI
bItpfGPnPnZPRXhAaAmKqVOJOJOJOJOJOJOJZXbI
BRUDaAaAUDmKXIaAEnAmqVwxelGazJEulMZXzbVA
bzeomKXdUDeolIvSvSrCSsESJzBEViwIvWZXjqbI
bIvSvSaAUDTyvSvSvSvSSsESJzyNyNJBWYPUzbbI
vSvSvSeoUDOjvSvSvSvSvSwxHukADxbDSOZXafbI
vSvSbIbzBRbzbIbIvSvSbIbIbIbIbIbIbIbIbIbI
"}
