"a" = (/obj/structure/catwalk,/obj/structure/cable{d1 = 1; d2 = 8; icon_state = "1-8"},/obj/machinery/light/small,/obj/random/facility/mercenary/low,/turf/simulated/floor/plating,/area/template_noop)
"b" = (/obj/structure/railing/mapped,/obj/structure/railing/mapped{dir = 8; icon_state = "railing0-1"},/obj/structure/cable/green{d1 = 1; d2 = 2; icon_state = "1-2"},/obj/structure/cable/green{d1 = 1; d2 = 8; icon_state = "1-8"},/turf/simulated/floor/plating,/area/template_noop)
"c" = (/obj/effect/wallframe_spawn/no_grille,/turf/simulated/floor/plating,/area/template_noop)
"d" = (/turf/simulated/floor/tiled/techfloor,/area/template_noop)
"e" = (/obj/structure/cable/green{d1 = 4; d2 = 8; icon_state = "4-8"},/obj/effect/floor_decal/industrial/warning{dir = 8},/obj/structure/sign/warning/detailed{pixel_y = 32},/turf/simulated/floor/plating,/area/template_noop)
"f" = (/obj/effect/floor_decal/corner/blue/half{dir = 1},/turf/simulated/floor/tiled/steel_ridged,/area/template_noop)
"i" = (/obj/machinery/door/airlock/hatch{aiControlDisabled = 1},/turf/simulated/floor/tiled/techfloor/grid,/area/template_noop)
"j" = (/obj/structure/table/rack,/obj/random/loot,/obj/effect/floor_decal/corner/yellow{dir = 9},/turf/simulated/floor/tiled/techfloor,/area/template_noop)
"k" = (/obj/effect/floor_decal/corner/blue/half,/turf/simulated/floor/tiled/steel_ridged,/area/template_noop)
"l" = (/turf/simulated/wall/r_wall/prepainted,/area/template_noop)
"m" = (/obj/structure/cable{d1 = 4; d2 = 8; icon_state = "4-8"},/turf/simulated/wall/r_wall/invincible/prepainted,/area/template_noop)
"n" = (/obj/machinery/power/smes/buildable/preset/on_full,/obj/structure/cable/green{d2 = 4; icon_state = "0-4"},/turf/simulated/floor/plating,/area/template_noop)
"o" = (/turf/unsimulated/mineral{color = "#000000"; name = "void"},/area/template_noop)
"p" = (/obj/structure/catwalk,/obj/structure/cable/green{d1 = 1; d2 = 4; icon_state = "1-4"},/turf/simulated/floor/plating,/area/template_noop)
"q" = (/obj/effect/wallframe_spawn/no_grille,/obj/structure/cable/green{d1 = 1; d2 = 2; icon_state = "1-2"},/turf/simulated/floor/plating,/area/template_noop)
"r" = (/turf/simulated/floor/tiled/steel_ridged,/area/template_noop)
"u" = (/obj/structure/table/rack,/obj/random/tech_supply,/obj/random/toolbox,/obj/effect/floor_decal/industrial/warning{dir = 4},/obj/machinery/light/small{dir = 1},/turf/simulated/floor/plating,/area/template_noop)
"v" = (/obj/structure/table/rack,/obj/random/maintenance,/obj/effect/floor_decal/corner/yellow{dir = 6},/turf/simulated/floor/tiled/techfloor,/area/template_noop)
"w" = (/obj/effect/floor_decal/corner/yellow{dir = 9},/turf/simulated/floor/tiled,/area/template_noop)
"x" = (/obj/structure/cable/green{d1 = 4; d2 = 8; icon_state = "4-8"},/turf/simulated/floor/tiled/dark/monotile,/area/template_noop)
"y" = (/obj/structure/cable/green{d1 = 2; d2 = 8; icon_state = "2-8"},/obj/machinery/door/airlock/hatch{aiControlDisabled = 1},/turf/simulated/floor/tiled/techfloor/grid,/area/template_noop)
"z" = (/obj/structure/catwalk,/obj/structure/cable{d1 = 1; d2 = 2; icon_state = "1-2"},/obj/structure/cable/green{d1 = 4; d2 = 8; icon_state = "4-8"},/turf/simulated/floor/plating,/area/template_noop)
"C" = (/obj/structure/cable/green{d1 = 4; d2 = 8; icon_state = "4-8"},/turf/simulated/wall/r_wall/invincible/prepainted,/area/template_noop)
"D" = (/obj/structure/cable/green{d1 = 1; d2 = 2; icon_state = "1-2"},/turf/simulated/wall/r_wall/prepainted,/area/template_noop)
"E" = (/turf/simulated/wall/r_wall/invincible/prepainted,/area/template_noop)
"F" = (/obj/structure/catwalk,/obj/structure/cable{d1 = 4; d2 = 8; icon_state = "4-8"},/turf/simulated/floor/plating,/area/template_noop)
"G" = (/obj/structure/cable{d1 = 2; d2 = 8; icon_state = "2-8"},/obj/effect/floor_decal/industrial/warning/corner{dir = 1},/turf/simulated/floor/plating,/area/template_noop)
"I" = (/obj/structure/table/rack,/obj/random/maintenance,/obj/effect/floor_decal/corner/yellow{dir = 9},/turf/simulated/floor/tiled/techfloor,/area/template_noop)
"J" = (/obj/effect/floor_decal/industrial/warning/corner{dir = 4},/turf/simulated/floor/plating,/area/template_noop)
"K" = (/obj/effect/floor_decal/corner/blue,/obj/effect/floor_decal/corner/yellow{dir = 9},/obj/machinery/light/small,/turf/simulated/floor/tiled,/area/template_noop)
"L" = (/obj/machinery/light/small,/turf/simulated/floor/tiled/techfloor,/area/template_noop)
"M" = (/obj/structure/cable{d2 = 4; icon_state = "0-4"},/obj/machinery/power/debug_items/infinite_generator{mouse_opacity = 0; alpha = 1},/turf/simulated/floor/tiled/dark/monotile,/area/template_noop)
"N" = (/obj/structure/cable/green{d1 = 2; d2 = 8; icon_state = "2-8"},/turf/simulated/floor/plating,/area/template_noop)
"O" = (/obj/structure/cable/green{d1 = 1; d2 = 2; icon_state = "1-2"},/turf/simulated/wall/r_wall/invincible/prepainted,/area/template_noop)
"R" = (/obj/structure/cable/green{d1 = 1; d2 = 2; icon_state = "1-2"},/turf/simulated/floor/plating,/area/template_noop)
"T" = (/obj/structure/railing/mapped,/obj/structure/cable/green{d1 = 4; d2 = 8; icon_state = "4-8"},/obj/random/maintenance,/obj/random/tool,/obj/random/tool,/obj/random/tool,/obj/structure/closet/toolcloset,/turf/simulated/floor/plating,/area/template_noop)
"U" = (/obj/machinery/power/terminal{dir = 1},/obj/structure/cable{d2 = 4; icon_state = "0-4"},/obj/effect/floor_decal/industrial/warning{dir = 1},/turf/simulated/floor/plating,/area/template_noop)
"W" = (/obj/structure/cable{d1 = 1; d2 = 2; icon_state = "1-2"},/obj/machinery/door/airlock/hatch{aiControlDisabled = 1},/turf/simulated/floor/tiled/techfloor/grid,/area/template_noop)
"X" = (/obj/structure/sign/warning/high_voltage,/turf/simulated/wall/r_wall/invincible/prepainted,/area/template_noop)
"Y" = (/obj/effect/floor_decal/corner/blue{dir = 4},/obj/effect/floor_decal/corner/yellow{dir = 9},/turf/simulated/floor/tiled,/area/template_noop)
"Z" = (/obj/structure/railing/mapped,/obj/structure/railing/mapped{dir = 4; icon_state = "railing0-1"},/obj/structure/cable/green{d1 = 4; d2 = 8; icon_state = "4-8"},/turf/simulated/floor/plating,/area/template_noop)

(1,1,1) = {"
ooEEXEEEoE
ooEuneNEoE
ooEJUGREoE
EEElcWqEXE
oxCTZzblYf
oMmFFapywr
EEElillDKk
ooEjddvOEE
ooEILdvOoE
ooEEEEEOoE
"}
