"a" = (/turf/simulated/wall/r_wall/invincible/prepainted,/area/template_noop)
"b" = (/obj/effect/floor_decal/corner/beige/half,/obj/structure/bed/chair/padded/black{dir = 8},/turf/simulated/floor/tiled/dark/monotile,/area/template_noop)
"c" = (/obj/structure/window/reinforced/crescent{dir = 1},/obj/effect/floor_decal/spline/fancy/black{dir = 1},/obj/effect/decal/cleanable/dirt,/turf/simulated/floor/tiled/dark,/area/template_noop)
"d" = (/turf/unsimulated/mineral{color = "#000000"; name = "void"},/area/template_noop)
"f" = (/obj/effect/floor_decal/corner/beige/half{dir = 8},/obj/effect/floor_decal/corner/beige{dir = 4},/obj/structure/bed/chair/padded/black,/obj/effect/floor_decal/spline/plain/beige{dir = 8},/obj/effect/decal/cleanable/dirt,/turf/simulated/floor/tiled/dark/monotile,/area/template_noop)
"h" = (/obj/structure/window/reinforced/crescent{dir = 4},/obj/effect/floor_decal/spline/fancy/black{dir = 4},/turf/simulated/floor/tiled/dark,/area/template_noop)
"i" = (/obj/effect/floor_decal/corner/beige/half{dir = 4},/obj/effect/floor_decal/corner/beige{dir = 8},/obj/effect/floor_decal/spline/plain/beige{dir = 4},/obj/structure/holoplant,/turf/simulated/floor/tiled/dark/monotile,/area/template_noop)
"j" = (/obj/structure/window/reinforced/crescent{dir = 8},/obj/effect/floor_decal/spline/fancy/black{dir = 8},/turf/simulated/floor/tiled/dark,/area/template_noop)
"k" = (/obj/effect/floor_decal/corner/beige{dir = 1},/obj/machinery/light/small{dir = 1},/obj/effect/decal/cleanable/dirt,/turf/simulated/floor/tiled/dark/monotile,/area/template_noop)
"l" = (/obj/effect/floor_decal/corner/beige/half{dir = 4},/obj/structure/bed/chair/padded/black{dir = 1},/obj/effect/floor_decal/spline/plain/beige{dir = 4},/turf/simulated/floor/tiled/dark/monotile,/area/template_noop)
"m" = (/obj/effect/floor_decal/corner/beige/half{dir = 8},/obj/structure/bed/chair/padded/black,/obj/effect/floor_decal/spline/plain/beige{dir = 8},/obj/effect/decal/cleanable/dirt,/turf/simulated/floor/tiled/dark/monotile,/area/template_noop)
"n" = (/obj/effect/floor_decal/corner/beige/half{dir = 4},/obj/structure/table/steel,/obj/effect/floor_decal/spline/plain/beige{dir = 4},/obj/random/maintenance,/obj/random/junk,/obj/effect/decal/cleanable/dirt,/turf/simulated/floor/tiled/dark/monotile,/area/template_noop)
"o" = (/obj/effect/floor_decal/corner/beige/half{dir = 4},/obj/effect/floor_decal/spline/plain/beige{dir = 4},/obj/machinery/light{dir = 4},/obj/effect/decal/cleanable/dirt,/obj/random/facility/mercenary/low,/turf/simulated/floor/tiled/dark/monotile,/area/template_noop)
"p" = (/obj/structure/window/reinforced/crescent,/obj/effect/floor_decal/spline/fancy/black,/turf/simulated/floor/tiled/dark,/area/template_noop)
"q" = (/obj/effect/floor_decal/spline/fancy/black/corner{dir = 4},/obj/effect/decal/cleanable/dirt,/turf/simulated/floor/tiled/dark,/area/template_noop)
"r" = (/obj/effect/floor_decal/corner/beige/half{dir = 4},/obj/structure/bed/chair/padded/black,/obj/effect/floor_decal/spline/plain/beige{dir = 4},/obj/effect/decal/cleanable/dirt,/turf/simulated/floor/tiled/dark/monotile,/area/template_noop)
"s" = (/obj/effect/floor_decal/corner/black{dir = 10},/turf/simulated/floor/tiled/steel_ridged,/area/template_noop)
"t" = (/obj/effect/floor_decal/corner/beige/half{dir = 8},/obj/structure/table/steel,/obj/effect/floor_decal/spline/plain/beige{dir = 8},/obj/random/junk,/obj/random/snack,/obj/effect/decal/cleanable/dirt,/turf/simulated/floor/tiled/dark/monotile,/area/template_noop)
"v" = (/obj/effect/floor_decal/corner/beige/half,/obj/structure/bed/chair/padded/black{dir = 4},/obj/effect/decal/cleanable/dirt,/turf/simulated/floor/tiled/dark/monotile,/area/template_noop)
"x" = (/obj/effect/floor_decal/corner/beige/half,/obj/structure/table/steel,/obj/random/snack,/turf/simulated/floor/tiled/dark/monotile,/area/template_noop)
"y" = (/obj/effect/floor_decal/corner/beige/half{dir = 8},/obj/effect/floor_decal/spline/plain/beige{dir = 8},/obj/machinery/light{dir = 8},/obj/effect/decal/cleanable/dirt,/turf/simulated/floor/tiled/dark/monotile,/area/template_noop)
"B" = (/obj/effect/decal/cleanable/dirt,/turf/simulated/floor/tiled/dark,/area/template_noop)
"C" = (/obj/structure/window/reinforced/crescent,/obj/effect/floor_decal/spline/fancy/black,/obj/effect/decal/cleanable/dirt,/turf/simulated/floor/tiled/dark,/area/template_noop)
"D" = (/obj/effect/floor_decal/spline/fancy/black/corner,/turf/simulated/floor/tiled/dark,/area/template_noop)
"E" = (/obj/effect/floor_decal/corner/beige/half{dir = 4},/obj/structure/table/steel,/obj/effect/floor_decal/spline/plain/beige{dir = 4},/obj/random/junk,/obj/effect/decal/cleanable/dirt,/turf/simulated/floor/tiled/dark/monotile,/area/template_noop)
"F" = (/turf/space,/area/template_noop)
"J" = (/obj/structure/window/reinforced/crescent{dir = 8},/obj/effect/floor_decal/spline/fancy/black{dir = 8},/obj/effect/decal/cleanable/dirt,/turf/simulated/floor/tiled/dark,/area/template_noop)
"K" = (/obj/effect/floor_decal/corner/beige/half{dir = 8},/obj/structure/bed/chair/padded/black{dir = 1},/obj/effect/floor_decal/spline/plain/beige{dir = 8},/turf/simulated/floor/tiled/dark/monotile,/area/template_noop)
"M" = (/obj/structure/window/reinforced/crescent{dir = 4},/obj/effect/floor_decal/spline/fancy/black{dir = 4},/obj/effect/decal/cleanable/dirt,/turf/simulated/floor/tiled/dark,/area/template_noop)
"N" = (/obj/effect/floor_decal/spline/fancy/black/corner{dir = 8},/obj/effect/decal/cleanable/dirt,/turf/simulated/floor/tiled/dark,/area/template_noop)
"O" = (/obj/effect/floor_decal/corner/black{dir = 10},/obj/effect/decal/cleanable/dirt,/turf/simulated/floor/tiled/steel_ridged,/area/template_noop)
"P" = (/obj/effect/floor_decal/corner/beige/half{dir = 4},/obj/effect/floor_decal/corner/beige{dir = 1},/obj/structure/bed/chair/padded/black,/obj/effect/floor_decal/spline/plain/beige{dir = 4},/turf/simulated/floor/tiled/dark/monotile,/area/template_noop)
"S" = (/obj/effect/floor_decal/corner/beige/half{dir = 8},/obj/structure/bed/chair/padded/black{dir = 1},/obj/effect/floor_decal/spline/plain/beige{dir = 8},/obj/effect/decal/cleanable/dirt,/turf/simulated/floor/tiled/dark/monotile,/area/template_noop)
"T" = (/obj/effect/floor_decal/spline/fancy/black/corner{dir = 1},/turf/simulated/floor/tiled/dark,/area/template_noop)
"W" = (/obj/effect/floor_decal/corner/beige{dir = 4},/obj/machinery/light/small{dir = 1},/turf/simulated/floor/tiled/dark/monotile,/area/template_noop)
"Y" = (/obj/effect/floor_decal/corner/beige/half,/obj/machinery/light/small,/obj/effect/decal/cleanable/dirt,/turf/simulated/floor/tiled/dark/monotile,/area/template_noop)
"Z" = (/obj/effect/floor_decal/corner/beige/half{dir = 8},/obj/effect/floor_decal/corner/beige,/obj/effect/floor_decal/spline/plain/beige{dir = 8},/obj/structure/holoplant,/turf/simulated/floor/tiled/dark/monotile,/area/template_noop)

(1,1,1) = {"
aaasOOaaaa
afkBBBWPad
atDpCpNEad
aSMFFFJlad
ayMFFFJoad
amhFFFjrad
athFFFJnad
aKTcccqlad
aZYvxbYiad
aaaaaaaaad
"}
