"d" = (/turf/simulated/floor/tiled/steel_grid,/area/template_noop)
"g" = (/obj/effect/floor_decal/corner/blue{dir = 10},/obj/effect/decal/cleanable/dirt,/obj/effect/decal/cleanable/dirt,/obj/effect/decal/cleanable/dirt,/obj/effect/decal/cleanable/dirt,/obj/random/trash,/obj/item/material/shard,/turf/simulated/floor/tiled/dark,/area/template_noop)
"h" = (/obj/effect/decal/cleanable/dirt,/obj/effect/decal/cleanable/dirt,/obj/effect/decal/cleanable/dirt,/obj/effect/decal/cleanable/dirt,/obj/random/trash,/obj/random/junk,/obj/item/stack/material/rods,/turf/simulated/floor/plating,/area/template_noop)
"i" = (/obj/effect/floor_decal/corner/blue/half{dir = 1},/turf/simulated/floor/tiled/steel_ridged,/area/template_noop)
"j" = (/obj/effect/decal/cleanable/dirt,/obj/effect/decal/cleanable/dirt,/obj/effect/decal/cleanable/dirt,/obj/effect/decal/cleanable/dirt,/obj/effect/decal/cleanable/dirt,/obj/random/trash,/obj/random/trash,/obj/item/stack/material/rods,/obj/item/stack/material/rods,/obj/item/material/shard,/obj/item/material/shard,/obj/structure/sign/warning/nosmoking_1{dir = 4; pixel_x = -32},/turf/simulated/floor/plating,/area/template_noop)
"l" = (/turf/simulated/wall/r_wall/invincible/prepainted,/area/template_noop)
"m" = (/turf/unsimulated/mineral,/area/template_noop)
"n" = (/obj/effect/decal/cleanable/dirt,/obj/effect/decal/cleanable/dirt,/obj/effect/decal/cleanable/dirt,/obj/effect/decal/cleanable/dirt,/obj/random/trash,/obj/random/trash,/obj/item/stack/material/rods,/turf/simulated/floor/plating,/area/template_noop)
"p" = (/turf/simulated/floor/tiled/steel_ridged,/area/template_noop)
"q" = (/obj/effect/floor_decal/corner/blue/three_quarters{dir = 1},/obj/structure/sign/warning/nosmoking_1{pixel_y = 24},/turf/simulated/floor/tiled,/area/template_noop)
"r" = (/obj/effect/decal/cleanable/dirt,/obj/effect/decal/cleanable/dirt,/obj/effect/decal/cleanable/dirt,/obj/effect/decal/cleanable/dirt,/obj/effect/decal/cleanable/dirt,/obj/random/trash,/obj/machinery/light/small/red{dir = 8},/obj/item/material/shard,/turf/simulated/floor/plating,/area/template_noop)
"t" = (/obj/effect/floor_decal/corner/blue/three_quarters{dir = 8},/obj/effect/decal/cleanable/dirt,/obj/effect/decal/cleanable/dirt,/obj/random/trash,/turf/simulated/floor/tiled/dark,/area/template_noop)
"u" = (/obj/machinery/door/airlock/civilian{name = "Office"},/turf/simulated/floor/tiled/steel_ridged,/area/template_noop)
"w" = (/obj/effect/floor_decal/corner/blue{dir = 6},/turf/simulated/floor/tiled/steel_grid,/area/template_noop)
"z" = (/obj/effect/floor_decal/corner/blue{dir = 10},/turf/simulated/floor/tiled,/area/template_noop)
"C" = (/obj/effect/floor_decal/corner/blue/half,/turf/simulated/floor/tiled/steel_ridged,/area/template_noop)
"E" = (/turf/unsimulated/mineral{color = "#000000"; name = "void"},/area/template_noop)
"F" = (/obj/effect/floor_decal/corner/blue{dir = 5},/obj/machinery/light/small{dir = 1},/turf/simulated/floor/tiled,/area/template_noop)
"R" = (/obj/effect/floor_decal/corner/blue/three_quarters{dir = 4},/turf/simulated/floor/tiled,/area/template_noop)
"W" = (/obj/effect/floor_decal/corner/blue/three_quarters,/obj/effect/decal/cleanable/dirt,/obj/effect/decal/cleanable/dirt,/obj/effect/decal/cleanable/dirt,/obj/random/trash,/turf/simulated/floor/tiled/dark,/area/template_noop)
"X" = (/obj/effect/decal/cleanable/dirt,/obj/effect/decal/cleanable/dirt,/obj/effect/decal/cleanable/dirt,/obj/effect/decal/cleanable/dirt,/obj/effect/decal/cleanable/dirt,/obj/random/trash,/obj/random/trash,/obj/random/junk,/obj/item/stack/material/rods,/turf/simulated/floor/plating,/area/template_noop)

(1,1,1) = {"
lEEEEEEEEE
lEEEEEEEEE
lEElllllll
llllthmmml
iFqlrnmmml
pdwuXmmmml
CzRljmmmml
llllWgmmml
lEElllllll
lEEEEEEEEE
"}
