"aJ" = (/obj/structure/table/marble,/obj/effect/floor_decal/corner/black/mono,/obj/item/reagent_containers/food/condiment/cornoil{pixel_x = -14},/obj/item/reagent_containers/food/drinks/milk{volume = 5000; desc = "It's milk. White and nutritious goodness! Something strange about this carton... Its..."},/turf/simulated/floor/tiled/white/monotile,/area/template_noop)
"aP" = (/obj/structure/bed/chair/padded/black{dir = 4},/obj/effect/floor_decal/spline/fancy/wood{dir = 8},/turf/simulated/floor/wood/ebony,/area/template_noop)
"bc" = (/obj/structure/table/marble,/obj/effect/floor_decal/corner/black/mono,/obj/item/reagent_containers/food/condiment/salt{name = "REALLY HUGE bag of salt"; volume = 5000; starting_reagents = list(/datum/reagent/sodiumchloride=5000); attack_cooldown = 15; force = 15; throwforce = 25},/turf/simulated/floor/tiled/white/monotile,/area/template_noop)
"bl" = (/obj/effect/floor_decal/corner/blue/border{dir = 8},/turf/simulated/floor/tiled/dark/monotile,/area/template_noop)
"bo" = (/obj/structure/table/standard,/obj/machinery/fabricator/micro/bartender{pixel_x = -3},/obj/effect/floor_decal/corner/black/border{dir = 1},/obj/item/reagent_containers/food/drinks/glass2/shot{icon_state = "shot"; pixel_x = 6},/obj/machinery/light{dir = 1},/turf/simulated/floor/tiled/dark/monotile,/area/template_noop)
"bp" = (/obj/structure/table/woodentable/walnut,/turf/simulated/floor/carpet/red,/area/template_noop)
"bI" = (/obj/effect/paint_stripe/brown,/turf/simulated/wall/r_wall/invincible/prepainted,/area/template_noop)
"cU" = (/obj/structure/bed/sofa/black/left,/turf/simulated/floor/wood/ebony,/area/template_noop)
"dd" = (/obj/structure/bed/sofa/black{dir = 4},/turf/simulated/floor/carpet/red,/area/template_noop)
"de" = (/obj/item/stool/bar/padded,/turf/simulated/floor/wood/ebony,/area/template_noop)
"do" = (/obj/structure/table/marble,/obj/effect/floor_decal/corner/black{dir = 6},/obj/item/reagent_containers/food/snacks/hamburger{pixel_x = 5},/obj/item/reagent_containers/food/condiment/mint{pixel_x = -7; starting_reagents = list(/datum/reagent/nutriment/mint=50)},/turf/simulated/floor/tiled/white,/area/template_noop)
"dp" = (/obj/effect/floor_decal/spline/fancy/wood{dir = 9},/turf/simulated/floor/wood/ebony,/area/template_noop)
"dH" = (/obj/structure/bed/sofa/black/left{dir = 8},/turf/simulated/floor/carpet/magenta,/area/template_noop)
"dW" = (/obj/effect/floor_decal/corner/beige{dir = 5},/obj/effect/floor_decal/borderfloorblack/corner,/obj/effect/floor_decal/corner/black{dir = 8},/turf/simulated/floor/tiled/dark,/area/template_noop)
"ea" = (/obj/effect/floor_decal/borderfloorblack{dir = 9},/obj/effect/floor_decal/corner/black,/turf/simulated/floor/tiled/dark,/area/template_noop)
"ef" = (/obj/effect/floor_decal/corner/grey/three_quarters{dir = 4},/turf/simulated/floor/tiled/white,/area/template_noop)
"eJ" = (/obj/effect/floor_decal/corner/black{dir = 5},/obj/structure/closet/chefcloset,/obj/machinery/light{dir = 1},/turf/simulated/floor/tiled/white,/area/template_noop)
"eY" = (/obj/structure/table/woodentable/walnut,/obj/item/reagent_containers/food/drinks/glass2/shot{icon_state = "shot"; pixel_x = -7},/obj/item/reagent_containers/food/drinks/glass2/shot{icon_state = "shot"; pixel_x = 6},/turf/simulated/floor/wood/ebony,/area/template_noop)
"fv" = (/obj/effect/floor_decal/corner/black/border{dir = 5},/obj/machinery/chem_master/condimaster,/turf/simulated/floor/tiled/white/monotile,/area/template_noop)
"fO" = (/obj/structure/bed/chair/padded/black,/obj/effect/floor_decal/spline/fancy/wood{dir = 1},/turf/simulated/floor/wood/ebony,/area/template_noop)
"fQ" = (/obj/effect/floor_decal/corner/black{dir = 5},/obj/structure/closet/secure_closet/bar{req_access = list()},/obj/item/reagent_containers/food/drinks/bottle/premiumwine{desc = "You feel pretentious just looking at it. Label on the side '1890'"; name = "Decayed Uve De Blanc"},/turf/simulated/floor/tiled/white,/area/template_noop)
"gd" = (/obj/structure/synthesized_instrument/synthesizer/piano,/obj/structure/railing/mapped{dir = 1; icon_state = "railing0-1"},/obj/effect/floor_decal/corner/blue/half{dir = 1},/turf/simulated/floor/tiled/dark/monotile,/area/template_noop)
"gt" = (/obj/structure/bed/sofa/black/left{dir = 10},/turf/simulated/floor/wood/ebony,/area/template_noop)
"hf" = (/obj/structure/bed/chair/padded/black{dir = 1},/turf/simulated/floor/wood/ebony,/area/template_noop)
"hv" = (/obj/structure/bed/sofa/black/left{dir = 6},/turf/simulated/floor/carpet/magenta,/area/template_noop)
"hE" = (/obj/structure/bed/sofa/black,/turf/simulated/floor/carpet/magenta,/area/template_noop)
"hS" = (/obj/structure/bed/sofa/black,/obj/machinery/light{dir = 1},/turf/simulated/floor/carpet/red,/area/template_noop)
"ic" = (/obj/structure/bed/sofa/black,/obj/machinery/light{dir = 1},/turf/simulated/floor/wood/ebony,/area/template_noop)
"is" = (/obj/structure/bed/sofa/black/left,/turf/simulated/floor/carpet/magenta,/area/template_noop)
"it" = (/obj/effect/floor_decal/borderfloorblack,/obj/effect/floor_decal/corner/black{dir = 5},/turf/simulated/floor/tiled/dark,/area/template_noop)
"iv" = (/obj/structure/table/marble,/obj/effect/floor_decal/corner/black/border,/obj/item/reagent_containers/food/snacks/fatsausage,/turf/simulated/floor/tiled/dark/monotile,/area/template_noop)
"ji" = (/obj/effect/floor_decal/spline/fancy/wood,/obj/structure/curtain/open,/turf/simulated/floor/wood/ebony,/area/template_noop)
"jw" = (/obj/structure/railing/mapped{dir = 1; icon_state = "railing0-1"},/obj/effect/floor_decal/corner/blue/half{dir = 8},/obj/effect/floor_decal/corner/blue{dir = 4},/turf/simulated/floor/tiled/dark/monotile,/area/template_noop)
"jx" = (/obj/structure/table/marble,/obj/machinery/microwave{pixel_x = -3; pixel_y = 6},/obj/effect/floor_decal/corner/black/border{dir = 6},/turf/simulated/floor/tiled/white/monotile,/area/template_noop)
"jR" = (/obj/structure/bed/sofa/black/left{dir = 10},/turf/simulated/floor/carpet/magenta,/area/template_noop)
"kc" = (/obj/effect/floor_decal/spline/fancy/wood/corner{dir = 1},/obj/effect/floor_decal/spline/fancy/wood{dir = 8},/turf/simulated/floor/wood/ebony,/area/template_noop)
"ki" = (/obj/structure/bed/sofa/black/right{dir = 4},/turf/simulated/floor/carpet/magenta,/area/template_noop)
"kv" = (/obj/structure/table/marble,/obj/effect/floor_decal/corner/black/border,/obj/item/reagent_containers/food/snacks/meatsteak/toxin,/turf/simulated/floor/tiled/dark/monotile,/area/template_noop)
"kC" = (/obj/structure/table/woodentable/walnut,/obj/item/device/flashlight/lamp/lava/red{pixel_y = 6},/turf/simulated/floor/carpet/red,/area/template_noop)
"kL" = (/obj/structure/table/standard,/obj/machinery/chemical_dispenser/bar_coffee/full{pixel_y = 10},/obj/effect/floor_decal/corner/black/border{dir = 1},/turf/simulated/floor/tiled/dark/monotile,/area/template_noop)
"kO" = (/obj/effect/floor_decal/corner/blue/border{dir = 1},/obj/random/facility/mercenary/low,/turf/simulated/floor/tiled/dark/monotile,/area/template_noop)
"lr" = (/obj/structure/table/woodentable/walnut,/obj/item/reagent_containers/food/snacks/greek_salad,/turf/simulated/floor/carpet/red,/area/template_noop)
"ls" = (/obj/effect/floor_decal/borderfloorblack{dir = 8},/obj/effect/floor_decal/corner/black{dir = 6},/turf/simulated/floor/tiled/dark,/area/template_noop)
"mb" = (/obj/structure/bed/sofa/black/right{dir = 4},/obj/machinery/light{dir = 8},/turf/simulated/floor/wood/ebony,/area/template_noop)
"mh" = (/obj/structure/table/marble,/obj/machinery/microwave{pixel_x = -3; pixel_y = 6},/obj/effect/floor_decal/corner/black/border{dir = 4},/turf/simulated/floor/tiled/white/monotile,/area/template_noop)
"mu" = (/obj/effect/floor_decal/spline/fancy/wood{dir = 10},/turf/simulated/floor/wood/ebony,/area/template_noop)
"mT" = (/obj/random/facility/mercenary/high,/turf/simulated/floor/tiled/dark,/area/template_noop)
"mU" = (/obj/structure/curtain/black,/turf/simulated/floor/tiled/dark/monotile,/area/template_noop)
"nr" = (/obj/structure/bed/sofa/black/left{dir = 1},/turf/simulated/floor/carpet/magenta,/area/template_noop)
"ny" = (/obj/structure/table/marble,/obj/effect/floor_decal/corner/black{dir = 6},/obj/item/reagent_containers/food/snacks/hotchili,/obj/item/reagent_containers/glass/beaker/bowl{pixel_y = 14},/turf/simulated/floor/tiled/white,/area/template_noop)
"ot" = (/turf/simulated/wall/walnut,/area/template_noop)
"oC" = (/obj/effect/floor_decal/corner/grey{dir = 9},/obj/machinery/light{dir = 8},/turf/simulated/floor/tiled/white,/area/template_noop)
"oM" = (/obj/effect/floor_decal/corner/beige{dir = 4},/obj/effect/floor_decal/corner/blue/border,/turf/simulated/floor/tiled/dark/monotile,/area/template_noop)
"oO" = (/obj/effect/floor_decal/corner/blue/bordercorner{dir = 4},/turf/simulated/floor/tiled/dark/monotile,/area/template_noop)
"pM" = (/obj/random/facility/mercenary/high,/turf/simulated/floor/wood/ebony,/area/template_noop)
"pT" = (/obj/structure/bed/sofa/black/left{dir = 6},/turf/simulated/floor/carpet/red,/area/template_noop)
"qn" = (/obj/structure/table/woodentable/walnut,/obj/effect/floor_decal/spline/fancy/wood{dir = 4},/obj/item/device/flashlight/lamp/lava/purple{pixel_x = -5; pixel_y = 3},/turf/simulated/floor/wood/ebony,/area/template_noop)
"qr" = (/obj/effect/floor_decal/borderfloorblack{dir = 1},/obj/effect/floor_decal/corner/black{dir = 10},/turf/simulated/floor/tiled/dark,/area/template_noop)
"qL" = (/obj/effect/floor_decal/borderfloorblack{dir = 8},/obj/effect/floor_decal/corner/black{dir = 6},/obj/random/facility/mercenary/low,/turf/simulated/floor/tiled/dark,/area/template_noop)
"qS" = (/obj/effect/floor_decal/corner/black/mono,/turf/simulated/floor/tiled/white/monotile,/area/template_noop)
"rv" = (/obj/structure/bed/sofa/black/right,/obj/effect/floor_decal/spline/fancy/wood{dir = 4},/turf/simulated/floor/wood/ebony,/area/template_noop)
"rz" = (/obj/structure/table/marble,/obj/effect/floor_decal/corner/black/border,/turf/simulated/floor/tiled/dark/monotile,/area/template_noop)
"rG" = (/obj/structure/bed/sofa/black/right,/turf/simulated/floor/carpet/magenta,/area/template_noop)
"sl" = (/obj/effect/floor_decal/corner/beige{dir = 6},/obj/effect/floor_decal/borderfloorblack/corner{dir = 1},/obj/effect/floor_decal/corner/black{dir = 8},/turf/simulated/floor/tiled/dark,/area/template_noop)
"sm" = (/obj/effect/floor_decal/spline/fancy/wood,/turf/simulated/floor/wood/ebony,/area/template_noop)
"sE" = (/obj/structure/table/marble,/obj/effect/floor_decal/corner/black/border{dir = 10},/obj/item/reagent_containers/food/drinks/pitcher{pixel_x = 8; pixel_y = 10},/turf/simulated/floor/tiled/dark/monotile,/area/template_noop)
"sH" = (/obj/structure/railing/mapped{dir = 1; icon_state = "railing0-1"},/obj/effect/floor_decal/corner/blue/half{dir = 4},/obj/effect/floor_decal/corner/blue{dir = 1},/turf/simulated/floor/tiled/dark/monotile,/area/template_noop)
"sS" = (/obj/structure/bed/sofa/black/right{dir = 8},/turf/simulated/floor/carpet/magenta,/area/template_noop)
"sW" = (/obj/effect/floor_decal/corner/grey{dir = 10},/turf/simulated/floor/tiled/white,/area/template_noop)
"ti" = (/obj/machinery/light{dir = 1},/turf/simulated/floor/wood/ebony,/area/template_noop)
"tJ" = (/obj/effect/floor_decal/corner/grey/three_quarters{dir = 8},/turf/simulated/floor/tiled/white,/area/template_noop)
"uX" = (/obj/structure/table/woodentable/walnut,/obj/item/reagent_containers/food/condiment/small/saltshaker{pixel_x = -3},/obj/item/reagent_containers/food/condiment/small/peppermill{pixel_x = 3},/turf/simulated/floor/carpet/magenta,/area/template_noop)
"vu" = (/obj/effect/floor_decal/borderfloorblack{dir = 4},/obj/effect/floor_decal/corner/black{dir = 9},/obj/machinery/light{dir = 4},/turf/simulated/floor/tiled/dark,/area/template_noop)
"vG" = (/obj/effect/floor_decal/corner/grey/three_quarters{dir = 1},/turf/simulated/floor/tiled/white,/area/template_noop)
"vL" = (/obj/effect/floor_decal/corner/black{dir = 5},/obj/effect/floor_decal/corner/black,/obj/machinery/vending/dinnerware,/turf/simulated/floor/tiled/white,/area/template_noop)
"vS" = (/obj/structure/table/woodentable/walnut,/obj/item/device/flashlight/lamp/lava/red{pixel_y = 6},/turf/simulated/floor/wood/ebony,/area/template_noop)
"we" = (/obj/effect/floor_decal/corner/grey{dir = 1},/turf/simulated/floor/tiled/white,/area/template_noop)
"wL" = (/obj/structure/table/woodentable/walnut,/turf/simulated/floor/carpet/magenta,/area/template_noop)
"wO" = (/obj/effect/floor_decal/corner/grey/three_quarters,/obj/structure/closet/secure_closet/freezer/fridge,/obj/item/reagent_containers/food/condiment/enzyme,/obj/item/reagent_containers/food/condiment/enzyme,/obj/item/reagent_containers/food/condiment/enzyme,/obj/item/reagent_containers/food/snacks/sliceable/bread,/obj/item/reagent_containers/food/snacks/sliceable/bread,/turf/simulated/floor/tiled/white,/area/template_noop)
"xu" = (/turf/simulated/floor/wood/ebony,/area/template_noop)
"xF" = (/obj/effect/floor_decal/spline/fancy/wood{dir = 4},/obj/effect/floor_decal/spline/fancy/wood/corner{dir = 8},/obj/random/facility/mercenary,/turf/simulated/floor/wood/ebony,/area/template_noop)
"yj" = (/obj/effect/floor_decal/spline/fancy/wood{dir = 4},/obj/effect/floor_decal/spline/fancy/wood/corner{dir = 8},/obj/random/facility/mercenary/high,/turf/simulated/floor/wood/ebony,/area/template_noop)
"yP" = (/obj/structure/table/woodentable/walnut,/obj/item/reagent_containers/food/drinks/glass2/rocks{icon_state = "rocks"; pixel_y = 11},/turf/simulated/floor/carpet/magenta,/area/template_noop)
"yY" = (/obj/structure/bed/sofa/black/left{dir = 6},/turf/simulated/floor/wood/ebony,/area/template_noop)
"zb" = (/obj/effect/floor_decal/corner/blue/border{dir = 1},/turf/simulated/floor/tiled/dark/monotile,/area/template_noop)
"zm" = (/obj/effect/floor_decal/corner/grey{dir = 9},/turf/simulated/floor/tiled/white,/area/template_noop)
"zt" = (/turf/simulated/floor/tiled/dark,/area/template_noop)
"zv" = (/obj/effect/floor_decal/spline/fancy/wood/corner,/turf/simulated/floor/wood/ebony,/area/template_noop)
"zA" = (/obj/structure/table/woodentable/walnut,/obj/item/reagent_containers/food/drinks/bottle/brandy,/turf/simulated/floor/carpet/magenta,/area/template_noop)
"zK" = (/obj/structure/bed/sofa/black/left{dir = 8},/turf/simulated/floor/wood/ebony,/area/template_noop)
"Al" = (/obj/effect/floor_decal/spline/fancy/wood,/obj/effect/floor_decal/spline/fancy/wood{dir = 1},/obj/machinery/light{dir = 4},/turf/simulated/floor/wood/ebony,/area/template_noop)
"BI" = (/obj/structure/table/woodentable/walnut,/obj/item/reagent_containers/food/snacks/friedegg,/turf/simulated/floor/carpet/magenta,/area/template_noop)
"Ch" = (/obj/effect/floor_decal/spline/fancy/wood{dir = 8},/obj/random/facility/mercenary/medium,/turf/simulated/floor/wood/ebony,/area/template_noop)
"Cv" = (/obj/effect/floor_decal/spline/fancy/wood/corner,/obj/effect/floor_decal/spline/fancy/wood/corner{dir = 4},/obj/effect/floor_decal/spline/fancy/wood/corner{dir = 1},/turf/simulated/floor/wood/ebony,/area/template_noop)
"CV" = (/obj/effect/floor_decal/corner/blue/bordercorner{dir = 1},/turf/simulated/floor/tiled/dark/monotile,/area/template_noop)
"Dk" = (/obj/machinery/cooker/grill,/obj/effect/floor_decal/corner/black/border{dir = 4},/obj/item/reagent_containers/food/snacks/cutlet,/obj/item/reagent_containers/food/snacks/cutlet{pixel_y = 4},/obj/item/reagent_containers/food/snacks/cutlet{pixel_y = 8},/obj/machinery/light{dir = 8},/turf/simulated/floor/tiled/white/monotile,/area/template_noop)
"DC" = (/obj/effect/floor_decal/corner/black{dir = 5},/obj/item/reagent_containers/food/condiment/cornoil,/obj/item/reagent_containers/food/condiment/cornoil,/obj/item/reagent_containers/food/condiment/cornoil,/obj/item/reagent_containers/food/condiment/cornoil,/obj/item/reagent_containers/food/condiment/cornoil,/obj/item/reagent_containers/food/condiment/barbecue,/obj/item/reagent_containers/food/condiment/barbecue,/obj/item/reagent_containers/food/condiment/barbecue,/obj/item/reagent_containers/food/condiment/enzyme,/obj/item/reagent_containers/food/condiment/enzyme,/obj/item/reagent_containers/food/condiment/enzyme,/obj/item/reagent_containers/food/condiment/enzyme,/obj/item/reagent_containers/food/condiment/flour,/obj/item/reagent_containers/food/condiment/flour,/obj/item/reagent_containers/food/condiment/flour,/obj/item/reagent_containers/food/condiment/flour,/obj/item/reagent_containers/food/condiment/flour,/obj/item/reagent_containers/food/condiment/ketchup,/obj/item/reagent_containers/food/condiment/ketchup,/obj/item/reagent_containers/food/condiment/ketchup,/obj/item/reagent_containers/food/condiment/ketchup,/obj/structure/closet/crate/freezer,/turf/simulated/floor/tiled/white,/area/template_noop)
"DU" = (/obj/effect/floor_decal/spline/fancy/wood{dir = 1},/turf/simulated/floor/wood/ebony,/area/template_noop)
"DZ" = (/obj/structure/table/marble,/obj/effect/floor_decal/corner/black/border,/obj/item/reagent_containers/food/drinks/glass2/rocks{icon_state = "rocks"; pixel_y = 11},/turf/simulated/floor/tiled/dark/monotile,/area/template_noop)
"Ee" = (/obj/effect/floor_decal/spline/fancy/wood,/obj/effect/floor_decal/spline/fancy/wood{dir = 1},/turf/simulated/floor/wood/ebony,/area/template_noop)
"El" = (/obj/structure/table/marble,/obj/effect/floor_decal/corner/black/border{dir = 8},/obj/item/reagent_containers/food/drinks/glass2/shot{icon_state = "shot"; pixel_x = 6},/turf/simulated/floor/tiled/dark/monotile,/area/template_noop)
"Ex" = (/obj/structure/bed/sofa/black/left{dir = 8},/turf/simulated/floor/carpet/red,/area/template_noop)
"EK" = (/obj/machinery/door/airlock/civilian{name = "Galley"},/obj/effect/floor_decal/corner/black/mono,/turf/simulated/floor/tiled/dark/monotile,/area/template_noop)
"Fj" = (/obj/structure/table/marble,/obj/effect/floor_decal/corner/black/border,/obj/item/reagent_containers/food/snacks/cracker{name = "planet cracker"; bitesize = 0.000001; nutriment_amt = 10000; volume = 50000},/turf/simulated/floor/tiled/dark/monotile,/area/template_noop)
"FL" = (/obj/structure/table/standard,/obj/machinery/reagentgrinder/juicer{layer = 2.24; pixel_x = -4; pixel_y = 19},/obj/item/reagent_containers/glass/beaker/large,/obj/effect/floor_decal/corner/black/border{dir = 1},/turf/simulated/floor/tiled/dark/monotile,/area/template_noop)
"Gb" = (/obj/effect/floor_decal/corner/grey{dir = 9},/obj/random/facility/mercenary/high,/turf/simulated/floor/tiled/white,/area/template_noop)
"GE" = (/obj/effect/floor_decal/spline/fancy/wood,/obj/machinery/light{dir = 1},/turf/simulated/floor/wood/ebony,/area/template_noop)
"GJ" = (/obj/structure/table/standard,/obj/machinery/chemical_dispenser/bar_alc/full{pixel_y = 10},/obj/effect/floor_decal/corner/black/border{dir = 1},/turf/simulated/floor/tiled/dark/monotile,/area/template_noop)
"Hn" = (/obj/structure/hygiene/sink/kitchen{pixel_x = -32},/turf/simulated/floor/tiled/dark,/area/template_noop)
"Ho" = (/obj/effect/floor_decal/borderfloorblack{dir = 6},/obj/effect/floor_decal/corner/black{dir = 1},/turf/simulated/floor/tiled/dark,/area/template_noop)
"HC" = (/obj/effect/floor_decal/spline/fancy/wood{dir = 4},/turf/simulated/floor/wood/ebony,/area/template_noop)
"IF" = (/obj/effect/floor_decal/corner/blue/border{dir = 4},/turf/simulated/floor/tiled/dark/monotile,/area/template_noop)
"IO" = (/obj/effect/floor_decal/corner/blue/half{dir = 4},/turf/simulated/floor/tiled/dark/monotile,/area/template_noop)
"Js" = (/obj/machinery/vending/boozeomat{req_access = list()},/obj/effect/floor_decal/corner/black/border{dir = 5},/turf/simulated/floor/tiled/dark/monotile,/area/template_noop)
"JG" = (/obj/effect/floor_decal/corner/blue/bordercorner,/turf/simulated/floor/tiled/dark/monotile,/area/template_noop)
"Kb" = (/obj/effect/floor_decal/corner/grey{dir = 6},/turf/simulated/floor/tiled/white,/area/template_noop)
"Kn" = (/obj/effect/floor_decal/corner/grey/three_quarters{dir = 1},/obj/machinery/light{dir = 4},/turf/simulated/floor/tiled/white,/area/template_noop)
"KB" = (/obj/effect/floor_decal/borderfloorblack{dir = 4},/obj/effect/floor_decal/corner/black{dir = 9},/turf/simulated/floor/tiled/dark,/area/template_noop)
"KD" = (/obj/effect/floor_decal/spline/fancy/wood{dir = 6},/turf/simulated/floor/wood/ebony,/area/template_noop)
"KF" = (/obj/structure/bed/sofa/black/right{dir = 8},/turf/simulated/floor/wood/ebony,/area/template_noop)
"KJ" = (/obj/effect/floor_decal/corner/grey{dir = 10},/obj/structure/closet/secure_closet/freezer/meat,/obj/item/reagent_containers/food/snacks/canned/caviar/true,/turf/simulated/floor/tiled/white,/area/template_noop)
"KS" = (/obj/structure/bed/sofa/black{dir = 8},/turf/simulated/floor/carpet/red,/area/template_noop)
"KX" = (/turf/simulated/wall/r_wall/invincible/prepainted,/area/template_noop)
"Lk" = (/obj/item/stool/bar/padded,/obj/effect/floor_decal/spline/fancy/wood/corner,/turf/simulated/floor/wood/ebony,/area/template_noop)
"Lu" = (/obj/machinery/cooker/fryer,/obj/effect/floor_decal/corner/black/border{dir = 8},/turf/simulated/floor/tiled/white/monotile,/area/template_noop)
"LC" = (/obj/effect/floor_decal/corner/blue/half{dir = 8},/obj/machinery/light,/turf/simulated/floor/tiled/dark/monotile,/area/template_noop)
"LI" = (/obj/structure/bed/sofa/black,/turf/simulated/floor/wood/ebony,/area/template_noop)
"LL" = (/obj/structure/table/marble,/obj/effect/floor_decal/corner/black/mono,/obj/item/material/kitchen/rollingpin,/obj/item/reagent_containers/food/snacks/cheesewedge,/turf/simulated/floor/tiled/white/monotile,/area/template_noop)
"LR" = (/obj/effect/paint_stripe/brown,/turf/simulated/wall/prepainted,/area/template_noop)
"MU" = (/obj/effect/floor_decal/spline/fancy/wood{dir = 4},/obj/effect/floor_decal/spline/fancy/wood/corner{dir = 8},/turf/simulated/floor/wood/ebony,/area/template_noop)
"Na" = (/obj/effect/floor_decal/corner/beige{dir = 4},/obj/effect/floor_decal/corner/blue/border{dir = 8},/turf/simulated/floor/tiled/dark/monotile,/area/template_noop)
"Nm" = (/obj/structure/table/standard,/obj/machinery/chemical_dispenser/bar_soft/full{pixel_y = 10},/obj/effect/floor_decal/corner/black/border{dir = 1},/turf/simulated/floor/tiled/dark/monotile,/area/template_noop)
"No" = (/obj/structure/bed/chair/padded/black{dir = 8},/turf/simulated/floor/wood/ebony,/area/template_noop)
"OB" = (/obj/structure/table/woodentable/walnut,/obj/machinery/light,/turf/simulated/floor/wood/ebony,/area/template_noop)
"OS" = (/obj/machinery/cooker/oven,/obj/effect/floor_decal/corner/black/border{dir = 9},/obj/machinery/light{dir = 4},/turf/simulated/floor/tiled/white/monotile,/area/template_noop)
"Pc" = (/obj/structure/table/marble,/obj/effect/floor_decal/corner/black/mono,/obj/machinery/reagentgrinder/juicer,/obj/item/reagent_containers/glass/beaker/large,/turf/simulated/floor/tiled/white/monotile,/area/template_noop)
"Pi" = (/obj/random/facility/mercenary,/turf/simulated/floor/wood/ebony,/area/template_noop)
"Pw" = (/obj/effect/floor_decal/corner/grey{dir = 8},/turf/simulated/floor/tiled/white,/area/template_noop)
"PS" = (/obj/effect/floor_decal/corner/black/border{dir = 1},/obj/machinery/light{dir = 1},/turf/simulated/floor/tiled/dark/monotile,/area/template_noop)
"Qa" = (/obj/effect/floor_decal/borderfloorblack{dir = 8},/obj/effect/floor_decal/corner/black{dir = 6},/obj/machinery/light{dir = 8},/turf/simulated/floor/tiled/dark,/area/template_noop)
"Qp" = (/obj/structure/bed/sofa/black,/turf/simulated/floor/carpet/red,/area/template_noop)
"QP" = (/obj/effect/floor_decal/corner/black/border{dir = 10},/obj/structure/closet/secure_closet/freezer/kitchen{req_access = list()},/turf/simulated/floor/tiled/white/monotile,/area/template_noop)
"Rd" = (/obj/structure/bed/sofa/black/right{dir = 4},/turf/simulated/floor/wood/ebony,/area/template_noop)
"Rp" = (/obj/structure/bed/sofa/black{dir = 9},/turf/simulated/floor/carpet/magenta,/area/template_noop)
"Rs" = (/obj/effect/floor_decal/corner/black/border{dir = 4},/turf/simulated/floor/tiled/dark/monotile,/area/template_noop)
"Sg" = (/obj/effect/floor_decal/spline/fancy/wood{dir = 4},/obj/effect/floor_decal/spline/fancy/wood{dir = 8},/turf/simulated/floor/wood/ebony,/area/template_noop)
"SE" = (/obj/structure/table/woodentable/walnut,/obj/item/device/flashlight/lamp/lava/orange{pixel_x = 5},/turf/simulated/floor/wood/ebony,/area/template_noop)
"SS" = (/obj/effect/floor_decal/corner/blue/border,/turf/simulated/floor/tiled/dark/monotile,/area/template_noop)
"Tz" = (/obj/effect/floor_decal/borderfloorblack,/obj/effect/floor_decal/corner/black{dir = 5},/obj/machinery/light,/turf/simulated/floor/tiled/dark,/area/template_noop)
"Ue" = (/obj/structure/table/woodentable/walnut,/obj/item/reagent_containers/food/drinks/bottle/champagne{pixel_y = 9},/turf/simulated/floor/wood/ebony,/area/template_noop)
"Uf" = (/obj/item/stool/padded,/turf/simulated/floor/tiled/dark,/area/template_noop)
"Ur" = (/obj/effect/floor_decal/corner/grey{dir = 10},/obj/structure/closet/secure_closet/freezer/fridge,/obj/item/reagent_containers/food/snacks/sliceable/bread,/obj/item/reagent_containers/food/snacks/sliceable/bread,/obj/item/reagent_containers/food/snacks/sliceable/bread,/obj/item/reagent_containers/food/snacks/sliceable/bread,/obj/item/reagent_containers/food/snacks/sliceable/bread,/turf/simulated/floor/tiled/white,/area/template_noop)
"UD" = (/obj/structure/bed/sofa/black/left{dir = 4},/turf/simulated/floor/wood/ebony,/area/template_noop)
"Va" = (/obj/effect/floor_decal/corner/grey{dir = 5},/turf/simulated/floor/tiled/white,/area/template_noop)
"Vx" = (/obj/structure/bed/sofa/black{dir = 8},/turf/simulated/floor/carpet/magenta,/area/template_noop)
"VO" = (/obj/structure/bed/sofa/black/right{dir = 4},/turf/simulated/floor/carpet/red,/area/template_noop)
"Wr" = (/turf/simulated/floor/carpet/red,/area/template_noop)
"Ws" = (/obj/machinery/cooker/oven,/obj/effect/floor_decal/corner/black/border{dir = 8},/turf/simulated/floor/tiled/white/monotile,/area/template_noop)
"WD" = (/obj/structure/table/woodentable/walnut,/obj/item/reagent_containers/food/snacks/fries,/turf/simulated/floor/carpet/magenta,/area/template_noop)
"WE" = (/obj/effect/floor_decal/spline/fancy/wood/corner,/obj/effect/floor_decal/spline/fancy/wood{dir = 8},/turf/simulated/floor/wood/ebony,/area/template_noop)
"WZ" = (/obj/structure/bed/sofa/black/left{dir = 10},/turf/simulated/floor/carpet/red,/area/template_noop)
"Xe" = (/obj/effect/floor_decal/corner/grey{dir = 4},/turf/simulated/floor/tiled/white,/area/template_noop)
"XX" = (/obj/structure/table/woodentable/walnut,/turf/simulated/floor/wood/ebony,/area/template_noop)
"XZ" = (/obj/effect/floor_decal/borderfloorblack{dir = 10},/obj/effect/floor_decal/corner/black{dir = 4},/turf/simulated/floor/tiled/dark,/area/template_noop)
"Yb" = (/obj/effect/floor_decal/spline/fancy/wood{dir = 4},/obj/effect/floor_decal/spline/fancy/wood{dir = 8},/obj/random/facility/mercenary/high,/turf/simulated/floor/wood/ebony,/area/template_noop)
"YJ" = (/obj/effect/floor_decal/spline/fancy/wood{dir = 8},/turf/simulated/floor/wood/ebony,/area/template_noop)
"ZV" = (/obj/machinery/smartfridge/foods,/turf/simulated/floor/tiled/dark/monotile,/area/template_noop)

(1,1,1) = {"
bIbIbIKXmUKXbIbIbIbIbIbIbIbIbIbIbIbIbIbI
bIeaqrqrqrslEKPSFLNmGJkLboJsLRDCeJfQvLbI
bIQaJGSSSSoMLRHnztztztztztRsEKVaVavGdobI
bIlsIFdpfODUElztztmTztztztRsZVsWPwKbnybI
bIlsIFYJXXxusEDZFjkvrzivLRLRLRfvzmKbOSbI
bIlsIFYJhfxuxudedededeLksmGELRDkzmKbWsbI
bIQaIFYJpMxuxuzvsmsmsmyjisjRLRmhzmKbLubI
bIlsIFaPOBNoPiHChvhErGSgBIVxLRjxGbKbQPbI
bIqLIFototototMUkiuXWDSgwLdHLRtJweXeKnbI
bIQaIFpTQphSWZkcDUDUDUCvEeAlLRzmPcaJKbbI
bIlsIFddlrbpKSWEsmsmsmxFzAsSLRzmbcLLKbbI
bIlsIFVObpkCExYbjwgdsHSgyPVxLRoCqSqSKbbI
bIlsIFWrWrWrWrSgLCUfIOSgnrRpLRwOUrKJefbI
bIQaIFotototototototototototLRLRLRLREKbI
KXlsIFYJUDSEKFtiotcUicLIgtotyYLIrvNadWKX
mUlsIFChRdeYzKxuotxuvSUezKotmbXXqnblKBmU
KXlsIFmusmsmsmsmotjijijijiotsmsmKDblKBKX
bIQaoOzbzbzbzbzbzbzbzbzbzbzbkOzbzbCVvubI
bIXZitititititTzitititTzitititTzititHobI
bIbIbIKXmUKXbIbIbIbIbIbIbIbIbIbIbIbIbIbI
"}
