"a" = (/turf/simulated/wall/r_wall/invincible/prepainted,/area/template_noop)
"c" = (/obj/effect/decal/cleanable/dirt,/obj/effect/decal/cleanable/dirt,/obj/effect/decal/cleanable/molten_item,/turf/simulated/floor/plating,/area/template_noop)
"d" = (/obj/effect/floor_decal/corner/blue{dir = 9},/obj/effect/decal/cleanable/dirt,/turf/simulated/floor/tiled,/area/template_noop)
"g" = (/obj/effect/floor_decal/corner/blue{dir = 9},/obj/effect/decal/cleanable/dirt,/obj/effect/decal/cleanable/dirt,/obj/effect/decal/cleanable/generic,/turf/simulated/floor/tiled,/area/template_noop)
"i" = (/obj/effect/floor_decal/corner/blue{dir = 9},/turf/simulated/floor/tiled,/area/template_noop)
"j" = (/turf/unsimulated/mineral{color = "#000000"; name = "void"},/area/template_noop)
"k" = (/obj/effect/catwalk_plated,/obj/effect/decal/cleanable/dirt,/turf/simulated/floor/plating,/area/template_noop)
"m" = (/obj/effect/decal/cleanable/dirt,/obj/effect/decal/cleanable/filth,/turf/simulated/floor/tiled/steel_grid,/area/template_noop)
"n" = (/obj/structure/bed/chair/padded/beige{dir = 1},/obj/effect/decal/cleanable/dirt,/obj/effect/decal/cleanable/dirt,/obj/effect/decal/cleanable/filth,/turf/simulated/floor/tiled/monotile,/area/template_noop)
"o" = (/obj/structure/bed/chair/padded/beige{dir = 4},/obj/effect/decal/cleanable/dirt,/obj/effect/decal/cleanable/filth,/turf/simulated/floor/tiled/monotile,/area/template_noop)
"p" = (/obj/structure/bed/chair/padded/beige,/obj/effect/decal/cleanable/dirt,/obj/effect/decal/cleanable/mucus,/turf/simulated/floor/tiled/monotile,/area/template_noop)
"q" = (/obj/effect/floor_decal/corner/blue{dir = 6},/turf/simulated/floor/tiled,/area/template_noop)
"t" = (/obj/effect/floor_decal/corner/blue/three_quarters{dir = 8},/obj/effect/decal/cleanable/dirt,/obj/effect/decal/cleanable/dirt,/turf/simulated/floor/tiled,/area/template_noop)
"v" = (/turf/unsimulated/mineral,/area/template_noop)
"w" = (/obj/effect/floor_decal/corner/blue{dir = 6},/obj/effect/decal/cleanable/dirt,/obj/effect/decal/cleanable/filth,/turf/simulated/floor/tiled,/area/template_noop)
"x" = (/obj/structure/bed/chair/padded/beige{dir = 8},/obj/effect/decal/cleanable/dirt,/obj/effect/decal/cleanable/dirt,/obj/effect/decal/cleanable/generic,/turf/simulated/floor/plating,/area/template_noop)
"y" = (/obj/effect/decal/cleanable/dirt,/obj/effect/decal/cleanable/dirt,/obj/random/maintenance/solgov,/turf/simulated/floor/plating,/area/template_noop)
"A" = (/obj/effect/floor_decal/corner/blue{dir = 9},/obj/machinery/light/small{dir = 8},/obj/effect/decal/cleanable/dirt,/obj/effect/decal/cleanable/filth,/turf/simulated/floor/tiled,/area/template_noop)
"C" = (/obj/effect/decal/cleanable/dirt,/turf/simulated/floor/tiled/steel_grid,/area/template_noop)
"D" = (/obj/effect/decal/cleanable/dirt,/turf/simulated/floor/tiled/steel_ridged,/area/template_noop)
"F" = (/obj/effect/floor_decal/corner/blue{dir = 9},/obj/effect/decal/cleanable/dirt,/obj/random/facility/mercenary/low,/turf/simulated/floor/tiled,/area/template_noop)
"G" = (/obj/effect/floor_decal/corner/blue{dir = 5},/obj/effect/decal/cleanable/dirt,/obj/effect/decal/cleanable/dirt,/obj/effect/decal/cleanable/filth,/turf/simulated/floor/tiled,/area/template_noop)
"I" = (/obj/effect/floor_decal/corner/blue/half{dir = 4},/obj/effect/decal/cleanable/dirt,/turf/simulated/floor/tiled/steel_ridged,/area/template_noop)
"J" = (/obj/structure/table/woodentable,/obj/machinery/light{dir = 1},/obj/effect/decal/cleanable/dirt,/obj/effect/decal/cleanable/dirt,/turf/simulated/floor/tiled/monotile,/area/template_noop)
"M" = (/obj/effect/floor_decal/corner/blue/half{dir = 8},/turf/simulated/floor/tiled/steel_ridged,/area/template_noop)
"N" = (/obj/structure/table/woodentable,/obj/machinery/light{dir = 8},/obj/effect/decal/cleanable/dirt,/turf/simulated/floor/tiled/monotile,/area/template_noop)
"O" = (/obj/machinery/door/airlock/hatch,/turf/simulated/floor/tiled/steel_ridged,/area/template_noop)
"S" = (/obj/structure/holoplant,/obj/effect/decal/cleanable/cobweb,/turf/simulated/floor/tiled/monotile,/area/template_noop)
"W" = (/obj/effect/decal/cleanable/dirt,/obj/effect/decal/cleanable/dirt,/turf/simulated/floor/plating,/area/template_noop)
"X" = (/obj/effect/decal/cleanable/dirt,/obj/effect/decal/cleanable/dirt,/obj/effect/decal/cleanable/generic,/turf/simulated/floor/plating,/area/template_noop)
"Y" = (/obj/effect/floor_decal/corner/blue{dir = 6},/obj/machinery/light/small{dir = 4; icon_state = "bulb1"},/obj/effect/decal/cleanable/filth,/turf/simulated/floor/tiled,/area/template_noop)

(1,1,1) = {"
jjjjjjjjjj
jaaaaaajjj
jaSoJxaaaa
japtGcyvva
jaNgWvvvvO
janFmXvvva
jaaikwaaaa
jjadCYajja
jjaAkqajja
aaaMDIaaaa
"}
