"a" = (/turf/simulated/wall/r_wall/invincible/prepainted,/area/template_noop)
"d" = (/obj/structure/catwalk,/obj/machinery/light/small/red,/turf/simulated/floor/plating,/area/template_noop)
"e" = (/obj/effect/decal/cleanable/dirt,/obj/effect/decal/cleanable/dirt,/obj/effect/decal/cleanable/dirt,/obj/effect/floor_decal/floordetail,/turf/simulated/floor/tiled/techfloor,/area/template_noop)
"g" = (/obj/structure/table/standard,/obj/effect/decal/cleanable/dirt,/obj/effect/decal/cleanable/dirt,/turf/simulated/floor/tiled/techfloor,/area/template_noop)
"h" = (/obj/structure/railing/mapped{dir = 1; icon_state = "railing0-1"},/obj/effect/decal/cleanable/dirt,/obj/effect/decal/cleanable/cobweb{dir = 4},/turf/simulated/floor/plating,/area/template_noop)
"i" = (/obj/machinery/door/airlock/hatch/maintenance,/turf/simulated/floor/tiled/techfloor/grid,/area/template_noop)
"j" = (/obj/effect/decal/cleanable/dirt,/obj/effect/decal/cleanable/dirt,/obj/effect/decal/cleanable/dirt,/turf/simulated/floor/tiled/techfloor,/area/template_noop)
"l" = (/obj/structure/catwalk,/obj/machinery/light/small{dir = 8},/turf/simulated/floor/plating,/area/template_noop)
"n" = (/obj/effect/decal/cleanable/dirt,/obj/effect/decal/cleanable/dirt,/turf/simulated/floor/tiled/techfloor,/area/template_noop)
"o" = (/obj/structure/bed/chair/office/dark,/obj/effect/decal/cleanable/dirt,/obj/effect/decal/cleanable/dirt,/obj/effect/floor_decal/corner/yellow{dir = 6},/turf/simulated/floor/tiled/techfloor,/area/template_noop)
"p" = (/obj/structure/railing/mapped{dir = 1; icon_state = "railing0-1"},/obj/structure/railing/mapped{dir = 4},/obj/machinery/light/small,/obj/effect/decal/cleanable/dirt,/obj/effect/decal/cleanable/dirt,/turf/simulated/floor/plating,/area/template_noop)
"r" = (/obj/structure/catwalk,/obj/effect/decal/cleanable/cobweb2,/turf/simulated/floor/plating,/area/template_noop)
"t" = (/obj/machinery/light/small{dir = 1},/obj/effect/floor_decal/corner/yellow{dir = 10},/obj/effect/floor_decal/borderfloorblack{dir = 1},/turf/simulated/floor/tiled,/area/template_noop)
"w" = (/obj/machinery/computer/modular/preset/civilian,/obj/effect/decal/cleanable/dirt,/obj/effect/decal/cleanable/cobweb,/turf/simulated/floor/tiled/techfloor,/area/template_noop)
"y" = (/obj/structure/catwalk,/turf/simulated/floor/plating,/area/template_noop)
"B" = (/obj/effect/decal/cleanable/dirt,/turf/simulated/floor/tiled/techfloor/grid,/area/template_noop)
"D" = (/obj/structure/table/standard,/obj/machinery/light/small{dir = 4; icon_state = "bulb1"},/obj/random/medical/lite,/obj/effect/decal/cleanable/dirt,/turf/simulated/floor/tiled/techfloor,/area/template_noop)
"E" = (/obj/effect/decal/cleanable/dirt,/obj/effect/floor_decal/corner/yellow{dir = 6},/turf/simulated/floor/tiled/techfloor,/area/template_noop)
"H" = (/obj/effect/decal/cleanable/dirt,/obj/effect/decal/cleanable/dirt,/obj/effect/floor_decal/floordetail,/turf/simulated/floor/tiled/techfloor,/area/template_noop)
"I" = (/obj/structure/bed/chair/office/light{dir = 8},/obj/effect/decal/cleanable/dirt,/obj/effect/decal/cleanable/dirt,/obj/effect/floor_decal/floordetail,/turf/simulated/floor/tiled/techfloor,/area/template_noop)
"L" = (/obj/structure/catwalk,/obj/effect/decal/cleanable/dirt,/turf/simulated/floor/plating,/area/template_noop)
"M" = (/obj/structure/table/standard,/obj/random/maintenance/solgov,/obj/effect/decal/cleanable/dirt,/obj/effect/decal/cleanable/dirt,/obj/effect/floor_decal/corner/yellow{dir = 6},/turf/simulated/floor/tiled/techfloor,/area/template_noop)
"N" = (/obj/structure/table/standard,/obj/random/facility/ammo,/obj/effect/decal/cleanable/dirt,/obj/effect/decal/cleanable/dirt,/turf/simulated/floor/tiled/techfloor,/area/template_noop)
"O" = (/obj/effect/floor_decal/corner/yellow{dir = 10},/obj/effect/floor_decal/borderfloorblack{dir = 1},/turf/simulated/floor/tiled,/area/template_noop)
"P" = (/obj/structure/largecrate,/obj/structure/railing/mapped{dir = 1; icon_state = "railing0-1"},/obj/random/loot,/turf/simulated/floor/plating,/area/template_noop)
"Q" = (/obj/structure/largecrate,/obj/random/maintenance/solgov,/obj/random/maintenance/solgov,/obj/random/facility/ammo,/obj/effect/decal/cleanable/dirt,/turf/simulated/floor/tiled/techfloor,/area/template_noop)
"R" = (/obj/structure/table/standard,/obj/machinery/light/small/red{dir = 8},/obj/effect/decal/cleanable/dirt,/obj/effect/decal/cleanable/dirt,/turf/simulated/floor/tiled/techfloor,/area/template_noop)
"S" = (/obj/machinery/light/small/red{dir = 4},/obj/effect/decal/cleanable/dirt,/turf/simulated/floor/tiled/techfloor/grid,/area/template_noop)
"U" = (/obj/structure/largecrate,/obj/random/maintenance/solgov,/obj/random/maintenance/solgov,/obj/random/facility/gun,/turf/simulated/floor/tiled/techfloor,/area/template_noop)
"V" = (/turf/simulated/wall/prepainted,/area/template_noop)
"W" = (/obj/structure/table/standard,/obj/random/maintenance/solgov,/obj/effect/decal/cleanable/dirt,/obj/effect/decal/cleanable/dirt,/turf/simulated/floor/tiled/techfloor,/area/template_noop)
"Y" = (/obj/structure/catwalk,/obj/effect/decal/cleanable/dirt,/obj/effect/decal/cleanable/dirt,/turf/simulated/floor/plating,/area/template_noop)

(1,1,1) = {"
aaaaaaaaaa
awWgDVNMra
aHHIeVRoYa
aPpjninELa
aVVVVVVVSa
alYYLLyiya
aYQVVVVVBa
aYUVyydyya
ahVViVVVVa
aaatOOaaaa
"}
