"a" = (/turf/unsimulated/wall{color = "black"},/area/space)
"b" = (/obj/effect/floor_decal/spline/plain/black{dir = 8; icon_state = "spline_plain"},/turf/simulated/open,/area/space)
"c" = (/obj/structure/stairs/west,/turf/simulated/floor/tiled/skrell,/area/space)
"d" = (/obj/structure/lattice,/obj/effect/floor_decal/spline/plain/black{dir = 1; icon_state = "spline_plain"},/obj/effect/floor_decal/spline/plain/black{dir = 4},/turf/simulated/open,/area/space)
"e" = (/obj/structure/lattice,/obj/structure/catwalk,/turf/simulated/open,/area/space)
"f" = (/obj/effect/floor_decal/spline/plain/black{dir = 8; icon_state = "spline_plain"},/turf/unsimulated/floor/exoplanet/water/shallow{color = "#506f8d"},/area/space)
"h" = (/turf/unsimulated/mineral{color = "#33446b"},/area/space)
"j" = (/obj/structure/lattice,/obj/effect/floor_decal/spline/plain/black{dir = 8; icon_state = "spline_plain"},/obj/effect/floor_decal/spline/plain/black{dir = 1; icon_state = "spline_plain"},/turf/simulated/open,/area/space)
"l" = (/turf/unsimulated/floor/exoplanet/barren{color = "#555555"},/area/space)
"o" = (/obj/structure/lattice,/turf/simulated/open,/area/space)
"p" = (/obj/effect/floor_decal/spline/plain/black{dir = 4},/obj/effect/floor_decal/spline/plain/black{dir = 1; icon_state = "spline_plain"},/turf/simulated/open,/area/space)
"r" = (/obj/structure/lattice,/obj/effect/floor_decal/spline/plain/black{dir = 4},/turf/simulated/open,/area/space)
"t" = (/obj/effect/floor_decal/spline/plain/black{dir = 8; icon_state = "spline_plain"},/obj/effect/floor_decal/spline/plain/black,/obj/structure/fd/bs_spikes{pixel_x = 4; pixel_y = 3},/turf/unsimulated/floor/exoplanet/water/shallow{color = "#506f8d"},/area/space)
"w" = (/obj/structure/lattice,/obj/effect/floor_decal/spline/plain/black{dir = 8; icon_state = "spline_plain"},/turf/simulated/open,/area/space)
"x" = (/obj/effect/floor_decal/spline/plain/black{dir = 8; icon_state = "spline_plain"},/obj/effect/floor_decal/spline/plain/black{dir = 1; icon_state = "spline_plain"},/turf/simulated/open,/area/space)
"y" = (/obj/effect/floor_decal/spline/plain/black,/turf/unsimulated/floor/exoplanet/water/shallow{color = "#506f8d"},/area/space)
"z" = (/obj/effect/floor_decal/spline/plain/black{dir = 1; icon_state = "spline_plain"},/obj/effect/floor_decal/spline/plain/black{dir = 4},/turf/simulated/open,/area/space)
"B" = (/obj/effect/floor_decal/spline/plain/black{dir = 4},/turf/unsimulated/floor/exoplanet/water/shallow{color = "#506f8d"},/area/space)
"D" = (/obj/effect/floor_decal/spline/plain/black{dir = 1; icon_state = "spline_plain"},/turf/unsimulated/floor/exoplanet/water/shallow{color = "#506f8d"},/area/space)
"E" = (/obj/effect/paint/black{color = "#151d25"},/turf/simulated/wall/r_wall/invincible,/area/space)
"G" = (/obj/effect/floor_decal/spline/plain/black{dir = 4},/obj/structure/fd/bs_spikes,/turf/unsimulated/floor/exoplanet/water/shallow{color = "#506f8d"},/area/space)
"H" = (/obj/structure/fd/bs_spikes,/turf/unsimulated/floor/exoplanet/water/shallow{color = "#506f8d"},/area/space)
"I" = (/obj/effect/wallframe_spawn/reinforced,/obj/effect/paint/black{color = "#151d25"},/turf/simulated/floor/plating,/area/space)
"K" = (/obj/effect/floor_decal/spline/plain/black{dir = 4},/obj/effect/floor_decal/spline/plain/black,/turf/unsimulated/floor/exoplanet/water/shallow{color = "#506f8d"},/area/space)
"L" = (/obj/effect/floor_decal/spline/plain/black{dir = 8; icon_state = "spline_plain"},/obj/effect/floor_decal/spline/plain/black{dir = 1; icon_state = "spline_plain"},/turf/unsimulated/floor/exoplanet/water/shallow{color = "#506f8d"},/area/space)
"O" = (/turf/simulated/open,/area/space)
"P" = (/turf/simulated/floor/tiled/skrell,/area/space)
"Q" = (/obj/effect/floor_decal/spline/plain/black{dir = 8; icon_state = "spline_plain"},/obj/effect/floor_decal/spline/plain/black,/obj/effect/floor_decal/spline/plain/black{dir = 4},/turf/unsimulated/floor/exoplanet/water/shallow{color = "#506f8d"},/area/space)
"S" = (/obj/effect/floor_decal/spline/plain/black,/obj/effect/floor_decal/spline/plain/black{dir = 4},/turf/unsimulated/floor/exoplanet/water/shallow{color = "#506f8d"},/area/space)
"T" = (/obj/effect/floor_decal/spline/plain/black{dir = 4},/turf/simulated/open,/area/space)
"X" = (/obj/effect/floor_decal/spline/plain/black{dir = 1; icon_state = "spline_plain"},/turf/simulated/open,/area/space)
"Y" = (/obj/effect/floor_decal/spline/plain/black{dir = 1; icon_state = "spline_plain"},/obj/effect/floor_decal/spline/plain/black{dir = 4},/turf/unsimulated/floor/exoplanet/water/shallow{color = "#506f8d"},/area/space)
"Z" = (/turf/unsimulated/floor/exoplanet/water/shallow{color = "#506f8d"},/area/space)

(1,1,1) = {"
aaaaaaaaaaaaaaaaaaaaaaaaaaaaaaaaaaaaaaaaaaaaaaaaaaaaaaaaaaaaaaaaaaaaaaaaaaaaaaaaaaaaaaaaaaaaaaaaaaaa
aOOOOOOOOOOOOOOOOOOOOOOOOOOOOOOOOOOOOOOOOOOOOOOOOOOOOhhhhhhhhhhhhhhhhhhhhhhhhhhhhhhhhhhhhhhhhhhhhhha
aOOOOOOOOOOOOOOOOOOOOOOOOOOOOOOOOOOOOOOOOOOOOOOOOOOOOOhhhhhhhhhhhhhhhhhhhhhhhhhhhhhhhhhhhhhhhhhhhhha
aOOOOOOOOOOOOOOOOOOOOOOOOOOOOOOOOOOOOOOOOOOOOOOOOOOOOOhhhhhhhhhhhhhhhhhhhhhhhhhhhhhhhhhhhhhhhhhhhhha
aOOOOOOOOOOOOOOOOOOOOOOOOOOOOOOOOOOOOOOOOOOOOOOOOOOOOOOhhhhhhhhhhhhhhhhhhhhhhhhhhhhhhhhhhhhhhhhhhhha
aOOOOOOOOOOOOOOOOOOOOOOOOOOOOOOOOOOOOOOOOOOOOOOOOOOOOOOhhhhhhhhhhhhhhhhhhhhhhhhhhhhhhhhhhhhhhhhhhhha
aOOOOOOOOOOOOOOOOOOOOOOOOOOOOOOOOOOOOOOOOOOOOOOOOOOOOOhhhhhhhhhhhhhhhhhhhhhhhhhhhhhhhhhhhhhhhhhhhhha
aOOOOOOOOOOOOOOOOOOOOOOOOOOOOOOOOOOOOOOOOOOOOOOOOOOOhhhhhhhhhhhhhhhhhhhhhhhhhhhhhhhhhhhhhhhhhhhhhhha
aOOOOOOOOOOOOOOOOOOOOOOOOOOOOOOOOOOOOOOOOOOOOOOOOOOOhhhhhhhhhhhhhhhhhhhhhhhhhhhhhhhhhhhhhhhhhhhhhhha
aOOOOOOOOOOOOOOOOOOOOOOOOOOOOOOOOOOOOOOOOOOOOOOOOOhhhhOOOOhhhhhhhhhhhhhhhhhhhhhhhhhhhhhhhhhhhhhhhhha
aOOOOOOOOOOOOOOOOOOOOOOOOOOOOOOOOOOOOOOOOOOOOOOOOOOOhOOOOOOhhhhhhhhhhhhhhhhhhhhhhhhhhhhhhhhhhhhhhhha
aOOOOOOOOOOOOOOOOOOOOOOOOOOOOOOOOOOOOOOOOOOOOOOOOOOOOOOOOOOOOOOOhhhhhhhhhhhhhhhhhhhhhhhhhhhhhhhhhhha
aOOOOOOOOOOOOOOOOOOOOOOOOOOOOOOOOOOOOOOOOOOOOOOOOOOOOOOOOOOOOOOOOhhhhhhhhhhhhhhhhhhhhhhhhhhhhhhhhhha
aOOOOOOOOOOOOOOOOOOOOOOOOOOOOOOOOOOOOOOOOOOOOOOOOOOOOOOOOOOOOOOOOhhhhhhhhhhhhhhhhhhhhhhhhhhhhhhhhhha
aOOOOOOOOOOOOOOOOOOOOOOOOOOOOOOOOOOOOOOOOOOOOOOOOOOOOOOOOOOOOOOOOhhhhhhhhhhhhhhhhhhhhhhhhhhhhhhhhhha
aOOOOOOOOOOOOOOOOOOOOOOOOOOOOOOOOOOOOOOOOOOOOOOOOOOOOOOOOOOOOOOOOOhhhhhhhhhhhhhhhZZZhhhhhhhhhhhhhhha
aOOOOOOOOOOOOOOOOOOOOOOOOOOOOOOOOOOOOOOOOOOOOOOOOOOOOOOOOOOOOOOOOOOhhhhhhhhhhhZZZZZZHhhhhhhhhhhhhhha
aOOOOOOOOOOOOOOOOOOOOOOOOOOOOOOOOOOOOOOOOOOOOOOOOOOOOOOOOOOOOOOOOOOOOhhhhhhhhhZHZZZZZZhhhhhhhhhhhhha
aOOOOOOOOOOOOOOOOOOOOOOOOOOOOOOOOOOOOOOOOOOOOOOOOOOOOOOOOOOOOOOOOOOOOOhhhhhhhZZZhhZZZZhhhhhhhhhhhhha
aOOOOOOOOOOOOOOOOOOOOOOOOOOOOOOOOOOOOOOOOOOOOOOOOOOOOOOOOOOOOOOOOOOOOOhhhhhhZZZhhhhHZZZhhhhhhhhhhhha
aOOOOOOOOOOOOOOOOOOOOOOOOOOOOOOOOOOOOOOOOOOOOOOOOOOOOOOOOOOOOOOOOOOOOhhhhhhhZZZZhhhZZZZZZhhhhhhhhhha
aOOOOOOOOOOOOOOOOOOOOOOOOOOOOOOOOOOOOOOOOOOOOOOOOOOOOOOOOOOOOOOOOOOOOhhhhhhhHZZZhhhhZHZyhhlllhhhhhha
aOOOOOOOOOOOOOOOOOOOOOOOOOOOOOOOOOOOOOOOOOOOOOOOOOOOOOOOOOOOOOOOOOOOhhhhhhhhZZZyyZhhhhBllllllhhhhhha
aOOOOOOOOOOOOOOOOOOOOOOOOOOOOOOOOOOOOOOOOOOOOOOOOOOOOOOOOOOOOOOOOOOhhhhhhhhhhZSllfhhhhhhllllhhhhhhha
aOOOOOOOOOOOOOOOOOOOOOOOOOOOOOOOOOOOOOOOOOOOOOOOOOOOOOOOOOOOOOOOOOOhhhhhhhhhhBlllthhhhhllllhhhhhhhha
aOOOOOOOOOOOOOOOOOOOOOOOOOOOOOOOOOOOOOOOOOOOOOOOOOOOOOOOOOOOOOOOOOhhhhhhhhhhhhllllhhhhlllllhhhhhhhha
aOOOOOOOOOOOOOOOOOOOOOOOOOOOOOOOOOOOOOOOOOOOOOOOOOOOOOOOOOOOOOOOOhhhhhhhhhhhhhhlllllhhlhllhhhhhhhhha
aOOOOOOOOOOOOOOOOOOOOOOOOOOOOOOOOOOOOOOOOOOOOOOOOOOOOOOOOOOOOOOOOhhhhhhhhhhhhlllllllllllllhhhhhhhhha
aOOOOOOOOOOOOOOOOOOOOOOOOOOOOOOOOOOOOOOOOOOOOOOOOOOOOOOOOOOOOOOOOOOhhhZHhhhhllllllllllllllhhhhhhhhha
aOOOOOOOOOOOOOOOOOOOOOOOOOOOOOOOOOOOOOOOOOOOOOOOOOOOOOOOOOOOOOOOOOOhhhZZZhhlllllhlhhhhllhhhhhhhhhhha
aOOOOOOOOOOOOOOOOOOOOOOOOOOOOOOOOOOOOOOOOOOOOOOOOOOOOOOOOOOOOOOOOOOhZZZyyyhlllllllhhhhhhhhhhhhhhhhha
aOOOOOOOOOOOOOOOOOOOOOOOOOOOOOOOOOOOOOOOOOOOOOOOOOOOOOOOOOOOOOOOOOOhhZKlllQllhhhlllhhhhhhhhhhhhhhhha
aOOOOOOOOOOOOOOOOOOOOOOOOOOOOOOOOOOOOOOOOOOOOOOOOOOOOOOOOOOhhOOOOOOOhGlllllllhhllllllhhhhhhhhhhhhhha
aOOOOOOOOOOOOOOOOOOOOOOOOOOOOOOOOOOOOOOOOOOOOOOOOOOOOOOOOOOOhhhOOOOhhhlllhllhhhlllllllhllhhhhhhhhhha
aOOOOOOOOOOOOOOOOOOOOOOOOOOOOOOOOOOOOOOOOOOOOOOOOOOOOOOOOOOOhhhOOOhhhhllLhhlhhllllllllllllhhhhhhhhha
aOOOOOOOOOOOOOOOOOOOOOOOOOOOOOOOOOOOOOOOOOOOOOOOOOOOOOOOOOOOOOhhhhhhhBllfZhhhhlxdlEllhhhllhhhhhhhhha
aOOOOOOOOOOOOOOOOOOOOOOOOOOOOOOOOOOOOOOOOOOOOOOOOOOOOOOOOOOOOOhhhhhhhhYlfHhhhllbozelllhhlllhhhhhhhha
aOOOOOOOOOOOOOOOOOOOOOOOOOOOOOOOOOOOOOOOOOOOOOOOOOOOOOOOOOOOOOOOhhhhZZZDZhhhlEjoorexdlhlllhhhhhhhhha
aOOOOOOOOOOOOOOOOOOOOOOOOOOOOOOOOOOOOOOOOOOOOOOOOOOOOOOOOOOOOOOOOhhhhZZZhhhXXXOOoOoOoplllhhhhhhhhhha
aOOOOOOOOOOOOOOOOOOOOOOOOOOOOOOOOOOOOOOOOOOOOOOOOOOOOOOOOOOOOOOOOOhhhZZhhhhOOOOOoOeOoTllhhhhhhhhhhha
aOOOOOOOOOOOOOOOOOOOOOOOOOOOOOOOOOOOOOOOOOOOOOOOOOOOOOOOOOOOOOOOOOhhhhZhhhhOOOOOoTeworElllhhhhhhhhha
aOOOOOOOOOOOOOOOOOOOOOOOOOOOOOOOOOOOOOOOOOOOOOOOOOOOOOOOOOOOOOOOOOhhhhhhhhhOOOOOoTeOoOXzlllhhhhhhhha
aOOOOOOOOOOOOOOOOOOOOOOOOOOOOOOOOOOOOOOOOOOOOOOOOOOOOOOOOOOOOOOOOOhhhhhhhhOOOOOOoOOOOOOOXzlhhhhhhhha
aOOOOOOOOOOOOOOOOOOOOOOOOOOOOOOOOOOOOOOOOOOOOOOOOOOOOOOOOOOOOOOOOOhhhhhhhOOOOOOOoTEboOOOOOXhhhhhhhha
aOOOOOOOOOOOOOOOOOOOOOOOOOOOOOOOOOOOOOOOOOOOOOOOOOOOOOOOOOOOOOOOOOOhhhhOOOOOOOOOoTeboOOOOOOhhhhhhhha
aOOOOOOOOOOOOOOOOOOOOOOOOOOOOOOOOOOOOOOOOOOOOOOOOOOOOOOOOOOOOOOOOOOhhhhOOOOOOOOOoooOooOOOOOOhhhhhhha
aOOOOOOOOOOOOOOOOOOOOOOOOOOOOOOOOOOOOOOOOOOOOOOOOOOOOOOOOOOOOOOOOOOhhhOOOOOOOOOOoOoboOOOOOOOOhhhhhha
aOOOOOOOOOOOOOOOOOOOOOOOOOOOOOOOOOOOOOOOOOOOOOOOOOOOOOOOOOOOOOOOOOOhhOOOOOOOOOOOOOeboOOOOOOOOOhhhhha
aOOOOOOOOOOOOOOOOOOOOOOOOOOOOOOOOOOOOOOOOOOOOOOOOOOOOOOOOOOOOOOOOOOOOOOOOOOOOOOOOTeboOOOOOOOOOOhhhha
aOOOOOOOOOOOOOOOOOOOOOOOOOOOOOOOOOOOOOOOOOOOOOOOOOOOOOOOOOOOOOOOOOOOOOOOOOOOOOEOOTeboOEOOOOOOOOhhhha
aOOOOOOOOOOOOOOOOOOOOOOOOOOOOOOOOOOOOOOOOOOOOOOOOOOOOOOOOOOOOOOOOOOOOOOOOOOOOOEEEIIIEEEOOOOOOOhhhhha
aOOOOOOOOOOOOOOOOOOOOOOOOOOOOOOOOOOOOOOOOOOOOOOOOOOOOOOOOOOOOOOOOOOOOOOOOOOOOEEPPPPPPPEEOOOOOOhhhhha
aOOOOOOOOOOOOOOOOOOOOOOOOOOOOOOOOOOOOOOOOOOOOOOOOOOOOOOOOOOOOOOOOOOOOOOOOOOEEEPPPPPPPPPEEEOOOOOhhhha
aOOOOOOOOOOOOOOOOOOOOOOOOOOOOOOOOOOOOOOOOOOOOOOOOOOOOOOOOOOOOOOOOOOOOOOOOOOOEPPPPPPPPPPPEOOOOOOOOhha
aOOOOOOOOOOOOOOOOOOOOOOOOOOOOOOOOOOOOOOOOOOOOOOOOOOOOOOOOOOOOOOOOOOOOOOOOOOOEPPPPPPPPPPPEOOOOOOOOOha
aOOOOOOOOOOOOOOOOOOOOOOOOOOOOOOOOOOOOOOOOOOOOOOOOOOOOOOOOOOOOOOOOOOOOOOOOOOOIPPPPPPPPPPPIOOOOOOOOOOa
aOOOOOOOOOOOOOOOOOOOOOOOOOOOOOOOOOOOOOOOOOOOOOOOOOOOOOOOOOOOOOOOOOOOOOOOOOOOIPPPPPPPPPPPIOOOOOOOOOOa
aOOOOOOOOOOOOOOOOOOOOOOOOOOOOOOOOOOOOOOOOOOOOOOOOOOOOOOOOOOOOOOOOOOOOOOOOOOOIPPPPPPPPPPPIOOOOOOOOOOa
aOOOOOOOOOOOOOOOOOOOOOOOOOOOOOOOOOOOOOOOOOOOOOOOOOOOOOOOOOOOOOOOOOOOOOOOOOOOEPPPPPPPPPPPEOOOOOOOOOOa
aOOOOOOOOOOOOOOOOOOOOOOOOOOOOOOOOOOOOOOOOOOOOOOOOOOOOOOOOOOOOOOOOOOOOOOOOOOOEPPPPEcPPPPPEOOOOOOOOOOa
aOOOOOOOOOOOOOOOOOOOOOOOOOOOOOOOOOOOOOOOOOOOOOOOOOOOOOOOOOOOOOOOOOOOOOOOOOOEEEPPPPPPPPPEEEOOOOOOOOOa
aOOOOOOOOOOOOOOOOOOOOOOOOOOOOOOOOOOOOOOOOOOOOOOOOOOOOOOOOOOOOOOOOOOOOOOOOOOOOEEPPPPPPPEEOOOOOOOOOOOa
aOOOOOOOOOOOOOOOOOOOOOOOOOOOOOOOOOOOOOOOOOOOOOOOOOOOOOOOOOOOOOOOOOOOOOOOOOOOOOEEEIIIEEEOOOOOOOOOOOOa
aOOOOOOOOOOOOOOOOOOOOOOOOOOOOOOOOOOOOOOOOOOOOOOOOOOOOOOOOOOOOOOOOOOOOOOOOOOOOOEOOOOOOOEOOOOOOOOOOOOa
aOOOOOOOOOOOOOOOOOOOOOOOOOOOOOOOOOOOOOOOOOOOOOOOOOOOOOOOOOOOOOOOOOOOOOOOOOOOOOOOOOOOOOOOOOOOOOOOOOOa
aOOOOOOOOOOOOOOOOOOOOOOOOOOOOOOOOOOOOOOOOOOOOOOOOOOOOOOOOOOOOOOOOOOOOOOOOOOOOOOOOOOOOOOOOOOOOOOOOOOa
aOOOOOOOOOOOOOOOOOOOOOOOOOOOOOOOOOOOOOOOOOOOOOOOOOOOOOOOOOOOOOOOOOOOOOOOOOOOOOOOOOOOOOOOOOOOOOOOOOOa
aOOOOOOOOOOOOOOOOOOOOOOOOOOOOOOOOOOOOOOOOOOOOOOOOOOOOOOOOOOOOOOOOOOOOOOOOOOOOOOOOOOOOOOOOOOOOOOOOOOa
aOOOOOOOOOOOOOOOOOOOOOOOOOOOOOOOOOOOOOOOOOOOOOOOOOOOOOOOOOOOOOOOOOOOOOOOOOOOOOOOOOOOOOOOOOOOOOOOOOOa
aOOOOOOOOOOOOOOOOOOOOOOOOOOOOOOOOOOOOOOOOOOOOOOOOOOOOOOOOOOOOOOOOOOOOOOOOOOOOOOOOOOOOOOOOOOOOOOOOOOa
aOOOOOOOOOOOOOOOOOOOOOOOOOOOOOOOOOOOOOOOOOOOOOOOOOOOOOOOOOOOOOOOOOOOOOOOOOOOOOOOOOOOOOOOOOOOOOOOOOOa
aOOOOOOOOOOOOOOOOOOOOOOOOOOOOOOOOOOOOOOOOOOOOOOOOOOOOOOOOOOOOOOOOOOOOOOOOOOOOOOOOOOOOOOOOOOOOOOOOOOa
aOOOOOOOOOOOOOOOOOOOOOOOOOOOOOOOOOOOOOOOOOOOOOOOOOOOOOOOOOOOOOOOOOOOOOOOOOOOOOOOOOOOOOOOOOOOOOOOOOOa
aOOOOOOOOOOOOOOOOOOOOOOOOOOOOOOOOOOOOOOOOOOOOOOOOOOOOOOOOOOOOOOOOOOOOOOOOOOOOOOOOOOOOOOOOOOOOOOOOOOa
aOOOOOOOOOOOOOOOOOOOOOOOOOOOOOOOOOOOOOOOOOOOOOOOOOOOOOOOOOOOOOOOOOOOOOOOOOOOOOOOOOOOOOOOOOOOOOOOOOOa
aOOOOOOOOOOOOOOOOOOOOOOOOOOOOOOOOOOOOOOOOOOOOOOOOOOOOOOOOOOOOOOOOOOOOOOOOOOOOOOOOOOOOOOOOOOOOOOOOOOa
aOOOOOOOOOOOOOOOOOOOOOOOOOOOOOOOOOOOOOOOOOOOOOOOOOOOOOOOOOOOOOOOOOOOOOOOOOOOOOOOOOOOOOOOOOOOOOOOOOOa
aOOOOOOOOOOOOOOOOOOOOOOOOOOOOOOOOOOOOOOOOOOOOOOOOOOOOOOOOOOOOOOOOOOOOOOOOOOOOOOOOOOOOOOOOOOOOOOOOOOa
aOOOOOOOOOOOOOOOOOOOOOOOOOOOOOOOOOOOOOOOOOOOOOOOOOOOOOOOOOOOOOOOOOOOOOOOOOOOOOOOOOOOOOOOOOOOOOOOOOOa
aOOOOOOOOOOOOOOOOOOOOOOOOOOOOOOOOOOOOOOOOOOOOOOOOOOOOOOOOOOOOOOOOOOOOOOOOOOOOOOOOOOOOOOOOOOOOOOOOOOa
aOOOOOOOOOOOOOOOOOOOOOOOOOOOOOOOOOOOOOOOOOOOOOOOOOOOOOOOOOOOOOOOOOOOOOOOOOOOOOOOOOOOOOOOOOOOOOOOOOOa
aOOOOOOOOOOOOOOOOOOOOOOOOOOOOOOOOOOOOOOOOOOOOOOOOOOOOOOOOOOOOOOOOOOOOOOOOOOOOOOOOOOOOOOOOOOOOOOOOOOa
aOOOOOOOOOOOOOOOOOOOOOOOOOOOOOOOOOOOOOOOOOOOOOOOOOOOOOOOOOOOOOOOOOOOOOOOOOOOOOOOOOOOOOOOOOOOOOOOOOOa
aOOOOOOOOOOOOOOOOOOOOOOOOOOOOOOOOOOOOOOOOOOOOOOOOOOOOOOOOOOOOOOOOOOOOOOOOOOOOOOOOOOOOOOOOOOOOOOOOOOa
aOOOOOOOOOOOOOOOOOOOOOOOOOOOOOOOOOOOOOOOOOOOOOOOOOOOOOOOOOOOOOOOOOOOOOOOOOOOOOOOOOOOOOOOOOOOOOOOOOOa
aOOOOOOOOOOOOOOOOOOOOOOOOOOOOOOOOOOOOOOOOOOOOOOOOOOOOOOOOOOOOOOOOOOOOOOOOOOOOOOOOOOOOOOOOOOOOOOOOOOa
aOOOOOOOOOOOOOOOOOOOOOOOOOOOOOOOOOOOOOOOOOOOOOOOOOOOOOOOOOOOOOOOOOOOOOOOOOOOOOOOOOOOOOOOOOOOOOOOOOOa
aOOOOOOOOOOOOOOOOOOOOOOOOOOOOOOOOOOOOOOOOOOOOOOOOOOOOOOOOOOOOOOOOOOOOOOOOOOOOOOOOOOOOOOOOOOOOOOOOOOa
aOOOOOOOOOOOOOOOOOOOOOOOOOOOOOOOOOOOOOOOOOOOOOOOOOOOOOOOOOOOOOOOOOOOOOOOOOOOOOOOOOOOOOOOOOOOOOOOOOOa
aOOOOOOOOOOOOOOOOOOOOOOOOOOOOOOOOOOOOOOOOOOOOOOOOOOOOOOOOOOOOOOOOOOOOOOOOOOOOOOOOOOOOOOOOOOOOOOOOOOa
aOOOOOOOOOOOOOOOOOOOOOOOOOOOOOOOOOOOOOOOOOOOOOOOOOOOOOOOOOOOOOOOOOOOOOOOOOOOOOOOOOOOOOOOOOOOOOOOOOOa
aOOOOOOOOOOOOOOOOOOOOOOOOOOOOOOOOOOOOOOOOOOOOOOOOOOOOOOOOOOOOOOOOOOOOOOOOOOOOOOOOOOOOOOOOOOOOOOOOOOa
aOOOOOOOOOOOOOOOOOOOOOOOOOOOOOOOOOOOOOOOOOOOOOOOOOOOOOOOOOOOOOOOOOOOOOOOOOOOOOOOOOOOOOOOOOOOOOOOOOOa
aOOOOOOOOOOOOOOOOOOOOOOOOOOOOOOOOOOOOOOOOOOOOOOOOOOOOOOOOOOOOOOOOOOOOOOOOOOOOOOOOOOOOOOOOOOOOOOOOOOa
aOOOOOOOOOOOOOOOOOOOOOOOOOOOOOOOOOOOOOOOOOOOOOOOOOOOOOOOOOOOOOOOOOOOOOOOOOOOOOOOOOOOOOOOOOOOOOOOOOOa
aOOOOOOOOOOOOOOOOOOOOOOOOOOOOOOOOOOOOOOOOOOOOOOOOOOOOOOOOOOOOOOOOOOOOOOOOOOOOOOOOOOOOOOOOOOOOOOOOOOa
aOOOOOOOOOOOOOOOOOOOOOOOOOOOOOOOOOOOOOOOOOOOOOOOOOOOOOOOOOOOOOOOOOOOOOOOOOOOOOOOOOOOOOOOOOOOOOOOOOOa
aOOOOOOOOOOOOOOOOOOOOOOOOOOOOOOOOOOOOOOOOOOOOOOOOOOOOOOOOOOOOOOOOOOOOOOOOOOOOOOOOOOOOOOOOOOOOOOOOOOa
aOOOOOOOOOOOOOOOOOOOOOOOOOOOOOOOOOOOOOOOOOOOOOOOOOOOOOOOOOOOOOOOOOOOOOOOOOOOOOOOOOOOOOOOOOOOOOOOOOOa
aaaaaaaaaaaaaaaaaaaaaaaaaaaaaaaaaaaaaaaaaaaaaaaaaaaaaaaaaaaaaaaaaaaaaaaaaaaaaaaaaaaaaaaaaaaaaaaaaaaa
"}
