"aa" = (/obj/effect/paint/green,/turf/simulated/wall,/area/map_template/wreck/wreckfour)
"ab" = (/obj/effect/wallframe_spawn/reinforced,/obj/effect/paint/green,/turf/simulated/floor/plating,/area/map_template/wreck/wreckfour)
"ac" = (/obj/effect/floor_decal/corner/b_green/border{dir = 1},/obj/structure/bed/chair/padded/green,/turf/simulated/floor/tiled/dark/monotile,/area/map_template/wreck/wreckfour)
"ad" = (/obj/effect/floor_decal/corner/b_green/border{dir = 1},/obj/structure/table/woodentable/walnut,/turf/simulated/floor/tiled/dark/monotile,/area/map_template/wreck/wreckfour)
"ae" = (/obj/effect/floor_decal/corner/b_green/border{dir = 1},/obj/structure/mopbucket,/turf/simulated/floor/tiled/dark/monotile,/area/map_template/wreck/wreckfour)
"af" = (/obj/effect/floor_decal/corner/b_green/border{dir = 1},/obj/structure/flora/pottedplant/minitree,/obj/machinery/light/invisible{dir = 1},/turf/simulated/floor/tiled/dark/monotile,/area/map_template/wreck/wreckfour)
"ag" = (/obj/effect/floor_decal/corner/b_green/border{dir = 1},/obj/structure/bed/chair/padded/green{dir = 4},/turf/simulated/floor/tiled/dark/monotile,/area/map_template/wreck/wreckfour)
"ah" = (/obj/effect/floor_decal/corner/b_green/border{dir = 1},/obj/structure/table/woodentable/walnut,/obj/random/junkyard/advdevice,/turf/simulated/floor/tiled/dark/monotile,/area/map_template/wreck/wreckfour)
"ai" = (/obj/effect/floor_decal/corner/b_green/border{dir = 1},/obj/structure/bed/chair/padded/green{dir = 8},/turf/simulated/floor/tiled/dark/monotile,/area/map_template/wreck/wreckfour)
"aj" = (/obj/effect/floor_decal/borderfloor/corner,/obj/effect/floor_decal/spline/fancy/wood/corner,/obj/machinery/portable_atmospherics/powered/scrubber/broken,/obj/machinery/light{dir = 1},/turf/simulated/floor/tiled/dark,/area/map_template/wreck/wreckfour)
"ak" = (/obj/effect/floor_decal/borderfloor,/obj/effect/floor_decal/spline/fancy/wood,/turf/simulated/floor/tiled/dark,/area/map_template/wreck/wreckfour)
"al" = (/obj/effect/floor_decal/spline/fancy/wood/corner,/obj/effect/floor_decal/spline/fancy/wood/corner{dir = 8},/turf/simulated/floor/tiled/dark,/area/map_template/wreck/wreckfour)
"am" = (/obj/effect/floor_decal/borderfloor,/obj/effect/floor_decal/spline/fancy/wood,/obj/structure/bed/chair/padded/green{dir = 1},/turf/simulated/floor/tiled/dark,/area/map_template/wreck/wreckfour)
"an" = (/obj/effect/floor_decal/borderfloor/corner{dir = 8},/obj/effect/floor_decal/spline/fancy/wood/corner{dir = 8},/obj/structure/closet/crate/secure/hydrosec,/obj/machinery/light{dir = 1},/turf/simulated/floor/tiled/dark,/area/map_template/wreck/wreckfour)
"ao" = (/obj/effect/floor_decal/borderfloor/corner,/obj/effect/floor_decal/spline/fancy/wood/corner,/obj/machinery/newscaster{pixel_y = 30},/turf/simulated/floor/tiled/dark,/area/map_template/wreck/wreckfour)
"ap" = (/obj/effect/floor_decal/borderfloor{dir = 6},/obj/effect/floor_decal/spline/fancy/wood{dir = 6; icon_state = "spline_fancy"},/turf/simulated/floor/tiled/dark,/area/map_template/wreck/wreckfour)
"aq" = (/turf/unsimulated/floor/exoplanet/grass,/area/map_template/wreck/wreckfour)
"ar" = (/obj/effect/floor_decal/spline/fancy/wood{dir = 8},/obj/effect/floor_decal/spline/fancy/wood{dir = 4},/turf/simulated/floor/tiled/dark,/area/map_template/wreck/wreckfour)
"as" = (/turf/unsimulated/floor/exoplanet/barren,/area/map_template/wreck/wreckfour)
"at" = (/obj/effect/floor_decal/borderfloor{dir = 10},/obj/effect/floor_decal/spline/fancy/wood{dir = 10; icon_state = "spline_fancy"},/turf/simulated/floor/tiled/dark,/area/map_template/wreck/wreckfour)
"au" = (/obj/effect/floor_decal/borderfloor/corner{dir = 8},/obj/effect/floor_decal/spline/fancy/wood/corner{dir = 8},/obj/machinery/atm{pixel_y = 29},/turf/simulated/floor/tiled/dark,/area/map_template/wreck/wreckfour)
"av" = (/obj/effect/floor_decal/borderfloor/corner,/obj/effect/floor_decal/spline/fancy/wood/corner,/obj/machinery/light{dir = 1},/turf/simulated/floor/tiled/dark,/area/map_template/wreck/wreckfour)
"aw" = (/turf/simulated/floor/grass,/area/map_template/wreck/wreckfour)
"ax" = (/obj/effect/floor_decal/spline/fancy/wood{dir = 8},/obj/effect/floor_decal/spline/fancy/wood{dir = 4},/obj/machinery/light/invisible,/turf/simulated/floor/tiled/dark,/area/map_template/wreck/wreckfour)
"ay" = (/obj/machinery/beehive,/turf/simulated/floor/grass,/area/map_template/wreck/wreckfour)
"az" = (/obj/machinery/portable_atmospherics/hydroponics/soil,/turf/simulated/floor/grass,/area/map_template/wreck/wreckfour)
"aA" = (/obj/effect/floor_decal/borderfloor/corner{dir = 8},/obj/effect/floor_decal/spline/fancy/wood/corner{dir = 8},/obj/machinery/light{dir = 1},/turf/simulated/floor/tiled/dark,/area/map_template/wreck/wreckfour)
"aB" = (/obj/effect/floor_decal/borderfloor/corner,/obj/effect/floor_decal/spline/fancy/wood/corner,/obj/machinery/portable_atmospherics/canister/oxygen,/turf/simulated/floor/tiled/dark,/area/map_template/wreck/wreckfour)
"aC" = (/obj/effect/floor_decal/spline/fancy/wood{dir = 9; icon_state = "spline_fancy"},/turf/simulated/floor/tiled/dark,/area/map_template/wreck/wreckfour)
"aD" = (/obj/effect/floor_decal/spline/fancy/wood/corner{dir = 1},/obj/effect/floor_decal/spline/fancy/wood/corner{dir = 4},/obj/machinery/light/invisible{dir = 1},/turf/simulated/floor/tiled/dark/monotile,/area/map_template/wreck/wreckfour)
"aE" = (/obj/effect/floor_decal/spline/fancy/wood{dir = 5; icon_state = "spline_fancy"},/turf/simulated/floor/tiled/dark,/area/map_template/wreck/wreckfour)
"aF" = (/obj/effect/floor_decal/borderfloor/corner{dir = 8},/obj/effect/floor_decal/spline/fancy/wood/corner{dir = 8},/turf/simulated/floor/tiled/dark,/area/map_template/wreck/wreckfour)
"aG" = (/obj/effect/floor_decal/borderfloor{dir = 4},/obj/effect/floor_decal/spline/fancy/wood{dir = 4},/turf/simulated/floor/tiled/dark,/area/map_template/wreck/wreckfour)
"aH" = (/obj/effect/floor_decal/spline/fancy/wood,/obj/structure/railing/mapped,/obj/random/intel_console,/turf/simulated/floor/tiled/dark/monotile,/area/map_template/wreck/wreckfour)
"aI" = (/obj/effect/floor_decal/spline/fancy/wood{dir = 9; icon_state = "spline_fancy"},/obj/effect/floor_decal/spline/fancy/wood/corner,/turf/simulated/floor/tiled/dark/monotile,/area/map_template/wreck/wreckfour)
"aJ" = (/obj/effect/floor_decal/spline/fancy/wood/corner{dir = 4},/obj/effect/floor_decal/spline/fancy/wood,/obj/structure/railing/mapped,/turf/simulated/floor/tiled/dark/monotile,/area/map_template/wreck/wreckfour)
"aK" = (/obj/machinery/light/invisible{dir = 4},/turf/simulated/floor/grass,/area/map_template/wreck/wreckfour)
"aL" = (/obj/effect/floor_decal/spline/fancy/wood/corner{dir = 1},/obj/effect/floor_decal/spline/fancy/wood,/obj/structure/railing/mapped,/obj/machinery/space_heater,/turf/simulated/floor/tiled/dark/monotile,/area/map_template/wreck/wreckfour)
"aM" = (/obj/effect/floor_decal/spline/fancy/wood{dir = 5; icon_state = "spline_fancy"},/obj/effect/floor_decal/spline/fancy/wood/corner{dir = 4},/obj/effect/floor_decal/spline/fancy/wood/corner{dir = 8},/turf/simulated/floor/tiled/dark/monotile,/area/map_template/wreck/wreckfour)
"aN" = (/obj/effect/floor_decal/borderfloor{dir = 8},/obj/effect/floor_decal/spline/fancy/wood{dir = 8},/turf/simulated/floor/tiled/dark,/area/map_template/wreck/wreckfour)
"aO" = (/obj/effect/floor_decal/corner/b_green/border{dir = 8},/obj/structure/bed/chair/padded/green{dir = 4},/turf/simulated/floor/tiled/dark/monotile,/area/map_template/wreck/wreckfour)
"aP" = (/obj/effect/floor_decal/spline/fancy/wood/corner{dir = 4},/obj/effect/floor_decal/spline/fancy/wood{dir = 4},/obj/structure/railing/mapped{dir = 4; icon_state = "railing0-1"},/turf/simulated/floor/tiled/dark/monotile,/area/map_template/wreck/wreckfour)
"aQ" = (/turf/unsimulated/floor/exoplanet/water/shallow,/area/map_template/wreck/wreckfour)
"aR" = (/obj/effect/floor_decal/spline/fancy/wood/corner{dir = 1},/obj/effect/floor_decal/spline/fancy/wood{dir = 8},/obj/structure/railing/mapped{dir = 8; icon_state = "railing0-1"},/turf/simulated/floor/tiled/dark/monotile,/area/map_template/wreck/wreckfour)
"aS" = (/obj/effect/floor_decal/corner/b_green/border{dir = 4},/obj/structure/closet/crate/hydroponics/beekeeping,/turf/simulated/floor/tiled/dark/monotile,/area/map_template/wreck/wreckfour)
"aT" = (/obj/effect/floor_decal/corner/b_green/border{dir = 8},/obj/structure/table/woodentable/walnut,/obj/random/junkyard/smokes,/turf/simulated/floor/tiled/dark/monotile,/area/map_template/wreck/wreckfour)
"aU" = (/obj/machinery/light/invisible{dir = 8},/turf/simulated/floor/grass,/area/map_template/wreck/wreckfour)
"aV" = (/obj/effect/floor_decal/spline/fancy/wood{dir = 8},/obj/structure/flora/pottedplant/minitree,/obj/machinery/light/invisible{dir = 8},/turf/simulated/floor/tiled/dark/monotile,/area/map_template/wreck/wreckfour)
"aW" = (/obj/effect/floor_decal/spline/fancy/wood{dir = 4},/obj/structure/railing/mapped{dir = 4; icon_state = "railing0-1"},/turf/simulated/floor/tiled/dark/monotile,/area/map_template/wreck/wreckfour)
"aX" = (/obj/structure/flora/tree/pine/xmas,/turf/unsimulated/floor/exoplanet/grass,/area/map_template/wreck/wreckfour)
"aY" = (/obj/effect/floor_decal/spline/fancy/wood{dir = 8},/obj/structure/railing/mapped{dir = 8; icon_state = "railing0-1"},/obj/machinery/portable_atmospherics/powered/pump,/turf/simulated/floor/tiled/dark/monotile,/area/map_template/wreck/wreckfour)
"aZ" = (/obj/effect/floor_decal/spline/fancy/wood{dir = 4},/obj/structure/flora/pottedplant/minitree,/obj/machinery/light/invisible{dir = 4},/turf/simulated/floor/tiled/dark/monotile,/area/map_template/wreck/wreckfour)
"ba" = (/obj/machinery/beehive,/obj/structure/cable/green{d1 = 2; d2 = 8; icon_state = "2-8"},/turf/simulated/floor/grass,/area/map_template/wreck/wreckfour)
"bb" = (/obj/effect/floor_decal/corner/b_green/border{dir = 4},/obj/machinery/seed_storage/garden{dir = 8},/turf/simulated/floor/tiled/dark/monotile,/area/map_template/wreck/wreckfour)
"bc" = (/obj/effect/floor_decal/corner/b_green/border{dir = 8},/obj/structure/bed/chair/padded/green{dir = 1},/obj/machinery/light/invisible{dir = 8},/turf/simulated/floor/tiled/dark/monotile,/area/map_template/wreck/wreckfour)
"bd" = (/obj/effect/floor_decal/borderfloor{dir = 4},/obj/effect/floor_decal/spline/fancy/wood{dir = 4},/obj/machinery/atmospherics/unary/vent_pump/on,/turf/simulated/floor/tiled/dark,/area/map_template/wreck/wreckfour)
"be" = (/obj/effect/floor_decal/spline/fancy/wood{dir = 10; icon_state = "spline_fancy"},/turf/simulated/floor/tiled/dark,/area/map_template/wreck/wreckfour)
"bf" = (/obj/effect/floor_decal/spline/fancy/wood/corner{dir = 8},/obj/effect/floor_decal/spline/fancy/wood{dir = 4},/obj/structure/railing/mapped{dir = 4; icon_state = "railing0-1"},/turf/simulated/floor/tiled/dark/monotile,/area/map_template/wreck/wreckfour)
"bg" = (/obj/effect/floor_decal/spline/fancy/wood/corner,/obj/effect/floor_decal/spline/fancy/wood{dir = 8},/obj/structure/railing/mapped{dir = 8; icon_state = "railing0-1"},/turf/simulated/floor/tiled/dark/monotile,/area/map_template/wreck/wreckfour)
"bh" = (/obj/effect/floor_decal/spline/fancy/wood{dir = 6; icon_state = "spline_fancy"},/turf/simulated/floor/tiled/dark,/area/map_template/wreck/wreckfour)
"bi" = (/obj/effect/floor_decal/borderfloor{dir = 8},/obj/effect/floor_decal/spline/fancy/wood{dir = 8},/obj/machinery/atmospherics/unary/vent_scrubber/on,/turf/simulated/floor/tiled/dark,/area/map_template/wreck/wreckfour)
"bj" = (/obj/effect/floor_decal/corner/b_green/border{dir = 4},/obj/machinery/vending/hydronutrients/generic{dir = 8},/obj/machinery/light/invisible{dir = 4},/turf/simulated/floor/tiled/dark/monotile,/area/map_template/wreck/wreckfour)
"bk" = (/obj/effect/floor_decal/corner/b_green/border{dir = 8},/obj/structure/reagent_dispensers/watertank,/turf/simulated/floor/tiled/dark/monotile,/area/map_template/wreck/wreckfour)
"bl" = (/obj/effect/floor_decal/borderfloor{dir = 4},/obj/effect/floor_decal/spline/fancy/wood{dir = 4},/obj/machinery/atmospherics/pipe/simple/hidden/supply,/turf/simulated/floor/tiled/dark,/area/map_template/wreck/wreckfour)
"bm" = (/obj/structure/foamedmetal,/turf/template_noop,/area/template_noop)
"bn" = (/obj/effect/floor_decal/spline/fancy/wood{dir = 10; icon_state = "spline_fancy"},/obj/effect/floor_decal/spline/fancy/wood/corner{dir = 1},/turf/simulated/floor/tiled/dark/monotile,/area/map_template/wreck/wreckfour)
"bo" = (/obj/effect/floor_decal/spline/fancy/wood/corner{dir = 8},/obj/effect/floor_decal/spline/fancy/wood{dir = 1; icon_state = "spline_fancy"},/obj/structure/railing/mapped{dir = 1; icon_state = "railing0-1"},/turf/simulated/floor/tiled/dark/monotile,/area/map_template/wreck/wreckfour)
"bp" = (/obj/effect/floor_decal/spline/fancy/wood{dir = 1; icon_state = "spline_fancy"},/obj/structure/railing/mapped{dir = 1; icon_state = "railing0-1"},/obj/structure/disposalpipe/trunk,/obj/machinery/disposal,/turf/simulated/floor/tiled/dark/monotile,/area/map_template/wreck/wreckfour)
"bq" = (/obj/effect/floor_decal/spline/fancy/wood/corner,/obj/effect/floor_decal/spline/fancy/wood{dir = 1; icon_state = "spline_fancy"},/obj/structure/railing/mapped{dir = 1; icon_state = "railing0-1"},/turf/simulated/floor/tiled/dark/monotile,/area/map_template/wreck/wreckfour)
"br" = (/obj/effect/floor_decal/spline/fancy/wood{dir = 6; icon_state = "spline_fancy"},/obj/effect/floor_decal/spline/fancy/wood/corner{dir = 4},/turf/simulated/floor/tiled/dark/monotile,/area/map_template/wreck/wreckfour)
"bs" = (/obj/effect/floor_decal/borderfloor{dir = 8},/obj/effect/floor_decal/spline/fancy/wood{dir = 8},/obj/machinery/atmospherics/pipe/simple/hidden/scrubbers,/turf/simulated/floor/tiled/dark,/area/map_template/wreck/wreckfour)
"bt" = (/obj/effect/floor_decal/borderfloor{dir = 4},/obj/effect/floor_decal/spline/fancy/wood{dir = 4},/obj/structure/closet/crate/large,/obj/random/junkyard/loot,/obj/random/junkyard/loot,/obj/random/junkyard/loot,/obj/random/junkyard/loot,/obj/random/junkyard/loot,/obj/machinery/atmospherics/pipe/simple/hidden/supply,/turf/simulated/floor/tiled/dark,/area/map_template/wreck/wreckfour)
"bu" = (/obj/effect/floor_decal/spline/fancy/wood/corner,/obj/effect/floor_decal/spline/fancy/wood/corner{dir = 8},/obj/structure/disposalpipe/segment,/obj/machinery/light/invisible,/obj/machinery/hologram/holopad,/turf/simulated/floor/tiled/dark/monotile,/area/map_template/wreck/wreckfour)
"bv" = (/obj/effect/floor_decal/borderfloor/corner{dir = 4},/obj/effect/floor_decal/spline/fancy/wood/corner{dir = 1},/obj/structure/closet/crate/freezer/rations,/obj/machinery/atmospherics/pipe/simple/hidden/supply{dir = 5},/turf/simulated/floor/tiled/dark,/area/map_template/wreck/wreckfour)
"bw" = (/obj/effect/floor_decal/borderfloor{dir = 5},/obj/effect/floor_decal/spline/fancy/wood{dir = 5; icon_state = "spline_fancy"},/obj/machinery/atmospherics/pipe/simple/hidden/supply{dir = 10},/turf/simulated/floor/tiled/dark,/area/map_template/wreck/wreckfour)
"bx" = (/obj/effect/floor_decal/spline/fancy/wood{dir = 8},/obj/effect/floor_decal/spline/fancy/wood{dir = 4},/obj/structure/disposalpipe/segment,/obj/machinery/light/invisible{dir = 1},/turf/simulated/floor/tiled/dark,/area/map_template/wreck/wreckfour)
"by" = (/obj/effect/floor_decal/borderfloor{dir = 9},/obj/effect/floor_decal/spline/fancy/wood{dir = 9; icon_state = "spline_fancy"},/obj/machinery/atmospherics/pipe/simple/hidden/scrubbers{dir = 6},/turf/simulated/floor/tiled/dark,/area/map_template/wreck/wreckfour)
"bz" = (/obj/effect/floor_decal/borderfloor/corner{dir = 1},/obj/effect/floor_decal/spline/fancy/wood/corner{dir = 4},/obj/machinery/atmospherics/pipe/simple/hidden/scrubbers{dir = 9},/turf/simulated/floor/tiled/dark,/area/map_template/wreck/wreckfour)
"bA" = (/obj/effect/floor_decal/borderfloor/corner{dir = 4},/obj/effect/floor_decal/spline/fancy/wood/corner{dir = 1},/obj/machinery/light,/obj/machinery/atmospherics/pipe/simple/hidden/supply{dir = 5},/turf/simulated/floor/tiled/dark,/area/map_template/wreck/wreckfour)
"bB" = (/obj/effect/floor_decal/spline/fancy/wood{dir = 8},/obj/effect/floor_decal/spline/fancy/wood{dir = 4},/obj/structure/disposalpipe/segment,/turf/simulated/floor/tiled/dark,/area/map_template/wreck/wreckfour)
"bC" = (/obj/effect/floor_decal/borderfloor/corner{dir = 1},/obj/effect/floor_decal/spline/fancy/wood/corner{dir = 4},/obj/machinery/light,/obj/machinery/atmospherics/pipe/simple/hidden/scrubbers{dir = 9},/turf/simulated/floor/tiled/dark,/area/map_template/wreck/wreckfour)
"bD" = (/obj/effect/floor_decal/borderfloor/corner{dir = 4},/obj/effect/floor_decal/spline/fancy/wood/corner{dir = 1},/obj/structure/closet/crate/plastic,/obj/random/junkyard/tech_supply,/obj/random/junkyard/tech_supply,/obj/random/junkyard/tech_supply,/obj/random/junkyard/tech_supply,/obj/machinery/atmospherics/pipe/simple/hidden/supply{dir = 5},/turf/simulated/floor/tiled/dark,/area/map_template/wreck/wreckfour)
"bE" = (/obj/effect/floor_decal/borderfloor{dir = 5},/obj/effect/floor_decal/spline/fancy/wood{dir = 5; icon_state = "spline_fancy"},/obj/machinery/atmospherics/pipe/simple/hidden/supply{dir = 10},/obj/structure/cable/green{d1 = 2; d2 = 4; icon_state = "2-4"},/turf/simulated/floor/tiled/dark,/area/map_template/wreck/wreckfour)
"bF" = (/obj/machinery/portable_atmospherics/hydroponics/soil,/obj/item/clothing/head/helmet/space/void/engineering/salvage,/turf/simulated/floor/grass,/area/map_template/wreck/wreckfour)
"bG" = (/obj/machinery/power/port_gen/pacman{anchored = 0; sheets = 25},/obj/structure/cable/green{d2 = 8; icon_state = "0-8"},/turf/simulated/floor/grass,/area/map_template/wreck/wreckfour)
"bH" = (/obj/effect/floor_decal/borderfloor/corner{dir = 1},/obj/effect/floor_decal/spline/fancy/wood/corner{dir = 4},/obj/machinery/firealarm{dir = 4; pixel_x = 24},/obj/machinery/atmospherics/pipe/simple/hidden/scrubbers{dir = 9},/turf/simulated/floor/tiled/dark,/area/map_template/wreck/wreckfour)
"bI" = (/obj/effect/floor_decal/borderfloor/corner{dir = 4},/obj/effect/floor_decal/spline/fancy/wood/corner{dir = 1},/obj/structure/cable{d2 = 4; icon_state = "0-4"},/obj/machinery/power/apc/derelict{dir = 8; pixel_x = -20},/obj/machinery/light,/obj/machinery/atmospherics/pipe/simple/hidden/supply{dir = 5},/obj/structure/cable/green,/turf/simulated/floor/tiled/dark,/area/map_template/wreck/wreckfour)
"bJ" = (/obj/effect/floor_decal/borderfloor{dir = 5},/obj/effect/floor_decal/spline/fancy/wood{dir = 5; icon_state = "spline_fancy"},/obj/structure/cable{d1 = 2; d2 = 8; desc = "A flexible superconducting cable for heavy-duty power transfer. It's been labeled 'chaos reigns'."; icon_state = "2-8"},/obj/machinery/atmospherics/pipe/simple/hidden/supply{dir = 10},/obj/structure/cable/green{d1 = 1; d2 = 4; icon_state = "1-4"},/turf/simulated/floor/tiled/dark,/area/map_template/wreck/wreckfour)
"bK" = (/obj/structure/closet/crate/secure/loot,/turf/simulated/floor/plating,/area/template_noop)
"bL" = (/obj/effect/floor_decal/spline/fancy/wood{dir = 8},/obj/effect/floor_decal/spline/fancy/wood{dir = 4},/obj/structure/disposalpipe/segment,/obj/item/clothing/suit/space/void/engineering/salvage,/turf/simulated/floor/tiled/dark,/area/map_template/wreck/wreckfour)
"bM" = (/obj/effect/floor_decal/borderfloor/corner{dir = 4},/obj/effect/floor_decal/spline/fancy/wood/corner{dir = 1},/obj/structure/cable{d1 = 1; d2 = 4; icon_state = "1-4"},/obj/machinery/light,/obj/machinery/atmospherics/pipe/simple/hidden/supply{dir = 5},/turf/simulated/floor/tiled/dark,/area/map_template/wreck/wreckfour)
"bN" = (/obj/effect/floor_decal/borderfloor{dir = 1},/obj/effect/floor_decal/spline/fancy/wood{dir = 1; icon_state = "spline_fancy"},/obj/structure/cable{d1 = 4; d2 = 8; icon_state = "4-8"},/obj/machinery/atmospherics/pipe/simple/hidden/supply{dir = 4},/obj/machinery/alarm{dir = 1; pixel_y = -25},/turf/simulated/floor/tiled/dark,/area/map_template/wreck/wreckfour)
"bO" = (/obj/effect/floor_decal/borderfloor{dir = 1},/obj/effect/floor_decal/spline/fancy/wood{dir = 1; icon_state = "spline_fancy"},/obj/structure/inflatable/wall,/obj/structure/cable{d1 = 4; d2 = 8; icon_state = "4-8"},/obj/machinery/atmospherics/pipe/simple/hidden/supply{dir = 4},/turf/simulated/floor/tiled/dark,/area/map_template/wreck/wreckfour)
"bP" = (/obj/effect/floor_decal/spline/fancy/wood/corner{dir = 1},/obj/effect/floor_decal/spline/fancy/wood/corner{dir = 4},/obj/structure/inflatable/door,/obj/structure/disposalpipe/segment,/obj/structure/cable{d1 = 2; d2 = 8; desc = "A flexible superconducting cable for heavy-duty power transfer. It's been labeled 'chaos reigns'."; icon_state = "2-8"},/obj/machinery/atmospherics/pipe/simple/hidden/supply{dir = 10},/obj/machinery/atmospherics/pipe/simple/hidden/scrubbers{dir = 6},/turf/simulated/floor/tiled/dark,/area/map_template/wreck/wreckfour)
"bQ" = (/obj/effect/floor_decal/borderfloor{dir = 1},/obj/effect/floor_decal/spline/fancy/wood{dir = 1; icon_state = "spline_fancy"},/obj/structure/inflatable/wall,/obj/machinery/atmospherics/pipe/simple/hidden/scrubbers{dir = 4},/turf/simulated/floor/tiled/dark,/area/map_template/wreck/wreckfour)
"bR" = (/obj/effect/floor_decal/borderfloor{dir = 1},/obj/effect/floor_decal/spline/fancy/wood{dir = 1; icon_state = "spline_fancy"},/obj/machinery/atmospherics/pipe/simple/hidden/scrubbers{dir = 4},/turf/simulated/floor/tiled/dark,/area/map_template/wreck/wreckfour)
"bS" = (/obj/structure/disposalpipe/segment,/obj/structure/cable{d1 = 1; d2 = 2; icon_state = "1-2"},/obj/machinery/door/airlock/hatch/maintenance/bolted,/obj/machinery/atmospherics/pipe/simple/hidden/scrubbers,/obj/machinery/atmospherics/pipe/simple/hidden/supply,/turf/simulated/floor/tiled/dark,/area/map_template/wreck/wreckfour)
"bT" = (/turf/simulated/floor/steel_dirty,/area/map_template/wreck/wreckfour)
"bU" = (/obj/structure/inflatable/door,/obj/structure/disposalpipe/segment,/obj/structure/cable{d1 = 1; d2 = 2; icon_state = "1-2"},/obj/machinery/atmospherics/pipe/simple/hidden/scrubbers,/obj/machinery/atmospherics/pipe/simple/hidden/supply,/turf/simulated/floor/steel_dirty,/area/map_template/wreck/wreckfour)
"bV" = (/obj/structure/inflatable/wall,/turf/simulated/floor/plating,/area/map_template/wreck/wreckfour)
"bW" = (/obj/structure/inflatable/wall,/turf/simulated/floor/steel_dirty,/area/map_template/wreck/wreckfour)
"bX" = (/obj/structure/lattice,/obj/structure/disposalpipe/segment,/obj/structure/cable{d1 = 1; d2 = 2; icon_state = "1-2"},/obj/machinery/atmospherics/pipe/simple/hidden/scrubbers,/obj/machinery/atmospherics/pipe/simple/hidden/supply,/turf/template_noop,/area/map_template/wreck/wreckfour)
"fE" = (/obj/structure/lattice,/obj/structure/girder/displaced,/turf/template_noop,/area/template_noop)
"hd" = (/obj/structure/grille/broken,/turf/simulated/floor/plating,/area/template_noop)
"hI" = (/obj/random/junkyard/obstruction,/turf/simulated/floor/steel_dirty,/area/template_noop)
"pz" = (/obj/structure/catwalk,/obj/random/junkyard/hostile,/turf/simulated/floor/plating,/area/template_noop)
"qV" = (/turf/simulated/floor/plating,/area/template_noop)
"ru" = (/obj/machinery/atmospherics/pipe/simple/hidden/scrubbers,/turf/template_noop,/area/template_noop)
"uj" = (/obj/structure/disposalpipe/segment,/obj/structure/cable{d1 = 1; d2 = 2; icon_state = "1-2"},/obj/machinery/atmospherics/pipe/simple/hidden/supply,/obj/machinery/atmospherics/pipe/simple/hidden/scrubbers,/turf/simulated/floor/steel_dirty,/area/template_noop)
"uH" = (/obj/structure/catwalk,/turf/simulated/floor/plating,/area/template_noop)
"vk" = (/obj/structure/grille,/turf/simulated/floor/plating,/area/template_noop)
"BW" = (/obj/random/junkyard/hostile,/turf/simulated/floor/tiled/techmaint,/area/template_noop)
"CM" = (/obj/structure/lattice,/obj/machinery/atmospherics/pipe/simple/hidden/scrubbers,/turf/template_noop,/area/template_noop)
"DT" = (/obj/random/junkyard/hostile,/turf/simulated/floor/steel_dirty,/area/template_noop)
"EO" = (/obj/structure/girder/displaced,/turf/template_noop,/area/template_noop)
"Fi" = (/obj/structure/dispenser/oxygen,/turf/simulated/floor/tiled/techmaint,/area/template_noop)
"FU" = (/turf/template_noop,/area/template_noop)
"Jd" = (/obj/structure/lattice,/obj/random/junkyard/obstruction,/turf/template_noop,/area/template_noop)
"Jg" = (/obj/structure/foamedmetal,/obj/structure/disposalpipe/segment,/obj/structure/cable{d1 = 1; d2 = 2; icon_state = "1-2"},/obj/machinery/atmospherics/pipe/simple/hidden/supply,/obj/machinery/atmospherics/pipe/simple/hidden/scrubbers,/turf/simulated/floor/plating,/area/template_noop)
"Kp" = (/obj/structure/lattice,/turf/template_noop,/area/template_noop)
"KB" = (/turf/simulated/wall,/area/template_noop)
"KO" = (/obj/effect/paint/green,/turf/simulated/wall,/area/template_noop)
"NF" = (/turf/simulated/floor/tiled/techfloor/grid,/area/template_noop)
"Pt" = (/obj/random/junkyard/obstruction,/turf/template_noop,/area/template_noop)
"SF" = (/obj/structure/girder,/turf/template_noop,/area/template_noop)
"WU" = (/obj/structure/girder,/turf/simulated/floor/plating,/area/template_noop)
"YX" = (/obj/structure/foamedmetal,/turf/simulated/floor/steel_dirty,/area/template_noop)
"Zz" = (/obj/structure/disposalpipe/segment,/obj/machinery/atmospherics/pipe/simple/hidden/supply,/turf/template_noop,/area/template_noop)
"ZO" = (/turf/simulated/floor/tiled/techmaint,/area/template_noop)

(1,1,1) = {"
FUFUFUFUFUFUFUFUFUFUFUFUFUFUFUFUFUFUFUFUFUFUFUFUFUFUKpFUFUFU
FUFUFUFUFUFUFUFUFUFUFUFUFUFUPtFUFUFUFUFUFUFUFUFUSFKBKpFUFUFU
FUFUFUFUFUFUFUFUFUFUFUEOFUFUFUFUFUFUFUFUFUFUFUFUFUZOKBFUFUFU
FUFUFUFUFUKOKOFUFUFUFUaaabababababababaaFUFUKpfEKpqVKBKBqVKp
FUFUFUFUPtKOKOFUFUFUaaaaacadaeafagahaiaaaaFUFUKpZOFiKBBWFUFU
FUFUFUFUFUFUFUFUFUaaaaajakakakalakamakanaaaaFUFUFUKBKBKpFUFU
FUFUFUFUFUFUFUFUaaaaaoapawawawarawawawatauaaaaFUFUFUKpKpFUFU
FUFUFUFUFUFUFUababavapawayayawaxawazazawataAababFUFUFUFUFUFU
FUFUFUFUFUFUFUabaBapawawawawaCaDaEawawawawataFabFUFUFUFUFUFU
FUFUEOFUFUFUababaGawayayawaIaJaHaLaMawazazawaNababFUFUFUFUFU
FUFUFUFUFUFUabaOaGawawawaCaPaQaqaQaRaEawawawaNaSabFUFUSFFUKO
FUFUFUFUFUFUabaTaGayayaKaVaWasaXaqaYaZaUazazaNbbabFUFUKpKpKO
FUFUFUFUFUFUabbcbdawawawbebfaQaQasbgbhawawawbibjabFUFUFUKpKp
FUFUFUFUFUFUabbkblawayayawbnbobpbqbrawazazawbsaSabFUFUKBJdFU
FUFUFUFUFUFUababbtawawawawawbebubhawawawawawbsababFUFUKBKBKB
FUFUFUFUFUFUFUabbvbwawawayayawbxawazazawawbybzabFUFUFUFUFUFU
FUFUFUFUFUFUFUababbAbwawawawawbBawawawawbybCababFUFUFUFUFUFU
FUFUFUKpFUFUFUFUaaaabDbEbaayawbBawbFazbybHaaaaFUFUFUFUFUFUFU
FUFUFUKpbmFUFUFUFUaaaabIbJbGawbLawawbybCaaaaFUFUFUFUFUFUFUFU
FUFUKOpzKOFUFUFUFUFUaaaabMbNbObPbQbRbCaaaaFUFUFUFUFUFUPtFUFU
FUFUKOuHKOKOKOFUFUFUFUaaaaaaaabSaaaaaaaaFUFUFUFUFUFUFUFUFUFU
FUFUKOuHbKKpKOFUFUFUFUFUFUaabTbUbVaaFUFUFUFUFUFUFUFUFUFUFUFU
FUFUKOKOKOKpWUKpFUFUFUFUFUaabWbXFUbTFUFUFUFUFUFUFUKBKBKBKBFU
FUFUFUFUKOuHbmFUFUFUFUFUFUFUFUCMFUKpFUFUFUFUFUFUJdKBNFNFKBFU
FUFUFUFUKpuHKOFUFUFUFUFUFUbmFUruKBFUFUFUFUFUFUFUFUFUKpqVKBFU
FUFUFUFUfEFUFUFUFUFUFUFUFUKOKpFUFUWUFUFUFUFUFUFUFUFUfEFUFUFU
FUFUFUFUFUFUFUFUFUFUFUFUFUKODTFUFUKOFUFUFUFUFUFUFUFUFUFUFUFU
PtFUFUFUFUFUFUFUFUFUFUFUFUvkFUZzYXKOFUFUFUFUFUFUFUFUFUFUFUFU
KBFUFUFUFUFUFUFUFUFUFUKpKphdKpujYXKOFUFUFUFUFUFUFUFUFUFUFUFU
FUFUFUFUFUFUFUFUFUFUFUFUFUFUKpJghIKOFUFUFUFUFUFUFUFUFUFUFUFU
"}
