"aa" = (/turf/simulated/wall,/area/map_template/wreck/wrecktwo/second)
"ab" = (/obj/effect/floor_decal/techfloor{dir = 8; icon_state = "techfloor_edges"},/turf/simulated/floor/tiled/techmaint,/area/map_template/wreck/wrecktwo/second)
"ac" = (/obj/effect/floor_decal/techfloor{dir = 8; icon_state = "techfloor_edges"},/obj/structure/bookcase,/obj/machinery/light{dir = 8},/obj/effect/decal/cleanable/dirt,/turf/simulated/floor/tiled/techmaint,/area/map_template/wreck/wrecktwo/second)
"ad" = (/obj/structure/ore_box,/obj/machinery/atmospherics/pipe/simple/hidden/supply,/turf/simulated/floor/plating,/area/map_template/wreck/wrecktwo/second)
"ae" = (/turf/simulated/floor/plating,/area/map_template/wreck/wrecktwo/second)
"af" = (/obj/structure/lattice,/turf/template_noop,/area/map_template/wreck/wrecktwo/second)
"ag" = (/obj/effect/decal/cleanable/dirt,/turf/simulated/wall,/area/map_template/wreck/wrecktwo/second)
"ah" = (/obj/effect/decal/cleanable/dirt,/obj/effect/decal/cleanable/dirt,/turf/simulated/wall,/area/map_template/wreck/wrecktwo/second)
"ai" = (/obj/structure/barricade,/turf/simulated/floor/plating,/area/map_template/wreck/wrecktwo/second)
"aj" = (/obj/structure/catwalk,/obj/structure/stasis_cage,/obj/machinery/atmospherics/pipe/simple/hidden/scrubbers,/obj/machinery/atmospherics/pipe/simple/hidden/supply,/turf/simulated/floor/plating,/area/map_template/wreck/wrecktwo/second)
"ak" = (/obj/effect/floor_decal/techfloor{dir = 4},/obj/structure/bookcase,/turf/simulated/floor/tiled/techmaint,/area/map_template/wreck/wrecktwo/second)
"al" = (/obj/effect/floor_decal/techfloor{dir = 1},/obj/structure/backup_server,/turf/simulated/floor/tiled/techmaint,/area/map_template/wreck/wrecktwo/second)
"am" = (/obj/structure/barricade,/obj/effect/decal/cleanable/dirt,/turf/simulated/floor/plating,/area/map_template/wreck/wrecktwo/second)
"an" = (/obj/effect/floor_decal/techfloor{dir = 1},/obj/structure/closet/crate,/obj/effect/decal/cleanable/dirt,/obj/random/contraband,/obj/random/contraband,/obj/random/handgun,/obj/random/gloves,/obj/random/powercell,/obj/random/powercell,/obj/random/tool,/turf/simulated/floor/tiled/techmaint,/area/map_template/wreck/wrecktwo/second)
"ao" = (/obj/effect/floor_decal/techfloor{dir = 1},/obj/item/stool/padded,/obj/effect/decal/remains,/turf/simulated/floor/tiled/techmaint,/area/map_template/wreck/wrecktwo/second)
"ap" = (/obj/effect/floor_decal/techfloor/corner{dir = 1},/obj/structure/ore_box,/turf/simulated/floor/tiled/techmaint,/area/map_template/wreck/wrecktwo/second)
"aq" = (/obj/structure/catwalk,/obj/structure/cable{d1 = 1; d2 = 2; icon_state = "1-2"},/obj/machinery/atmospherics/pipe/simple/hidden/scrubbers,/obj/machinery/atmospherics/pipe/simple/hidden/supply,/obj/item/trash/candy,/obj/effect/decal/cleanable/dirt,/turf/simulated/floor/plating,/area/map_template/wreck/wrecktwo/second)
"ar" = (/obj/effect/floor_decal/techfloor/corner{dir = 4},/obj/machinery/atmospherics/unary/vent_scrubber/on,/obj/item/wrench,/obj/item/weldingtool/experimental,/obj/item/stack/nanopaste{pixel_x = 9},/turf/simulated/floor/tiled/techmaint,/area/map_template/wreck/wrecktwo/second)
"as" = (/obj/effect/floor_decal/techfloor{dir = 1},/obj/structure/closet/crate/large,/obj/item/reagent_containers/food/drinks/bottle/cognac,/obj/item/device/robotanalyzer,/obj/random/bomb_supply,/obj/random/junkyard/loot,/obj/random/junkyard/loot,/turf/simulated/floor/tiled/techmaint,/area/map_template/wreck/wrecktwo/second)
"at" = (/obj/effect/floor_decal/techfloor{dir = 1},/obj/machinery/atm{pixel_y = 28},/obj/effect/decal/remains,/turf/simulated/floor/tiled/techmaint,/area/map_template/wreck/wrecktwo/second)
"au" = (/obj/effect/floor_decal/techfloor{dir = 1},/obj/machinery/vending/snack,/turf/simulated/floor/tiled/techmaint,/area/map_template/wreck/wrecktwo/second)
"av" = (/obj/effect/floor_decal/techfloor{dir = 1},/obj/machinery/vending/sovietsoda,/turf/simulated/floor/tiled/techmaint,/area/map_template/wreck/wrecktwo/second)
"aw" = (/obj/effect/floor_decal/techfloor{dir = 1},/obj/machinery/vending/cigarette,/turf/simulated/floor/tiled/techmaint,/area/map_template/wreck/wrecktwo/second)
"ax" = (/obj/effect/floor_decal/techfloor{dir = 1},/obj/structure/closet/emcloset,/obj/machinery/newscaster{pixel_y = 30},/turf/simulated/floor/tiled/techmaint,/area/map_template/wreck/wrecktwo/second)
"ay" = (/obj/effect/decal/cleanable/dirt,/obj/random/intel_console,/turf/simulated/floor/plating,/area/map_template/wreck/wrecktwo/second)
"az" = (/obj/effect/floor_decal/techfloor{dir = 1},/obj/effect/decal/cleanable/blood/splatter,/turf/simulated/floor/tiled/techmaint,/area/map_template/wreck/wrecktwo/second)
"aA" = (/obj/effect/floor_decal/techfloor{dir = 1},/turf/simulated/floor/tiled/techmaint,/area/map_template/wreck/wrecktwo/second)
"aB" = (/obj/structure/catwalk,/obj/structure/disposalpipe/segment{dir = 4},/obj/structure/cable{d1 = 4; d2 = 8; icon_state = "4-8"; pixel_x = 0},/obj/machinery/atmospherics/pipe/simple/hidden/scrubbers{dir = 4},/obj/item/gun/magnetic/railgun/tcc,/obj/item/device/flashlight/maglight{pixel_x = 5; pixel_y = -13},/turf/simulated/floor/plating,/area/map_template/wreck/wrecktwo/second)
"aC" = (/obj/structure/catwalk,/obj/structure/disposalpipe/segment{dir = 4},/obj/structure/barricade,/obj/structure/cable{d1 = 4; d2 = 8; icon_state = "4-8"; pixel_x = 0},/obj/machinery/atmospherics/pipe/simple/hidden/scrubbers{dir = 4},/obj/effect/decal/cleanable/dirt,/turf/simulated/floor/plating,/area/map_template/wreck/wrecktwo/second)
"aD" = (/obj/structure/disposalpipe/segment{dir = 4},/obj/machinery/atmospherics/pipe/simple/hidden/scrubbers{dir = 4},/obj/item/stack/cable_coil/single,/turf/simulated/floor/plating,/area/map_template/wreck/wrecktwo/second)
"aE" = (/obj/structure/catwalk,/obj/structure/disposalpipe/segment{dir = 4},/obj/structure/cable{d1 = 2; d2 = 4; icon_state = "2-4"},/obj/structure/cable{d1 = 4; d2 = 8; icon_state = "4-8"; pixel_x = 0},/obj/machinery/atmospherics/pipe/manifold/hidden/scrubbers{dir = 1; icon_state = "map-scrubbers"},/obj/machinery/atmospherics/pipe/manifold/hidden/supply{dir = 1},/turf/simulated/floor/plating,/area/map_template/wreck/wrecktwo/second)
"aF" = (/obj/structure/catwalk,/obj/structure/disposalpipe/segment{dir = 4},/obj/structure/cable{d1 = 4; d2 = 8; icon_state = "4-8"; pixel_x = 0},/obj/machinery/atmospherics/pipe/simple/hidden/scrubbers{dir = 4},/obj/machinery/atmospherics/pipe/simple/hidden/supply{dir = 4},/turf/simulated/floor/plating,/area/map_template/wreck/wrecktwo/second)
"aG" = (/obj/structure/catwalk,/obj/structure/disposalpipe/segment{dir = 4},/obj/structure/cable{d1 = 4; d2 = 8; icon_state = "4-8"; pixel_x = 0},/obj/structure/cable{d1 = 1; d2 = 4; icon_state = "1-4"},/obj/machinery/atmospherics/pipe/manifold/hidden/scrubbers,/obj/machinery/atmospherics/pipe/manifold/hidden/supply,/obj/effect/decal/cleanable/dirt,/turf/simulated/floor/plating,/area/map_template/wreck/wrecktwo/second)
"aH" = (/obj/structure/catwalk,/obj/structure/disposalpipe/segment{dir = 4},/obj/structure/cable{d1 = 4; d2 = 8; icon_state = "4-8"; pixel_x = 0},/obj/machinery/atmospherics/pipe/manifold/hidden/scrubbers,/obj/machinery/atmospherics/pipe/simple/hidden/supply{dir = 4},/obj/effect/decal/cleanable/dirt,/turf/simulated/floor/plating,/area/map_template/wreck/wrecktwo/second)
"aI" = (/obj/structure/disposalpipe/segment{dir = 4},/obj/structure/cable{d1 = 4; d2 = 8; icon_state = "4-8"; pixel_x = 0},/obj/machinery/atmospherics/pipe/simple/hidden/scrubbers{dir = 4},/obj/machinery/atmospherics/pipe/manifold/hidden/supply{dir = 1},/obj/item/device/augment_implanter/engineering_toolset{pixel_x = -11; pixel_y = 15},/turf/simulated/floor/plating,/area/map_template/wreck/wrecktwo/second)
"aJ" = (/obj/structure/disposalpipe/segment{dir = 4},/obj/structure/cable{d1 = 4; d2 = 8; icon_state = "4-8"; pixel_x = 0},/obj/machinery/atmospherics/pipe/simple/hidden/scrubbers{dir = 4},/obj/machinery/atmospherics/pipe/simple/hidden/supply{dir = 4},/turf/simulated/floor/plating,/area/map_template/wreck/wrecktwo/second)
"aK" = (/obj/structure/catwalk,/obj/structure/disposalpipe/segment{dir = 4},/obj/structure/cable{d1 = 4; d2 = 8; icon_state = "4-8"; pixel_x = 0},/obj/machinery/atmospherics/pipe/simple/hidden/scrubbers{dir = 4},/obj/machinery/atmospherics/pipe/simple/hidden/supply{dir = 4},/obj/item/trash/cakewrap,/obj/item/device/holowarrant{pixel_x = -17; pixel_y = -12},/turf/simulated/floor/plating,/area/map_template/wreck/wrecktwo/second)
"aL" = (/obj/structure/catwalk,/obj/structure/disposalpipe/segment{dir = 4},/obj/structure/cable{d1 = 4; d2 = 8; icon_state = "4-8"; pixel_x = 0},/obj/machinery/atmospherics/pipe/simple/hidden/scrubbers{dir = 4},/obj/machinery/atmospherics/pipe/simple/hidden/supply{dir = 4},/obj/random/voidsuit,/turf/simulated/floor/plating,/area/map_template/wreck/wrecktwo/second)
"aM" = (/obj/structure/disposalpipe/junction/yjunction,/obj/structure/cable{d1 = 2; d2 = 8; desc = "A flexible superconducting cable for heavy-duty power transfer. It's been labeled 'chaos reigns'."; icon_state = "2-8"},/obj/structure/cable{d1 = 4; d2 = 8; icon_state = "4-8"; pixel_x = 0},/obj/machinery/atmospherics/pipe/manifold/hidden/scrubbers{dir = 1; icon_state = "map-scrubbers"},/obj/machinery/atmospherics/pipe/simple/hidden/supply{dir = 4},/turf/simulated/floor/plating,/area/map_template/wreck/wrecktwo/second)
"aN" = (/obj/structure/disposalpipe/segment{dir = 4},/obj/structure/cable{d1 = 4; d2 = 8; icon_state = "4-8"; pixel_x = 0},/obj/machinery/atmospherics/pipe/simple/hidden/scrubbers{dir = 4},/obj/machinery/atmospherics/pipe/manifold/hidden/supply{dir = 1},/turf/simulated/floor/plating,/area/map_template/wreck/wrecktwo/second)
"aO" = (/obj/structure/catwalk,/obj/structure/disposalpipe/segment{dir = 4},/obj/structure/cable{d1 = 4; d2 = 8; icon_state = "4-8"; pixel_x = 0},/obj/machinery/atmospherics/pipe/simple/hidden/scrubbers{dir = 4},/obj/machinery/atmospherics/pipe/simple/hidden/supply{dir = 4},/obj/effect/decal/cleanable/dirt,/obj/effect/decal/cleanable/dirt,/turf/simulated/floor/plating,/area/map_template/wreck/wrecktwo/second)
"aP" = (/obj/effect/floor_decal/techfloor,/obj/effect/decal/cleanable/blood/splatter,/obj/effect/decal/cleanable/dirt,/turf/simulated/floor/tiled/techmaint,/area/map_template/wreck/wrecktwo/second)
"aQ" = (/obj/machinery/light,/obj/effect/decal/cleanable/dirt,/obj/effect/decal/cleanable/dirt,/turf/simulated/floor/plating,/area/map_template/wreck/wrecktwo/second)
"aR" = (/obj/item/tape_roll,/turf/simulated/floor/tiled/techmaint,/area/map_template/wreck/wrecktwo/second)
"aS" = (/obj/structure/cable{d1 = 1; d2 = 2; icon_state = "1-2"},/obj/machinery/atmospherics/pipe/simple/hidden/scrubbers,/obj/machinery/atmospherics/pipe/simple/hidden/supply,/turf/simulated/floor/plating,/area/map_template/wreck/wrecktwo/second)
"aT" = (/obj/effect/floor_decal/techfloor,/obj/machinery/light,/obj/item/stool/padded,/obj/effect/decal/cleanable/dirt,/obj/item/remains/robot,/turf/simulated/floor/tiled/techmaint,/area/map_template/wreck/wrecktwo/second)
"aU" = (/obj/effect/floor_decal/techfloor,/obj/structure/closet/firecloset,/turf/simulated/floor/tiled/techmaint,/area/map_template/wreck/wrecktwo/second)
"aV" = (/obj/effect/floor_decal/techfloor,/obj/machinery/atmospherics/pipe/simple/hidden/supply,/obj/effect/decal/cleanable/blood/splatter,/obj/effect/decal/cleanable/dirt,/turf/simulated/floor/tiled/techmaint,/area/map_template/wreck/wrecktwo/second)
"aW" = (/obj/effect/floor_decal/techfloor,/obj/machinery/light,/obj/effect/decal/cleanable/dirt,/obj/item/pizzabox/mushroom,/turf/simulated/floor/tiled/techmaint,/area/map_template/wreck/wrecktwo/second)
"aX" = (/obj/effect/floor_decal/techfloor,/obj/effect/decal/remains,/obj/random/energy,/turf/simulated/floor/tiled/techmaint,/area/map_template/wreck/wrecktwo/second)
"aY" = (/obj/effect/floor_decal/techfloor,/turf/simulated/floor/tiled/techmaint,/area/map_template/wreck/wrecktwo/second)
"aZ" = (/obj/effect/floor_decal/techfloor,/obj/machinery/portable_atmospherics/powered/pump,/turf/simulated/floor/tiled/techmaint,/area/map_template/wreck/wrecktwo/second)
"ba" = (/obj/effect/floor_decal/techfloor,/obj/machinery/light,/obj/effect/decal/cleanable/dirt,/turf/simulated/floor/tiled/techmaint,/area/map_template/wreck/wrecktwo/second)
"bb" = (/obj/effect/floor_decal/techfloor,/obj/structure/disposalpipe/segment,/obj/structure/cable{d1 = 1; d2 = 2; icon_state = "1-2"},/obj/machinery/atmospherics/pipe/simple/hidden/scrubbers,/turf/simulated/floor/tiled/techmaint,/area/map_template/wreck/wrecktwo/second)
"bc" = (/obj/effect/floor_decal/techfloor,/obj/machinery/alarm{dir = 1; icon_state = "alarm0"; pixel_y = -22},/obj/machinery/atmospherics/unary/vent_pump/on{dir = 1},/obj/item/extinguisher/empty,/turf/simulated/floor/tiled/techmaint,/area/map_template/wreck/wrecktwo/second)
"bd" = (/obj/effect/floor_decal/techfloor,/obj/structure/barricade,/obj/machinery/light,/turf/simulated/floor/tiled/techmaint,/area/map_template/wreck/wrecktwo/second)
"be" = (/obj/effect/floor_decal/techfloor,/obj/effect/decal/cleanable/dirt,/obj/random/junkyard/loot,/turf/simulated/floor/tiled/techmaint,/area/map_template/wreck/wrecktwo/second)
"bf" = (/obj/item/stack/tile/floor{pixel_x = -9; pixel_y = 15},/turf/simulated/floor/plating,/area/map_template/wreck/wrecktwo/second)
"bg" = (/turf/simulated/floor/tiled/techmaint,/area/map_template/wreck/wrecktwo/second)
"bh" = (/obj/structure/lattice,/obj/structure/cable{d1 = 1; d2 = 2; icon_state = "1-2"},/obj/machinery/atmospherics/pipe/simple/hidden/scrubbers,/obj/machinery/atmospherics/pipe/simple/hidden/supply,/turf/template_noop,/area/map_template/wreck/wrecktwo/second)
"bi" = (/obj/effect/decal/cleanable/ash,/turf/simulated/floor/plating,/area/map_template/wreck/wrecktwo/second)
"bj" = (/turf/simulated/wall,/area/map_template/wreck/wrecktwo)
"bk" = (/obj/machinery/door/airlock/glass/civilian,/obj/machinery/atmospherics/pipe/simple/hidden/supply,/turf/simulated/floor/wood/ebony,/area/map_template/wreck/wrecktwo)
"bl" = (/obj/structure/curtain/open/bed,/obj/effect/wallframe_spawn/no_grille,/turf/simulated/floor/plating,/area/map_template/wreck/wrecktwo)
"bm" = (/obj/effect/decal/cleanable/dirt,/turf/simulated/wall,/area/map_template/wreck/wrecktwo)
"bn" = (/obj/structure/disposalpipe/segment,/obj/structure/cable{d1 = 1; d2 = 2; icon_state = "1-2"},/obj/machinery/door/airlock/glass/civilian,/obj/machinery/atmospherics/pipe/simple/hidden/scrubbers,/turf/simulated/floor/wood/ebony,/area/map_template/wreck/wrecktwo)
"bo" = (/obj/effect/decal/cleanable/cobweb,/turf/simulated/floor/plating,/area/map_template/wreck/wrecktwo)
"bp" = (/obj/item/trash/chips,/turf/simulated/floor/plating,/area/map_template/wreck/wrecktwo)
"bq" = (/obj/structure/holoplant,/obj/machinery/atmospherics/pipe/simple/hidden/supply{dir = 10},/obj/effect/decal/cleanable/dirt,/obj/effect/decal/cleanable/dirt,/turf/simulated/floor/wood/ebony,/area/map_template/wreck/wrecktwo)
"br" = (/obj/structure/bed/chair/armchair/red{dir = 4},/obj/effect/decal/cleanable/dirt,/turf/simulated/floor/carpet/blue,/area/map_template/wreck/wrecktwo)
"bs" = (/obj/structure/table/steel_reinforced,/obj/item/trash/jupiter{pixel_x = 2; pixel_y = 13},/obj/item/trash/plate,/obj/effect/decal/cleanable/dirt,/turf/simulated/floor/carpet/blue,/area/map_template/wreck/wrecktwo)
"bt" = (/obj/structure/bed/chair/armchair/red{dir = 8},/turf/simulated/floor/carpet/blue,/area/map_template/wreck/wrecktwo)
"bu" = (/obj/structure/holoplant,/obj/machinery/light_switch{pixel_y = 24},/obj/machinery/atmospherics/pipe/simple/hidden/scrubbers{dir = 6},/turf/simulated/floor/wood/ebony,/area/map_template/wreck/wrecktwo)
"bv" = (/obj/structure/disposalpipe/junction/mirrored,/obj/structure/cable{d1 = 1; d2 = 2; icon_state = "1-2"},/obj/machinery/atmospherics/pipe/manifold/hidden/scrubbers{dir = 4},/turf/simulated/floor/wood/ebony,/area/map_template/wreck/wrecktwo)
"bw" = (/obj/structure/disposalpipe/trunk{dir = 8},/obj/machinery/disposal,/turf/simulated/floor/wood/ebony,/area/map_template/wreck/wrecktwo)
"bx" = (/obj/structure/lattice,/obj/machinery/light{dir = 8},/turf/template_noop,/area/map_template/wreck/wrecktwo)
"by" = (/turf/simulated/floor/plating,/area/map_template/wreck/wrecktwo)
"bz" = (/obj/machinery/atmospherics/pipe/simple/hidden/supply,/obj/effect/decal/cleanable/dirt,/obj/effect/decal/cleanable/dirt,/turf/simulated/floor/wood/ebony,/area/map_template/wreck/wrecktwo)
"bA" = (/obj/effect/decal/cleanable/dirt,/obj/effect/decal/cleanable/dirt,/obj/effect/decal/cleanable/dirt,/obj/effect/decal/cleanable/dirt,/turf/simulated/floor/wood/ebony,/area/map_template/wreck/wrecktwo)
"bB" = (/obj/effect/decal/cleanable/dirt,/turf/simulated/floor/wood/ebony,/area/map_template/wreck/wrecktwo)
"bC" = (/turf/simulated/floor/wood/ebony,/area/map_template/wreck/wrecktwo)
"bD" = (/obj/machinery/atmospherics/pipe/simple/hidden/scrubbers,/turf/simulated/floor/wood/ebony,/area/map_template/wreck/wrecktwo)
"bE" = (/obj/structure/disposalpipe/segment,/obj/structure/cable{d1 = 1; d2 = 2; icon_state = "1-2"},/obj/machinery/atmospherics/pipe/simple/hidden/scrubbers,/turf/simulated/floor/wood/ebony,/area/map_template/wreck/wrecktwo)
"bF" = (/obj/structure/bed/chair/armchair/red,/obj/machinery/light{dir = 4},/turf/simulated/floor/carpet/blue,/area/map_template/wreck/wrecktwo)
"bG" = (/obj/machinery/atmospherics/pipe/simple/hidden/supply,/turf/simulated/floor/plating,/area/map_template/wreck/wrecktwo)
"bH" = (/turf/simulated/floor/carpet/blue,/area/map_template/wreck/wrecktwo)
"bI" = (/obj/structure/disposalpipe/segment,/obj/structure/cable{d1 = 1; d2 = 2; icon_state = "1-2"},/obj/machinery/atmospherics/pipe/simple/hidden/scrubbers,/obj/item/remains/mouse,/turf/simulated/floor/wood/ebony,/area/map_template/wreck/wrecktwo)
"bJ" = (/obj/structure/table/steel_reinforced,/obj/machinery/alarm{alarm_id = "petrov2"; dir = 8; icon_state = "alarm0"; pixel_x = 24},/obj/item/reagent_containers/food/drinks/bottle/brandy{pixel_x = 5; pixel_y = 16},/obj/random/relic,/turf/simulated/floor/carpet/blue,/area/map_template/wreck/wrecktwo)
"bK" = (/obj/machinery/hologram/holopad,/turf/simulated/floor/wood/ebony,/area/map_template/wreck/wrecktwo)
"bL" = (/obj/machinery/atmospherics/unary/vent_scrubber/on{dir = 1},/obj/effect/decal/cleanable/dirt,/turf/simulated/floor/wood/ebony,/area/map_template/wreck/wrecktwo)
"bM" = (/obj/structure/disposalpipe/segment,/obj/structure/cable{d1 = 1; d2 = 2; icon_state = "1-2"},/obj/machinery/atmospherics/pipe/simple/hidden/scrubbers,/obj/effect/decal/cleanable/dirt,/obj/effect/decal/cleanable/dirt,/turf/simulated/floor/wood/ebony,/area/map_template/wreck/wrecktwo)
"bN" = (/obj/structure/sign/poster{pixel_x = 31},/obj/structure/bed/chair/armchair/red{dir = 1},/obj/effect/decal/cleanable/dirt,/turf/simulated/floor/carpet/blue,/area/map_template/wreck/wrecktwo)
"bO" = (/obj/effect/decal/cleanable/ash,/obj/effect/decal/cleanable/blood/splatter,/turf/simulated/floor/wood/ebony,/area/map_template/wreck/wrecktwo)
"bP" = (/obj/item/trash/mooncakewrap,/obj/effect/decal/cleanable/dirt,/turf/simulated/floor/wood/ebony,/area/map_template/wreck/wrecktwo)
"bQ" = (/obj/structure/disposalpipe/segment,/obj/structure/cable{d1 = 1; d2 = 2; icon_state = "1-2"},/obj/machinery/atmospherics/pipe/simple/hidden/scrubbers,/obj/effect/decal/cleanable/dirt,/turf/simulated/floor/wood/ebony,/area/map_template/wreck/wrecktwo)
"bR" = (/obj/machinery/light{dir = 4},/obj/effect/decal/remains,/obj/effect/decal/cleanable/dirt,/turf/simulated/floor/wood/ebony,/area/map_template/wreck/wrecktwo)
"bS" = (/obj/machinery/light,/obj/machinery/atmospherics/pipe/simple/hidden/supply{dir = 4},/turf/simulated/floor/plating,/area/map_template/wreck/wrecktwo)
"bT" = (/obj/structure/bed/chair/padded/red,/obj/machinery/atmospherics/pipe/simple/hidden/supply{dir = 10},/turf/simulated/floor/wood/ebony,/area/map_template/wreck/wrecktwo)
"bU" = (/obj/structure/disposalpipe/segment{dir = 4; icon_state = "pipe-c"},/obj/effect/decal/cleanable/dirt,/turf/simulated/floor/wood/ebony,/area/map_template/wreck/wrecktwo)
"bV" = (/obj/structure/disposalpipe/segment{dir = 4},/obj/structure/bed/chair/padded/red,/obj/effect/decal/cleanable/dirt,/obj/effect/decal/cleanable/dirt,/obj/effect/decal/cleanable/dirt,/turf/simulated/floor/wood/ebony,/area/map_template/wreck/wrecktwo)
"bW" = (/obj/structure/disposalpipe/segment{dir = 8; icon_state = "pipe-c"},/obj/structure/cable{d1 = 1; d2 = 2; icon_state = "1-2"},/obj/structure/cable{d1 = 1; d2 = 4; icon_state = "1-4"},/obj/structure/bed/chair/padded/red,/obj/machinery/atmospherics/pipe/simple/hidden/scrubbers,/obj/effect/decal/cleanable/dirt,/turf/simulated/floor/wood/ebony,/area/map_template/wreck/wrecktwo)
"bX" = (/obj/structure/noticeboard{dir = 1},/obj/structure/cable{dir = 4},/obj/machinery/power/apc/derelict{dir = 4; pixel_x = 19},/turf/simulated/floor/wood/ebony,/area/map_template/wreck/wrecktwo)
"bY" = (/obj/structure/table/reinforced,/obj/machinery/atmospherics/pipe/simple/hidden/supply,/obj/item/device/radio,/turf/simulated/floor/lino,/area/map_template/wreck/wrecktwo)
"bZ" = (/obj/structure/disposalpipe/segment,/turf/simulated/floor/plating,/area/map_template/wreck/wrecktwo)
"ca" = (/obj/structure/table/reinforced,/turf/simulated/floor/lino,/area/map_template/wreck/wrecktwo)
"cb" = (/obj/structure/table/reinforced,/obj/structure/cable{d1 = 1; d2 = 2; icon_state = "1-2"},/obj/machinery/fabricator/micro/bartender{pixel_x = 11; pixel_y = -1},/obj/machinery/atmospherics/pipe/simple/hidden/scrubbers,/turf/simulated/floor/lino,/area/map_template/wreck/wrecktwo)
"cc" = (/obj/machinery/atmospherics/pipe/simple/hidden/supply,/obj/effect/decal/cleanable/dirt,/turf/simulated/floor/lino,/area/map_template/wreck/wrecktwo)
"cd" = (/obj/structure/cable{d1 = 1; d2 = 2; icon_state = "1-2"},/obj/machinery/atmospherics/pipe/simple/hidden/scrubbers,/turf/simulated/floor/lino,/area/map_template/wreck/wrecktwo)
"ce" = (/obj/machinery/cooker/fryer,/turf/simulated/floor/lino,/area/map_template/wreck/wrecktwo)
"cf" = (/obj/machinery/atmospherics/unary/vent_pump/on{dir = 1},/obj/random/junkyard/loot,/turf/simulated/floor/lino,/area/map_template/wreck/wrecktwo)
"cg" = (/obj/structure/table/marble,/obj/machinery/reagent_temperature/cooler{pixel_y = 15},/obj/machinery/reagent_temperature,/turf/simulated/floor/lino,/area/map_template/wreck/wrecktwo)
"ch" = (/turf/template_noop,/area/template_noop)
"ci" = (/obj/effect/decal/cleanable/dirt,/obj/effect/decal/cleanable/dirt,/obj/effect/decal/cleanable/dirt,/turf/simulated/wall,/area/template_noop)
"cj" = (/obj/effect/decal/cleanable/dirt,/turf/simulated/wall,/area/template_noop)
"ck" = (/turf/simulated/wall,/area/template_noop)
"cl" = (/obj/item/crowbar/brace_jack,/turf/template_noop,/area/template_noop)
"cm" = (/obj/item/stack/tile/floor{pixel_x = 7; pixel_y = 18},/turf/template_noop,/area/template_noop)
"cn" = (/obj/structure/anomaly_container,/turf/template_noop,/area/template_noop)
"co" = (/obj/effect/floor_decal/techfloor{dir = 5; icon_state = "techfloor_edges"},/obj/effect/decal/cleanable/dirt,/turf/simulated/floor/tiled/techmaint,/area/template_noop)
"cp" = (/obj/machinery/atmospherics/pipe/simple/hidden/supply,/turf/template_noop,/area/template_noop)
"cq" = (/obj/structure/lattice,/turf/template_noop,/area/template_noop)
"cr" = (/obj/structure/lattice,/obj/structure/disposalpipe/segment{dir = 4},/obj/structure/cable{d1 = 4; d2 = 8; icon_state = "4-8"; pixel_x = 0},/obj/machinery/atmospherics/pipe/simple/hidden/supply{dir = 4},/turf/template_noop,/area/template_noop)
"cs" = (/obj/structure/lattice,/obj/structure/cable{d1 = 4; d2 = 8; icon_state = "4-8"; pixel_x = 0},/turf/template_noop,/area/template_noop)
"ct" = (/obj/item/stack/tile/floor{pixel_x = 15; pixel_y = -25},/turf/template_noop,/area/template_noop)
"cu" = (/obj/structure/lattice,/obj/machinery/atmospherics/pipe/simple/hidden/scrubbers,/turf/template_noop,/area/template_noop)
"cv" = (/obj/structure/lattice,/obj/item/stack/cable_coil/single,/turf/template_noop,/area/template_noop)
"cw" = (/obj/effect/decal/remains,/turf/template_noop,/area/template_noop)
"cx" = (/obj/item/stack/tile/floor,/turf/template_noop,/area/template_noop)
"cy" = (/obj/item/stack/tile/floor{pixel_x = -16; pixel_y = -30},/turf/template_noop,/area/template_noop)
"cz" = (/turf/simulated/floor/plating,/area/template_noop)
"cA" = (/obj/item/stack/tile/floor{pixel_x = -6; pixel_y = -21},/turf/template_noop,/area/template_noop)
"cB" = (/obj/structure/lattice,/obj/item/crowbar/emergency_forcing_tool,/turf/template_noop,/area/template_noop)
"cC" = (/obj/effect/decal/cleanable/dirt,/obj/effect/decal/cleanable/dirt,/obj/effect/decal/cleanable/dirt,/turf/simulated/floor/plating,/area/template_noop)
"cD" = (/obj/machinery/atmospherics/pipe/simple/hidden/supply{dir = 5},/turf/simulated/floor/plating,/area/template_noop)
"cE" = (/obj/item/stack/cable_coil/single,/turf/template_noop,/area/template_noop)
"cF" = (/obj/structure/lattice,/obj/structure/disposalpipe/segment,/turf/template_noop,/area/template_noop)
"cG" = (/obj/structure/lattice,/obj/structure/cable{d1 = 1; d2 = 2; icon_state = "1-2"},/turf/template_noop,/area/template_noop)
"cH" = (/obj/random/junkyard/hostile,/turf/simulated/floor/plating,/area/map_template/wreck/wrecktwo/second)
"cI" = (/obj/structure/catwalk,/obj/structure/disposalpipe/segment{dir = 4},/obj/structure/cable{d1 = 4; d2 = 8; icon_state = "4-8"; pixel_x = 0},/obj/machinery/atmospherics/pipe/simple/hidden/scrubbers{dir = 4},/obj/machinery/atmospherics/pipe/simple/hidden/supply{dir = 4},/obj/random/junkyard/hostile,/turf/simulated/floor/plating,/area/map_template/wreck/wrecktwo/second)
"cJ" = (/obj/random/junkyard/hostile,/turf/template_noop,/area/template_noop)
"cK" = (/obj/structure/lattice,/obj/random/junkyard/hostile,/turf/template_noop,/area/template_noop)

(1,1,1) = {"
chchchchchchchchchchchchchcicjckckchchch
chchchchchclcmcnchchchchchchcocjchchchch
chchchaaabcpcqchcqchchchchchchchchchchch
chchchaaacadaeaacqchchchchchchchchchchch
afagahaaaiajakagagaaaaaaaaaaaaaaaaaaaaaa
alamanaoapaqarasatauavawaxaecHayazchaeaA
aBaCaDaEcIaGaHaIaJaFaKaFaLaMaNaOaJcrcscq
aPaQaRaSaeaTaUaVaWaXaYaZbabbbcbdbebfchae
agagbgbhbibjbjbkbjblblblbmbnbjbjaacqctch
chcqchcuaebjbobpbqbrbsbtbubvbwbjchchchch
chchchcvchbjbxbybzbAbBbCbDbEbFbjchchchcw
chcwchchcxchchchbGbybHbtbDbIbJbjchchchch
chchchcychchchcqchbCbKbCbLbMbNbjchchchch
chcjczcAchcBcqcqczbCbObCbPbQbRbjchcJchch
chcjczcCchchcqcDbSbTbBbUbVbWbXbjchchchch
chchchchchchchchbjbYbybZcacbbjbjchchckch
chchchchcwchchcKbycccqbZchcdcebjchchchch
chcEchchchchchchchcfchcFcqcGcgbjchchchch
chchchchchchchchchbychcqcEchchbjchchchch
chchchchchchchchchcqchchchchchchchchchch
"}
