"aa" = (/obj/effect/paint/black,/obj/effect/decal/cleanable/dirt,/turf/simulated/wall/r_wall,/area/map_template/wreck/wreckfive)
"ab" = (/obj/effect/wallframe_spawn/reinforced,/obj/effect/paint/black,/obj/effect/decal/cleanable/dirt,/turf/simulated/floor/plating,/area/map_template/wreck/wreckfive)
"ac" = (/obj/effect/wallframe_spawn/reinforced,/obj/effect/paint/black,/turf/simulated/floor/plating,/area/map_template/wreck/wreckfive)
"ad" = (/obj/structure/wall_frame/hull,/obj/effect/paint/black,/turf/simulated/floor/plating,/area/map_template/wreck/wreckfive)
"ae" = (/obj/effect/paint/vox,/turf/simulated/wall/r_wall,/area/map_template/wreck/wreckfive)
"af" = (/obj/effect/paint/black,/turf/simulated/wall/r_wall,/area/map_template/wreck/wreckfive)
"ag" = (/obj/structure/catwalk,/obj/structure/cable/cyan{d1 = 2; d2 = 4; icon_state = "2-4"},/obj/machinery/light{dir = 1},/obj/structure/railing/mapped{dir = 4; icon_state = "railing0-1"},/turf/simulated/floor/plating,/area/map_template/wreck/wreckfive)
"ah" = (/obj/structure/catwalk,/obj/structure/cable/cyan{d1 = 4; d2 = 8; icon_state = "4-8"},/obj/machinery/constructable_frame/computerframe/deconstruct,/obj/effect/decal/cleanable/dirt,/obj/item/stock_parts/circuitboard/powermonitor,/turf/simulated/floor/plating,/area/map_template/wreck/wreckfive)
"ai" = (/obj/effect/floor_decal/industrial/warning{dir = 8},/obj/machinery/constructable_frame/machine_frame/deconstruct,/obj/effect/decal/cleanable/dirt,/turf/simulated/floor/tiled/techfloor/grid,/area/map_template/wreck/wreckfive)
"aj" = (/obj/machinery/constructable_frame/computerframe/deconstruct,/turf/simulated/floor/plating,/area/map_template/wreck/wreckfive)
"ak" = (/obj/item/stack/cable_coil/cyan{amount = 1},/obj/machinery/constructable_frame/computerframe/deconstruct,/turf/simulated/floor/plating,/area/map_template/wreck/wreckfive)
"al" = (/obj/structure/catwalk,/obj/structure/cable/cyan{d1 = 4; d2 = 8; icon_state = "4-8"},/obj/machinery/constructable_frame/computerframe/deconstruct,/turf/simulated/floor/plating,/area/map_template/wreck/wreckfive)
"am" = (/obj/structure/catwalk,/obj/structure/cable/cyan{d1 = 2; d2 = 8; icon_state = "2-8"},/obj/machinery/light{dir = 1},/obj/structure/railing/mapped{dir = 8; icon_state = "railing0-1"},/turf/simulated/floor/plating,/area/map_template/wreck/wreckfive)
"an" = (/obj/effect/paint/vox,/obj/effect/decal/cleanable/dirt,/turf/simulated/wall/r_wall,/area/map_template/wreck/wreckfive)
"ao" = (/obj/effect/paint/green,/turf/simulated/wall/r_wall,/area/map_template/wreck/wreckfive)
"ap" = (/obj/structure/catwalk,/obj/structure/cable/cyan{d1 = 1; d2 = 2; icon_state = "1-2"},/turf/simulated/floor/plating,/area/map_template/wreck/wreckfive)
"aq" = (/obj/effect/floor_decal/industrial/warning{dir = 9},/turf/simulated/floor/tiled/techfloor/grid,/area/map_template/wreck/wreckfive)
"ar" = (/obj/effect/floor_decal/industrial/warning/corner{dir = 1},/obj/structure/bed/chair/comfy/brown{dir = 1},/turf/simulated/floor/tiled/techfloor/grid,/area/map_template/wreck/wreckfive)
"as" = (/turf/simulated/floor/tiled/techfloor/grid,/area/map_template/wreck/wreckfive)
"at" = (/obj/structure/bed/chair/comfy/brown{dir = 1},/obj/effect/decal/cleanable/blood/splatter,/turf/simulated/floor/plating,/area/map_template/wreck/wreckfive)
"au" = (/obj/effect/decal/remains,/turf/simulated/floor/plating,/area/map_template/wreck/wreckfive)
"av" = (/obj/structure/catwalk,/obj/structure/cable/cyan{d1 = 1; d2 = 2; icon_state = "1-2"},/obj/effect/decal/cleanable/dirt,/turf/simulated/floor/plating,/area/map_template/wreck/wreckfive)
"aw" = (/obj/effect/paint/green,/obj/effect/decal/cleanable/dirt,/obj/effect/decal/cleanable/dirt,/turf/simulated/wall/r_wall,/area/map_template/wreck/wreckfive)
"ax" = (/obj/effect/paint/green,/obj/effect/decal/cleanable/dirt,/turf/simulated/wall/r_wall,/area/map_template/wreck/wreckfive)
"ay" = (/obj/structure/catwalk,/obj/structure/cable/cyan{d1 = 2; d2 = 4; icon_state = "2-4"},/obj/machinery/light{dir = 8},/obj/effect/decal/cleanable/dirt,/obj/effect/decal/cleanable/cobweb,/obj/random/intel_console,/turf/simulated/floor/plating,/area/map_template/wreck/wreckfive)
"az" = (/obj/structure/cable/cyan{d1 = 1; d2 = 8; icon_state = "1-8"},/obj/machinery/atmospherics/pipe/manifold/hidden/supply{dir = 1},/obj/structure/catwalk,/turf/simulated/floor/plating,/area/map_template/wreck/wreckfive)
"aA" = (/obj/effect/floor_decal/industrial/warning{dir = 8},/obj/machinery/atmospherics/pipe/simple/hidden/supply{dir = 4},/turf/simulated/floor/tiled/techfloor/grid,/area/map_template/wreck/wreckfive)
"aB" = (/obj/machinery/atmospherics/pipe/simple/hidden/supply{dir = 4},/obj/structure/railing/mapped,/turf/simulated/floor/tiled/techfloor/grid,/area/map_template/wreck/wreckfive)
"aC" = (/obj/machinery/atmospherics/pipe/simple/hidden/supply{dir = 4},/obj/structure/railing/mapped,/turf/simulated/floor/plating,/area/map_template/wreck/wreckfive)
"aD" = (/obj/machinery/atmospherics/pipe/simple/hidden/supply{dir = 4},/obj/item/stock_parts/circuitboard/helm,/turf/simulated/floor/plating,/area/map_template/wreck/wreckfive)
"aE" = (/obj/structure/cable/cyan{d1 = 1; d2 = 4; icon_state = "1-4"},/obj/machinery/atmospherics/pipe/simple/hidden/supply{dir = 10},/obj/structure/catwalk,/obj/random/junkyard/hostile,/turf/simulated/floor/plating,/area/map_template/wreck/wreckfive)
"aF" = (/obj/structure/cable/cyan{d1 = 2; d2 = 8; icon_state = "2-8"},/obj/structure/catwalk,/obj/machinery/light{dir = 4},/turf/simulated/floor/plating,/area/map_template/wreck/wreckfive)
"aG" = (/obj/effect/paint/iccg_hull,/turf/simulated/wall/r_wall,/area/map_template/wreck/wreckfive)
"aH" = (/obj/effect/paint/iccg_hull,/obj/effect/decal/cleanable/greenglow,/turf/simulated/wall/r_wall,/area/map_template/wreck/wreckfive)
"aI" = (/obj/effect/floor_decal/techfloor,/obj/structure/reagent_dispensers/watertank,/turf/simulated/floor/tiled/techfloor,/area/map_template/wreck/wreckfive)
"aJ" = (/obj/structure/reagent_dispensers/watertank,/turf/simulated/floor/plating,/area/map_template/wreck/wreckfive)
"aK" = (/obj/structure/catwalk,/obj/structure/cable/cyan{d1 = 1; d2 = 2; icon_state = "1-2"},/obj/machinery/atmospherics/pipe/simple/visible/universal{dir = 1},/turf/simulated/floor/plating,/area/map_template/wreck/wreckfive)
"aL" = (/obj/machinery/atmospherics/unary/vent_pump/on{dir = 1; level = 2},/obj/effect/decal/cleanable/dirt,/turf/simulated/floor/plating,/area/map_template/wreck/wreckfive)
"aM" = (/obj/structure/railing/mapped{dir = 4; icon_state = "railing0-1"},/obj/random/junkyard/bomb_supply,/obj/random/junkyard/bomb_supply,/turf/simulated/floor/tiled/techfloor/grid,/area/map_template/wreck/wreckfive)
"aN" = (/obj/effect/floor_decal/techfloor/orange{dir = 9},/obj/machinery/constructable_frame/computerframe/deconstruct,/turf/simulated/floor/tiled/techfloor/grid,/area/map_template/wreck/wreckfive)
"aO" = (/obj/effect/floor_decal/techfloor/orange{dir = 1},/obj/machinery/constructable_frame/computerframe/deconstruct,/turf/simulated/floor/tiled/techfloor/grid,/area/map_template/wreck/wreckfive)
"aP" = (/obj/effect/floor_decal/techfloor/orange{dir = 5},/obj/machinery/constructable_frame/machine_frame/deconstruct,/obj/item/stock_parts/circuitboard/comm_server,/turf/simulated/floor/tiled/techfloor/grid,/area/map_template/wreck/wreckfive)
"aQ" = (/obj/effect/floor_decal/industrial/warning/corner{dir = 4},/obj/structure/railing/mapped{dir = 8; icon_state = "railing0-1"},/turf/simulated/floor/tiled/techfloor/grid,/area/map_template/wreck/wreckfive)
"aR" = (/obj/effect/floor_decal/industrial/warning{dir = 5},/obj/machinery/atmospherics/unary/vent_pump/on{dir = 1; level = 2},/obj/effect/decal/cleanable/dirt,/turf/simulated/floor/tiled/techfloor/grid,/area/map_template/wreck/wreckfive)
"aS" = (/obj/machinery/portable_atmospherics/powered/scrubber,/turf/simulated/floor/plating,/area/map_template/wreck/wreckfive)
"aT" = (/obj/effect/floor_decal/techfloor,/obj/machinery/portable_atmospherics/powered/scrubber,/obj/effect/decal/cleanable/dirt,/obj/effect/decal/cleanable/greenglow,/obj/effect/decal/cleanable/greenglow,/turf/simulated/floor/tiled/techfloor,/area/map_template/wreck/wreckfive)
"aU" = (/obj/machinery/portable_atmospherics/canister/air,/obj/effect/floor_decal/industrial/outline/yellow,/obj/machinery/atmospherics/portables_connector{dir = 4},/turf/simulated/floor/tiled/steel_ridged,/area/map_template/wreck/wreckfive)
"aV" = (/obj/machinery/atmospherics/pipe/simple/visible/cyan{dir = 4},/turf/simulated/floor/plating,/area/map_template/wreck/wreckfive)
"aW" = (/obj/structure/catwalk,/obj/structure/cable/cyan{d1 = 1; d2 = 2; icon_state = "1-2"},/obj/machinery/atmospherics/pipe/manifold/hidden/cyan{dir = 4},/obj/effect/decal/cleanable/dirt,/turf/simulated/floor/plating,/area/map_template/wreck/wreckfive)
"aX" = (/obj/effect/floor_decal/industrial/warning{dir = 8},/obj/effect/decal/cleanable/dirt,/turf/simulated/floor/tiled/techfloor/grid,/area/map_template/wreck/wreckfive)
"aY" = (/obj/structure/railing/mapped{dir = 4; icon_state = "railing0-1"},/turf/simulated/floor/plating,/area/map_template/wreck/wreckfive)
"aZ" = (/obj/effect/floor_decal/techfloor/orange{dir = 8},/obj/machinery/constructable_frame/computerframe/deconstruct{dir = 4},/obj/effect/decal/cleanable/dirt,/turf/simulated/floor/tiled/techfloor/grid,/area/map_template/wreck/wreckfive)
"ba" = (/obj/structure/bed/chair/comfy/captain{dir = 1},/obj/effect/decal/cleanable/dirt,/obj/effect/decal/remains,/turf/simulated/floor/tiled/techfloor/grid,/area/map_template/wreck/wreckfive)
"bb" = (/obj/effect/floor_decal/techfloor/orange{dir = 4},/obj/machinery/constructable_frame/computerframe/deconstruct{dir = 8},/obj/effect/decal/cleanable/dirt,/turf/simulated/floor/tiled/techfloor/grid,/area/map_template/wreck/wreckfive)
"bc" = (/obj/structure/railing/mapped{dir = 8; icon_state = "railing0-1"},/turf/simulated/floor/tiled/techfloor/grid,/area/map_template/wreck/wreckfive)
"bd" = (/obj/effect/floor_decal/industrial/warning{dir = 4},/obj/effect/decal/cleanable/generic,/turf/simulated/floor/tiled/techfloor/grid,/area/map_template/wreck/wreckfive)
"be" = (/obj/structure/cable/yellow{d1 = 2; d2 = 4; icon_state = "2-4"},/obj/effect/floor_decal/industrial/loading{dir = 4},/obj/item/reagent_containers/glass/bucket{pixel_x = -5; pixel_y = -11},/obj/item/reagent_containers/glass/bucket{pixel_x = 6; pixel_y = 6},/obj/effect/decal/cleanable/greenglow,/turf/simulated/floor/tiled/steel_ridged,/area/map_template/wreck/wreckfive)
"bf" = (/obj/machinery/power/port_gen/pacman/super/potato/reactor,/obj/structure/cable/yellow{d2 = 8; icon_state = "0-8"},/obj/effect/floor_decal/industrial/hatch/yellow,/obj/effect/decal/cleanable/dirt,/obj/effect/decal/cleanable/greenglow,/turf/simulated/floor/tiled/steel_ridged,/area/map_template/wreck/wreckfive)
"bg" = (/obj/machinery/portable_atmospherics/canister/empty,/obj/effect/floor_decal/industrial/outline/yellow,/obj/machinery/atmospherics/portables_connector{dir = 4},/obj/machinery/light{dir = 8},/turf/simulated/floor/tiled/steel_ridged,/area/map_template/wreck/wreckfive)
"bh" = (/obj/machinery/atmospherics/pipe/simple/hidden/universal{dir = 4},/turf/simulated/floor/tiled/steel_ridged,/area/map_template/wreck/wreckfive)
"bi" = (/obj/structure/catwalk,/obj/structure/cable/cyan{d1 = 1; d2 = 2; icon_state = "1-2"},/obj/machinery/atmospherics/pipe/simple/hidden/cyan,/obj/machinery/atmospherics/pipe/simple/hidden/scrubbers{dir = 10},/obj/effect/decal/cleanable/dirt,/turf/simulated/floor/plating,/area/map_template/wreck/wreckfive)
"bj" = (/obj/effect/floor_decal/industrial/warning{dir = 8},/turf/simulated/floor/tiled/techfloor/grid,/area/map_template/wreck/wreckfive)
"bk" = (/obj/structure/railing/mapped{dir = 4; icon_state = "railing0-1"},/turf/simulated/floor/tiled/techfloor/grid,/area/map_template/wreck/wreckfive)
"bl" = (/obj/effect/floor_decal/techfloor/orange{dir = 10},/obj/machinery/constructable_frame/machine_frame/deconstruct,/turf/simulated/floor/tiled/techfloor/grid,/area/map_template/wreck/wreckfive)
"bm" = (/obj/effect/floor_decal/techfloor/orange,/obj/machinery/hologram/holopad/longrange,/turf/simulated/floor/tiled/techfloor/grid,/area/map_template/wreck/wreckfive)
"bn" = (/obj/effect/floor_decal/techfloor/orange{dir = 6},/obj/machinery/constructable_frame/computerframe/deconstruct{dir = 8},/turf/simulated/floor/tiled/techfloor/grid,/area/map_template/wreck/wreckfive)
"bo" = (/obj/machinery/portable_atmospherics/powered/pump,/obj/structure/railing/mapped{dir = 8; icon_state = "railing0-1"},/turf/simulated/floor/plating,/area/map_template/wreck/wreckfive)
"bp" = (/obj/effect/floor_decal/industrial/warning{dir = 4},/turf/simulated/floor/tiled/techfloor/grid,/area/map_template/wreck/wreckfive)
"bq" = (/obj/machinery/power/terminal{dir = 4},/obj/structure/cable/yellow{d2 = 2; icon_state = "0-2"},/obj/structure/cable/yellow,/obj/effect/decal/cleanable/dirt,/turf/simulated/floor/tiled/steel_ridged,/area/map_template/wreck/wreckfive)
"br" = (/obj/machinery/power/smes/buildable/preset/torch/shuttle{RCon_tag = "Shuttle - Guppy"},/obj/structure/cable/cyan{d2 = 4; icon_state = "0-4"},/obj/effect/floor_decal/industrial/hatch/yellow,/obj/machinery/light{dir = 4},/obj/item/device/geiger{pixel_x = -5; pixel_y = 11},/turf/simulated/floor/tiled/steel_ridged,/area/map_template/wreck/wreckfive)
"bs" = (/obj/effect/paint/iccg_hull,/obj/structure/cable/cyan{d1 = 2; d2 = 8; icon_state = "2-8"},/turf/simulated/wall/r_wall,/area/map_template/wreck/wreckfive)
"bt" = (/obj/effect/paint/red/dark,/turf/simulated/wall/r_wall,/area/map_template/wreck/wreckfive)
"bu" = (/obj/machinery/atmospherics/unary/tank/air{dir = 4; start_pressure = 4559.63},/obj/effect/floor_decal/industrial/hatch/yellow,/obj/effect/decal/cleanable/dirt,/turf/simulated/floor/tiled/steel_ridged,/area/map_template/wreck/wreckfive)
"bv" = (/obj/machinery/atmospherics/pipe/simple/visible/cyan{dir = 4},/obj/effect/decal/cleanable/dirt,/turf/simulated/floor/tiled/steel_ridged,/area/map_template/wreck/wreckfive)
"bw" = (/obj/structure/catwalk,/obj/structure/cable/cyan{d1 = 1; d2 = 2; icon_state = "1-2"},/obj/machinery/atmospherics/pipe/simple/hidden/cyan{dir = 9},/obj/machinery/atmospherics/pipe/simple/hidden/scrubbers,/obj/effect/decal/cleanable/dirt,/turf/simulated/floor/plating,/area/map_template/wreck/wreckfive)
"bx" = (/obj/effect/decal/cleanable/dirt,/obj/effect/decal/cleanable/dirt,/turf/simulated/floor/tiled/techfloor/grid,/area/map_template/wreck/wreckfive)
"by" = (/obj/effect/decal/cleanable/dirt,/turf/simulated/floor/tiled/techfloor/grid,/area/map_template/wreck/wreckfive)
"bz" = (/turf/simulated/floor/plating,/area/map_template/wreck/wreckfive)
"bA" = (/obj/structure/catwalk,/obj/structure/cable/cyan{d1 = 1; d2 = 2; icon_state = "1-2"},/obj/effect/decal/cleanable/greenglow,/obj/item/stack/material/uranium/ten,/obj/item/stack/material/uranium/ten{pixel_x = 10; pixel_y = 9},/turf/simulated/floor/plating,/area/map_template/wreck/wreckfive)
"bB" = (/obj/structure/cable/yellow{d1 = 1; d2 = 4; icon_state = "1-4"},/obj/effect/floor_decal/industrial/loading{dir = 4},/obj/effect/decal/cleanable/dirt,/turf/simulated/floor/tiled/steel_ridged,/area/map_template/wreck/wreckfive)
"bC" = (/obj/machinery/power/port_gen/pacman/super/potato/reactor,/obj/structure/cable/yellow{d2 = 8; icon_state = "0-8"},/obj/effect/floor_decal/industrial/hatch/yellow,/obj/effect/decal/cleanable/greenglow,/turf/simulated/floor/tiled/steel_ridged,/area/map_template/wreck/wreckfive)
"bD" = (/obj/effect/paint/iccg_hull,/obj/structure/cable/cyan{d1 = 1; d2 = 2; icon_state = "1-2"},/turf/simulated/wall/r_wall,/area/map_template/wreck/wreckfive)
"bE" = (/obj/machinery/ion_engine{dir = 1},/turf/simulated/floor/plating,/area/map_template/wreck/wreckfive)
"bF" = (/obj/machinery/ion_engine{dir = 1},/obj/effect/decal/cleanable/dirt,/turf/simulated/floor/plating,/area/map_template/wreck/wreckfive)
"bG" = (/obj/effect/paint/silver,/turf/simulated/wall/r_wall,/area/map_template/wreck/wreckfive)
"bH" = (/obj/effect/decal/cleanable/generic,/obj/random/junkyard/hostile,/obj/random/junkyard/cash,/turf/simulated/floor/plating,/area/map_template/wreck/wreckfive)
"bI" = (/obj/structure/catwalk,/obj/structure/cable/cyan{d1 = 1; d2 = 2; icon_state = "1-2"},/obj/machinery/atmospherics/pipe/simple/hidden/scrubbers,/obj/effect/decal/cleanable/dirt,/turf/simulated/floor/plating,/area/map_template/wreck/wreckfive)
"bJ" = (/obj/effect/floor_decal/industrial/warning{dir = 8},/obj/machinery/atmospherics/unary/vent_scrubber/on,/turf/simulated/floor/tiled/techfloor/grid,/area/map_template/wreck/wreckfive)
"bK" = (/obj/effect/decal/cleanable/dirt,/turf/simulated/floor/plating,/area/map_template/wreck/wreckfive)
"bL" = (/obj/structure/bed/chair/comfy/brown{dir = 8},/turf/simulated/floor/tiled/techfloor/grid,/area/map_template/wreck/wreckfive)
"bM" = (/obj/effect/floor_decal/industrial/warning{dir = 4},/obj/machinery/atmospherics/unary/vent_scrubber/on,/obj/effect/decal/cleanable/dirt,/turf/simulated/floor/tiled/techfloor/grid,/area/map_template/wreck/wreckfive)
"bN" = (/obj/structure/catwalk,/obj/structure/cable/cyan{d1 = 1; d2 = 4; icon_state = "1-4"},/obj/effect/decal/cleanable/dirt,/obj/structure/closet/crate/radiation_gear,/obj/random/relic,/turf/simulated/floor/plating,/area/map_template/wreck/wreckfive)
"bO" = (/obj/effect/floor_decal/techfloor{dir = 9; icon_state = "techfloor_edges"},/obj/structure/cable/cyan{d1 = 4; d2 = 8; icon_state = "4-8"},/obj/structure/reagent_dispensers/fueltank,/turf/simulated/floor/tiled/techfloor,/area/map_template/wreck/wreckfive)
"bP" = (/obj/effect/floor_decal/techfloor{dir = 1; icon_state = "techfloor_edges"},/obj/structure/cable/cyan{d1 = 4; d2 = 8; icon_state = "4-8"},/obj/machinery/portable_atmospherics/powered/pump/filled,/turf/simulated/floor/tiled/techfloor,/area/map_template/wreck/wreckfive)
"bQ" = (/obj/effect/paint/red/dark,/obj/structure/cable/cyan{d1 = 1; d2 = 8; icon_state = "1-8"},/turf/simulated/wall/r_wall,/area/map_template/wreck/wreckfive)
"bR" = (/obj/effect/paint/silver,/obj/effect/decal/cleanable/dirt,/turf/simulated/wall/r_wall,/area/map_template/wreck/wreckfive)
"bS" = (/obj/machinery/light{dir = 8},/obj/effect/decal/cleanable/dirt,/obj/structure/closet/crate/uranium,/turf/simulated/floor/plating,/area/map_template/wreck/wreckfive)
"bT" = (/obj/structure/catwalk,/obj/structure/cable/cyan{d1 = 1; d2 = 2; icon_state = "1-2"},/obj/machinery/atmospherics/pipe/simple/hidden/scrubbers{dir = 5},/turf/simulated/floor/plating,/area/map_template/wreck/wreckfive)
"bU" = (/obj/effect/floor_decal/industrial/warning{dir = 8},/obj/machinery/atmospherics/pipe/manifold/hidden/scrubbers,/obj/effect/decal/remains,/turf/simulated/floor/tiled/techfloor/grid,/area/map_template/wreck/wreckfive)
"bV" = (/obj/machinery/atmospherics/pipe/simple/hidden/scrubbers{dir = 4},/obj/effect/decal/cleanable/dirt,/turf/simulated/floor/tiled/techfloor/grid,/area/map_template/wreck/wreckfive)
"bW" = (/obj/machinery/atmospherics/pipe/simple/hidden/scrubbers{dir = 4},/obj/machinery/fabricator/hacked,/obj/effect/decal/cleanable/dirt,/obj/effect/decal/cleanable/dirt,/turf/simulated/floor/plating,/area/map_template/wreck/wreckfive)
"bX" = (/obj/machinery/atmospherics/pipe/simple/hidden/scrubbers{dir = 4},/obj/machinery/light,/turf/simulated/floor/plating,/area/map_template/wreck/wreckfive)
"bY" = (/obj/machinery/atmospherics/pipe/simple/hidden/scrubbers{dir = 4},/obj/structure/table/rack,/obj/random/junkyard/material,/obj/random/junkyard/material,/obj/random/junkyard/material,/obj/random/junkyard/material,/obj/random/junkyard/material,/obj/random/junkyard/material,/obj/random/junkyard/material,/obj/random/junkyard/powercell,/obj/random/junkyard/powercell,/turf/simulated/floor/tiled/techfloor/grid,/area/map_template/wreck/wreckfive)
"bZ" = (/obj/machinery/atmospherics/pipe/simple/hidden/scrubbers{dir = 4},/obj/machinery/radio_beacon,/turf/simulated/floor/tiled/techfloor/grid,/area/map_template/wreck/wreckfive)
"ca" = (/obj/effect/paint/vox,/obj/machinery/atmospherics/pipe/simple/hidden/scrubbers{dir = 9},/obj/effect/decal/cleanable/dirt,/turf/simulated/wall/r_wall,/area/map_template/wreck/wreckfive)
"cb" = (/obj/effect/wallframe_spawn/reinforced,/obj/effect/paint/vox,/turf/simulated/floor/plating,/area/map_template/wreck/wreckfive)
"cc" = (/obj/machinery/portable_atmospherics/canister/air/airlock,/obj/machinery/atmospherics/portables_connector{dir = 4},/turf/simulated/floor/plating,/area/map_template/wreck/wreckfive)
"cd" = (/obj/structure/catwalk,/obj/item/stack/cable_coil/cyan{amount = 1},/obj/machinery/atmospherics/pipe/simple/hidden{dir = 10},/obj/effect/decal/cleanable/dirt,/turf/simulated/floor/plating,/area/map_template/wreck/wreckfive)
"ce" = (/obj/effect/decal/cleanable/blood/splatter,/turf/simulated/floor/plating,/area/map_template/wreck/wreckfive)
"cf" = (/obj/structure/girder,/turf/simulated/floor/plating,/area/map_template/wreck/wreckfive)
"cg" = (/obj/effect/floor_decal/industrial/outline/yellow,/obj/structure/closet/crate/large,/obj/random/junkyard/tech_supply,/obj/random/junkyard/tech_supply,/obj/random/junkyard/tech_supply,/obj/random/junkyard/tech_supply,/obj/random/junkyard/tech_supply,/obj/random/junkyard/tech_supply,/obj/random/junkyard/tech_supply,/obj/random/junkyard/advdevice,/obj/random/junkyard/advdevice,/obj/random/junkyard/advdevice,/obj/random/junkyard/advdevice,/obj/random/junkyard/material,/obj/random/junkyard/material,/obj/random/junkyard/material,/obj/random/junkyard/material,/turf/simulated/floor/tiled/steel_grid,/area/map_template/wreck/wreckfive)
"ch" = (/obj/effect/floor_decal/industrial/outline/yellow,/turf/simulated/floor/tiled/steel_grid,/area/map_template/wreck/wreckfive)
"ci" = (/obj/structure/closet/crate/secure/gear,/obj/random/junkyard/loot,/obj/random/junkyard/loot,/obj/random/junkyard/loot,/obj/random/junkyard/loot,/obj/random/junkyard/loot,/obj/random/junkyard/loot,/obj/item/stock_parts/circuitboard/engine,/obj/random/junkyard/loot,/obj/random/junkyard/loot,/turf/simulated/floor/plating,/area/map_template/wreck/wreckfive)
"cj" = (/obj/structure/cable/cyan{d1 = 1; d2 = 4; icon_state = "1-4"},/turf/simulated/floor/plating,/area/map_template/wreck/wreckfive)
"ck" = (/obj/structure/cable/cyan{d1 = 2; d2 = 8; icon_state = "2-8"},/obj/machinery/light{dir = 4},/obj/effect/decal/cleanable/dirt,/turf/simulated/floor/plating,/area/map_template/wreck/wreckfive)
"cl" = (/obj/machinery/atmospherics/unary/vent_pump/high_volume/shuttle,/turf/simulated/floor/tiled/steel_ridged,/area/map_template/wreck/wreckfive)
"cm" = (/obj/machinery/atmospherics/unary/vent_pump/high_volume/shuttle,/obj/machinery/embedded_controller/radio/airlock/docking_port{pixel_y = 10},/turf/simulated/floor/tiled/steel_ridged,/area/map_template/wreck/wreckfive)
"cn" = (/obj/machinery/light{dir = 1},/obj/structure/closet/crate,/turf/simulated/floor/plating,/area/map_template/wreck/wreckfive)
"co" = (/obj/structure/handrail,/turf/simulated/floor/plating,/area/map_template/wreck/wreckfive)
"cp" = (/obj/effect/floor_decal/industrial/warning,/obj/effect/floor_decal/industrial/warning{dir = 1},/turf/simulated/floor/tiled/techmaint,/area/map_template/wreck/wreckfive)
"cq" = (/obj/effect/floor_decal/industrial/warning,/obj/effect/floor_decal/industrial/warning{dir = 1},/obj/random/junkyard/hostile,/turf/simulated/floor/tiled/techmaint,/area/map_template/wreck/wreckfive)
"cr" = (/obj/effect/floor_decal/industrial/warning/corner{dir = 8},/obj/effect/floor_decal/industrial/warning{dir = 1},/obj/effect/decal/cleanable/dirt,/obj/structure/closet/crate/plastic,/obj/random/junkyard/medical/lite,/obj/random/junkyard/medical/lite,/obj/random/junkyard/medical/lite,/obj/random/junkyard/medical/lite,/obj/random/junkyard/medical/lite,/obj/random/junkyard/medical/lite,/obj/random/junkyard/medical/lite,/turf/simulated/floor/tiled/techmaint,/area/map_template/wreck/wreckfive)
"cs" = (/obj/effect/floor_decal/techfloor{dir = 4; icon_state = "techfloor_edges"},/obj/effect/floor_decal/industrial/warning/corner{dir = 1},/obj/machinery/light{dir = 1},/obj/structure/railing/mapped{dir = 4; icon_state = "railing0-1"},/obj/effect/decal/cleanable/dirt,/turf/simulated/floor/tiled/techmaint,/area/map_template/wreck/wreckfive)
"ct" = (/obj/effect/floor_decal/industrial/warning{dir = 8},/obj/machinery/power/apc/derelict{pixel_y = -17},/obj/structure/cable/cyan{d2 = 2; dir = 1; icon_state = "0-2"},/obj/machinery/atmospherics/pipe/simple/hidden{dir = 4},/turf/simulated/floor/tiled/techfloor/grid,/area/map_template/wreck/wreckfive)
"cu" = (/obj/structure/catwalk,/obj/machinery/atmospherics/pipe/simple/hidden{dir = 4},/obj/machinery/door/airlock/external/bolted,/turf/simulated/floor/plating,/area/map_template/wreck/wreckfive)
"cv" = (/turf/template_noop,/area/map_template/wreck/wreckfive)
"cw" = (/obj/structure/catwalk,/obj/machinery/atmospherics/pipe/manifold/hidden{dir = 8},/turf/simulated/floor/plating,/area/map_template/wreck/wreckfive)
"cx" = (/obj/structure/catwalk,/obj/machinery/atmospherics/pipe/simple/hidden{dir = 4},/turf/simulated/floor/plating,/area/map_template/wreck/wreckfive)
"cy" = (/obj/effect/floor_decal/industrial/warning{dir = 8},/turf/simulated/floor/tiled/techmaint,/area/map_template/wreck/wreckfive)
"cz" = (/obj/effect/floor_decal/techfloor{dir = 4; icon_state = "techfloor_edges"},/turf/simulated/floor/tiled/techmaint,/area/map_template/wreck/wreckfive)
"cA" = (/obj/machinery/atmospherics/unary/vent_pump/high_volume/shuttle{dir = 1},/turf/simulated/floor/tiled/steel_ridged,/area/map_template/wreck/wreckfive)
"cB" = (/obj/effect/floor_decal/industrial/warning{dir = 4},/obj/structure/handrail{dir = 4},/obj/effect/decal/cleanable/generic,/turf/simulated/floor/tiled/techmaint,/area/map_template/wreck/wreckfive)
"cC" = (/obj/effect/floor_decal/industrial/outline/yellow,/obj/effect/decal/cleanable/dirt,/turf/simulated/floor/tiled/steel_grid,/area/map_template/wreck/wreckfive)
"cD" = (/obj/effect/floor_decal/industrial/outline/yellow,/obj/structure/closet/crate/solar_assembly,/turf/simulated/floor/tiled/steel_grid,/area/map_template/wreck/wreckfive)
"cE" = (/obj/effect/floor_decal/techfloor/corner,/obj/effect/floor_decal/industrial/warning{dir = 8},/turf/simulated/floor/tiled/techmaint,/area/map_template/wreck/wreckfive)
"cF" = (/obj/effect/floor_decal/techfloor{dir = 6; icon_state = "techfloor_edges"},/obj/structure/railing/mapped{dir = 4; icon_state = "railing0-1"},/obj/structure/railing/mapped,/turf/simulated/floor/tiled/techmaint,/area/map_template/wreck/wreckfive)
"cG" = (/obj/effect/floor_decal/techfloor,/obj/structure/railing/mapped,/obj/structure/closet/crate,/obj/random/junkyard/biggun,/obj/random/junkyard/ammo,/obj/random/junkyard/ammo,/turf/simulated/floor/tiled/techmaint,/area/map_template/wreck/wreckfive)
"cH" = (/obj/effect/floor_decal/techfloor,/obj/effect/floor_decal/industrial/warning{dir = 1},/turf/simulated/floor/tiled/techmaint,/area/map_template/wreck/wreckfive)
"cI" = (/obj/effect/floor_decal/techfloor{dir = 6; icon_state = "techfloor_edges"},/obj/effect/floor_decal/industrial/warning/corner{dir = 1},/obj/structure/railing/mapped{dir = 4; icon_state = "railing0-1"},/obj/structure/railing/mapped,/turf/simulated/floor/tiled/techmaint,/area/map_template/wreck/wreckfive)
"cJ" = (/turf/simulated/mineral/volcanic,/area/template_noop)
"ir" = (/obj/random/junkyard/hostile,/turf/template_noop,/area/template_noop)
"kw" = (/obj/structure/girder/displaced,/turf/template_noop,/area/template_noop)
"kS" = (/obj/structure/closet/crate/solar,/turf/template_noop,/area/template_noop)
"mP" = (/obj/effect/decal/cleanable/dirt,/obj/machinery/ion_engine{dir = 1},/turf/simulated/floor/plating,/area/map_template/wreck/wreckfive)
"mY" = (/turf/simulated/mineral/random/volcanic,/area/template_noop)
"uQ" = (/turf/template_noop,/area/template_noop)
"Lg" = (/obj/structure/lattice,/obj/machinery/shipsensors/weak,/obj/effect/decal/cleanable/dirt,/turf/template_noop,/area/template_noop)
"OJ" = (/obj/structure/lattice,/turf/template_noop,/area/template_noop)

(1,1,1) = {"
uQuQuQuQuQuQuQuQuQuQuQuQuQuQuQuQuQuQuQuQuQuQuQuQuQuQuQuQuQuQ
uQuQuQuQuQuQuQuQuQuQuQuQuQuQuQuQuQuQuQuQuQuQuQuQuQuQuQuQuQuQ
uQuQuQuQuQuQuQuQuQuQuQuQuQuQuQuQuQuQuQuQuQuQuQuQuQuQuQuQuQuQ
uQuQuQuQuQuQuQuQuQuQuQuQuQuQuQuQuQuQuQuQuQuQuQuQuQuQuQuQuQuQ
uQuQuQuQuQuQuQuQuQuQuQuQuQuQuQuQuQuQuQuQuQuQuQuQuQuQuQuQuQuQ
uQuQuQuQuQuQuQuQuQuQuQuQuQuQuQuQuQuQuQuQuQuQuQuQuQuQuQuQuQuQ
uQuQuQuQuQuQuQmYmYmYuQuQuQuQuQuQuQuQuQuQmYmYmYuQuQuQuQuQuQuQ
uQuQuQuQuQmYmYmYmYmYmYuQuQuQuQuQuQuQuQmYmYmYmYmYmYuQuQuQuQuQ
uQuQuQuQuQmYcJcJcJmYmYuQuQuQuQuQuQuQuQmYmYmYcJmYmYuQuQuQuQuQ
uQuQuQuQuQcJcJcJmYmYmYuQuQuQuQuQuQuQmYmYmYcJmYmYmYuQmYmYuQuQ
uQuQuQmYmYcJcJmYmYuQOJiruQuQuQuQuQuQmYmYmYcJcJmYmYmYmYmYmYuQ
uQuQuQuQcJcJmYmYuQuQaaaaabacacadacaeaeOJmYmYmYcJmYmYmYmYmYuQ
uQuQuQmYmYmYOJOJOJOJafagahaiajakalamanLguQmYmYmYcJcJmYmYmYuQ
uQuQuQmYmYmYuQuQuQaoafapaqarasatauavaaafuQuQuQmYmYmYmYmYmYmY
uQuQmYmYmYmYmYaoawaxayazaAaBaCaCaDaEaFafaGaHOJOJmYmYmYmYmYmY
uQuQmYmYmYmYmYaoaIaJaKaLaMaNaOaPaQaRapaSaTaGuQuQuQuQmYmYmYmY
uQuQmYmYmYOJuQaoaUaVaWaXaYaZbabbbcbdapbebfaHuQuQuQuQmYcJcJcJ
uQmYcJcJOJaoaoaxbgbhbibjbkblbmbnbobpapbqbrbsbtbtOJmYmYcJcJmY
uQcJmYcJaoaxaxaobubvbwbjbxbybzasbybpbAbBbCbDbtbtbtmYcJcJmYmY
uQuQmYcJaobEbFbGbzbHbIbJbKbxbzbLasbMbNbObPbQbEbEbtuQcJmYuQuQ
uQuQuQuQOJuQOJbGbRbSbTbUbVbWbXbYbZcaancbaeaeuQuQOJuQmYmYuQuQ
uQuQuQuQOJuQOJuQbGcccdbjcecfaeaeanaecgchcianuQuQOJuQuQuQuQuQ
uQmYcJmYmYuQOJmYbGbGcjckaeclcmaecncocpcqcrcsuQuQOJuQuQuQuQuQ
uQmYcJmYOJOJOJOJOJbzbzctcucvcwcxbzchchchcyczuQuQmYmYmYuQuQuQ
mYcJcJmYmYuQuQuQuQcvbzaaafcAcvafcBcCcCcDcEcFOJOJmYcJcJmYuQuQ
mYcJcJmYuQuQuQuQkwafafafaaafcvcfcGcHcHbzcIOJuQmYmYcJcJmYuQuQ
mYmYuQuQuQuQmYOJOJaamPbEbEafuQuQuQuQuQuQuQOJmYmYcJmYmYuQuQuQ
uQuQuQuQuQmYmYcJuQuQuQuQuQuQuQuQkwuQuQkSuQuQcJcJuQmYmYuQuQuQ
uQuQuQuQuQcJcJmYuQuQuQuQuQuQuQuQuQuQuQuQuQuQmYuQuQuQuQuQuQuQ
uQuQuQmYuQuQuQuQuQuQuQuQuQuQuQuQuQuQuQuQuQuQuQuQuQuQuQuQuQuQ
"}
