"a" = (/obj/effect/floor_decal/borderfloor{dir = 4},/obj/structure/railing/mapped{dir = 4; icon_state = "railing0-1"},/turf/simulated/floor/tiled/techfloor/grid,/area/template_noop)
"b" = (/obj/effect/floor_decal/borderfloor{dir = 4},/obj/structure/railing/mapped{dir = 4; icon_state = "railing0-1"},/obj/random/junkyard/smokes,/obj/random/trash,/turf/simulated/floor/tiled/techfloor/grid,/area/template_noop)
"c" = (/obj/effect/floor_decal/industrial/warning/fulltile,/obj/structure/reagent_dispensers/fueltank,/obj/structure/cable/green{d1 = 4; d2 = 8; icon_state = "4-8"},/turf/simulated/floor/tiled/techfloor,/area/template_noop)
"d" = (/obj/effect/floor_decal/industrial/warning{dir = 9},/obj/effect/decal/cleanable/dirt,/obj/effect/decal/cleanable/dirt,/obj/structure/table/rack,/obj/random/junkyard/material,/obj/random/junkyard/material,/obj/random/junkyard/material,/obj/random/junkyard/material,/obj/random/circuitboard{spawn_nothing_percentage = 50},/obj/random/circuitboard{spawn_nothing_percentage = 50},/turf/simulated/floor/tiled/techfloor,/area/template_noop)
"e" = (/obj/effect/floor_decal/industrial/warning/fulltile,/obj/structure/closet/crate/radiation_gear,/obj/effect/decal/cleanable/dirt,/obj/effect/decal/cleanable/dirt,/obj/structure/cable/green{d1 = 4; d2 = 8; icon_state = "4-8"},/obj/random/trash,/turf/simulated/floor/tiled/techfloor,/area/template_noop)
"f" = (/obj/structure/catwalk,/obj/structure/railing/mapped,/obj/effect/decal/cleanable/dirt,/obj/machinery/atmospherics/pipe/simple/hidden/scrubbers{dir = 8},/obj/machinery/atmospherics/pipe/simple/hidden/supply{dir = 4},/turf/simulated/floor/plating,/area/template_noop)
"g" = (/obj/effect/floor_decal/borderfloor{dir = 8},/obj/structure/railing/mapped{dir = 8; icon_state = "railing0-1"},/obj/structure/reagent_dispensers/watertank,/obj/effect/decal/cleanable/dirt,/turf/simulated/floor/tiled/techfloor/grid,/area/template_noop)
"h" = (/obj/effect/floor_decal/industrial/outline/yellow,/obj/structure/closet,/obj/machinery/firealarm{pixel_y = 13},/obj/random/junkyard/bomb_supply,/obj/random/junkyard/loot,/turf/simulated/floor/tiled/techfloor/grid,/area/template_noop)
"i" = (/obj/effect/floor_decal/industrial/outline/yellow,/obj/structure/closet/crate/large,/obj/random/junkyard/loot,/obj/random/junkyard/loot,/obj/random/junkyard/loot,/obj/random/junkyard/loot,/obj/random/junkyard/loot,/obj/random/junkyard/loot,/obj/random/junkyard/loot,/obj/random/junkyard/loot,/obj/random/junkyard/loot,/obj/random/junkyard/loot,/obj/random/junkyard/loot,/obj/random/junkyard/loot,/obj/random/junkyard/loot,/obj/random/junkyard/loot,/obj/random/junkyard/loot,/obj/random/contraband{spawn_nothing_percentage = 90},/turf/simulated/floor/tiled/techfloor/grid,/area/template_noop)
"j" = (/obj/structure/catwalk,/obj/structure/railing/mapped{dir = 1; icon_state = "railing0-1"},/obj/machinery/atmospherics/pipe/simple/hidden/scrubbers{dir = 8},/obj/machinery/atmospherics/pipe/simple/hidden/supply{dir = 4},/obj/machinery/atmospherics/pipe/simple/hidden/supply{dir = 4},/turf/simulated/floor/plating,/area/template_noop)
"k" = (/obj/structure/catwalk,/obj/machinery/atmospherics/pipe/manifold/hidden/scrubbers{dir = 4},/obj/machinery/atmospherics/pipe/manifold/hidden/supply{dir = 4},/obj/structure/cable/green{d1 = 4; d2 = 8; icon_state = "4-8"},/turf/simulated/floor/plating,/area/template_noop)
"l" = (/obj/structure/catwalk,/obj/machinery/atmospherics/pipe/simple/hidden/scrubbers{dir = 8},/obj/machinery/atmospherics/pipe/simple/hidden/supply{dir = 4},/obj/structure/cable/green{d1 = 4; d2 = 8; icon_state = "4-8"},/turf/simulated/floor/plating,/area/template_noop)
"n" = (/obj/effect/floor_decal/industrial/outline/yellow,/obj/structure/closet/toolcloset,/obj/effect/decal/cleanable/dirt,/obj/random/junkyard/tech_supply,/obj/random/junkyard/tech_supply,/obj/random/junkyard/tech_supply,/obj/random/junkyard/tech_supply,/obj/random/junkyard/tech_supply,/obj/random/junkyard/tech_supply,/obj/random/junkyard/toolbox,/obj/random/junkyard/toolbox,/obj/random/junkyard/tech_supply,/obj/random/junkyard/bomb_supply,/obj/random/junkyard/bomb_supply,/turf/simulated/floor/tiled/techfloor/grid,/area/template_noop)
"o" = (/obj/structure/catwalk,/obj/structure/railing/mapped{dir = 1; icon_state = "railing0-1"},/obj/machinery/atmospherics/pipe/simple/hidden/scrubbers{dir = 8},/obj/machinery/atmospherics/pipe/simple/hidden/supply{dir = 4},/turf/simulated/floor/plating,/area/template_noop)
"p" = (/obj/structure/catwalk,/obj/structure/catwalk,/obj/machinery/atmospherics/pipe/simple/hidden/supply{dir = 5},/obj/machinery/atmospherics/pipe/simple/hidden/scrubbers{dir = 5},/turf/simulated/floor/plating,/area/template_noop)
"q" = (/obj/effect/floor_decal/industrial/outline/yellow,/turf/simulated/floor/tiled/techfloor/grid,/area/template_noop)
"r" = (/obj/effect/floor_decal/industrial/warning{dir = 4},/obj/structure/ore_box,/obj/effect/decal/cleanable/dirt,/obj/machinery/light/small/red{dir = 1},/turf/simulated/floor/tiled/techfloor,/area/template_noop)
"s" = (/obj/effect/floor_decal/borderfloor{dir = 4},/obj/structure/railing/mapped{dir = 4; icon_state = "railing0-1"},/obj/effect/decal/cleanable/dirt,/obj/structure/table/rack,/obj/random/junkyard/loot,/obj/random/junkyard/loot,/turf/simulated/floor/tiled/techfloor/grid,/area/template_noop)
"t" = (/obj/effect/floor_decal/industrial/warning{dir = 10},/obj/effect/decal/cleanable/dirt,/obj/effect/decal/cleanable/dirt,/obj/effect/decal/cleanable/dirt,/obj/effect/decal/cleanable/dirt,/turf/simulated/floor/tiled/techfloor,/area/template_noop)
"u" = (/obj/structure/catwalk,/obj/machinery/atmospherics/pipe/manifold4w/hidden/scrubbers,/obj/machinery/atmospherics/pipe/manifold4w/hidden/supply,/obj/structure/cable/green{d1 = 1; d2 = 2; icon_state = "1-2"},/turf/simulated/floor/plating,/area/template_noop)
"v" = (/obj/structure/catwalk,/obj/machinery/atmospherics/pipe/manifold/hidden/scrubbers{dir = 8},/obj/machinery/atmospherics/pipe/manifold/hidden/supply{dir = 8},/obj/structure/cable/green{d1 = 4; d2 = 8; icon_state = "4-8"},/turf/simulated/floor/plating,/area/template_noop)
"w" = (/obj/effect/floor_decal/industrial/warning{dir = 4; icon_state = "warning"},/obj/machinery/light/small/red,/obj/structure/table/rack,/turf/simulated/floor/tiled/techfloor,/area/template_noop)
"x" = (/obj/structure/catwalk,/obj/structure/railing/mapped{dir = 1; icon_state = "railing0-1"},/obj/structure/closet/crate/secure/gear,/obj/machinery/atmospherics/pipe/simple/hidden/scrubbers{dir = 8},/obj/machinery/atmospherics/pipe/simple/hidden/supply{dir = 4},/obj/random/junkyard/biggun,/obj/random/junkyard/biggun,/obj/random/junkyard/biggun,/obj/random/junkyard/ammo,/obj/random/junkyard/ammo,/obj/random/junkyard/ammo,/obj/random/junkyard/ammo,/obj/random/junkyard/ammo,/turf/simulated/floor/plating,/area/template_noop)
"y" = (/obj/effect/floor_decal/industrial/outline/yellow,/obj/structure/closet/crate/freezer,/obj/item/reagent_containers/ivbag/blood/AMinus,/obj/item/reagent_containers/ivbag/blood/AMinus,/obj/item/reagent_containers/ivbag/blood/BPlus,/obj/item/reagent_containers/ivbag/blood/BPlus,/obj/item/reagent_containers/ivbag/blood/OMinus,/obj/item/reagent_containers/ivbag/blood/AMinus,/obj/item/reagent_containers/ivbag/blood/AMinus,/obj/item/reagent_containers/ivbag/blood/OPlus,/obj/item/reagent_containers/ivbag/blood/OMinus,/obj/item/reagent_containers/ivbag/blood/OMinus,/obj/item/reagent_containers/ivbag/blood/APlus,/obj/item/reagent_containers/ivbag/blood/APlus,/obj/item/reagent_containers/ivbag/blood/APlus,/obj/item/reagent_containers/ivbag/blood/APlus,/obj/item/reagent_containers/ivbag/blood/APlus,/obj/item/reagent_containers/ivbag/blood/BMinus,/turf/simulated/floor/tiled/techfloor/grid,/area/template_noop)
"z" = (/obj/effect/floor_decal/industrial/warning/fulltile,/obj/effect/decal/cleanable/dirt,/obj/structure/cable/green{d1 = 4; d2 = 8; icon_state = "4-8"},/turf/simulated/floor/tiled/techfloor,/area/template_noop)
"A" = (/obj/effect/floor_decal/industrial/outline/yellow,/obj/structure/closet/crate/plastic,/obj/random/hat,/obj/random/hat,/obj/random/hat,/obj/random/hat,/obj/random/accessory,/obj/random/accessory,/obj/random/accessory,/obj/random/accessory,/obj/random/hat,/obj/random/clothing{spawn_nothing_percentage = 50},/obj/random/clothing{spawn_nothing_percentage = 50},/obj/random/clothing{spawn_nothing_percentage = 50},/obj/random/clothing{spawn_nothing_percentage = 50},/obj/random/accessory,/obj/random/accessory,/obj/random/accessory,/turf/simulated/floor/tiled/techfloor/grid,/area/template_noop)
"B" = (/obj/structure/catwalk,/obj/structure/railing/mapped,/obj/machinery/atmospherics/pipe/simple/hidden/scrubbers{dir = 8},/obj/machinery/atmospherics/pipe/simple/hidden/supply{dir = 4},/turf/simulated/floor/plating,/area/template_noop)
"C" = (/obj/effect/floor_decal/borderfloor{dir = 8},/obj/structure/railing/mapped{dir = 8; icon_state = "railing0-1"},/obj/effect/decal/cleanable/dirt,/obj/effect/landmark/explosion/random,/turf/simulated/floor/tiled/techfloor/grid,/area/template_noop)
"D" = (/obj/effect/floor_decal/industrial/outline/yellow,/obj/structure/closet/crate/medical,/obj/effect/decal/cleanable/dirt,/obj/effect/decal/cleanable/dirt,/obj/effect/decal/cleanable/dirt,/obj/random/junkyard/medical,/obj/random/junkyard/medical,/obj/random/junkyard/medical,/obj/random/junkyard/medical/lite,/obj/random/junkyard/medical/lite,/obj/random/junkyard/medical/lite,/obj/random/junkyard/medical/lite,/obj/random/junkyard/medical/lite,/obj/random/junkyard/medical/lite,/obj/random/junkyard/medical,/obj/random/junkyard/medical/lite,/obj/random/junkyard/medical/lite,/obj/random/junkyard/medical/lite,/turf/simulated/floor/tiled/techfloor/grid,/area/template_noop)
"E" = (/obj/effect/floor_decal/borderfloor{dir = 8},/obj/structure/railing/mapped{dir = 8; icon_state = "railing0-1"},/obj/random/trash,/obj/random/trash,/turf/simulated/floor/tiled/techfloor/grid,/area/template_noop)
"F" = (/obj/effect/floor_decal/industrial/warning{dir = 8},/obj/effect/decal/cleanable/dirt,/obj/machinery/light/small/red,/obj/structure/table/rack,/turf/simulated/floor/tiled/techfloor,/area/template_noop)
"G" = (/obj/structure/catwalk,/obj/machinery/atmospherics/pipe/simple/hidden/supply{dir = 9},/obj/machinery/atmospherics/pipe/simple/hidden/scrubbers{dir = 9},/turf/simulated/floor/plating,/area/template_noop)
"H" = (/obj/structure/catwalk,/obj/structure/railing/mapped,/obj/machinery/atmospherics/pipe/simple/hidden/scrubbers{dir = 8},/obj/machinery/atmospherics/pipe/simple/hidden/supply{dir = 4},/obj/machinery/atmospherics/pipe/simple/hidden/supply{dir = 4},/turf/simulated/floor/plating,/area/template_noop)
"I" = (/obj/effect/floor_decal/industrial/outline/yellow,/obj/structure/closet/jcloset,/obj/effect/decal/cleanable/dirt,/obj/effect/decal/cleanable/generic,/turf/simulated/floor/tiled/techfloor/grid,/area/template_noop)
"J" = (/obj/effect/floor_decal/industrial/outline/yellow,/obj/structure/closet,/obj/random/junkyard/advdevice,/obj/random/junkyard/advdevice,/obj/random/circuitboard{spawn_nothing_percentage = 50},/obj/random/circuitboard{spawn_nothing_percentage = 50},/obj/random/circuitboard{spawn_nothing_percentage = 50},/turf/simulated/floor/tiled/techfloor/grid,/area/template_noop)
"K" = (/obj/effect/floor_decal/industrial/outline/yellow,/obj/structure/closet/emcloset,/obj/random/action_figure,/turf/simulated/floor/tiled/techfloor/grid,/area/template_noop)
"L" = (/obj/structure/catwalk,/obj/effect/decal/cleanable/dirt,/obj/machinery/atmospherics/pipe/simple/hidden/supply,/obj/machinery/atmospherics/pipe/simple/hidden/scrubbers,/obj/structure/cable/green{d1 = 4; d2 = 8; icon_state = "4-8"},/obj/structure/cable/green{d1 = 1; d2 = 8; icon_state = "1-8"},/obj/structure/cable/green{d1 = 2; d2 = 4; icon_state = "2-4"},/obj/structure/cable/green{d1 = 1; d2 = 4; icon_state = "1-4"},/obj/structure/cable/green{d1 = 2; d2 = 8; icon_state = "2-8"},/turf/simulated/floor/plating,/area/template_noop)
"M" = (/obj/structure/catwalk,/obj/structure/closet/crate/trashcart,/obj/effect/decal/cleanable/dirt,/obj/machinery/atmospherics/pipe/simple/hidden/supply{dir = 10},/obj/machinery/atmospherics/pipe/simple/hidden/scrubbers{dir = 10},/obj/random/junkyard/powercell,/obj/random/trash,/obj/random/trash,/obj/random/trash,/obj/random/trash,/obj/random/junkyard/bomb_supply,/obj/random/junkyard/toolbox,/obj/random/trash,/obj/random/trash,/obj/random/junkyard/lilgun,/obj/random/trash,/obj/random/trash,/obj/random/trash,/obj/random/relic,/obj/random/trash,/obj/random/trash,/obj/random/trash,/obj/random/trash,/obj/random/trash,/turf/simulated/floor/plating,/area/template_noop)
"N" = (/obj/effect/floor_decal/industrial/warning{dir = 8},/obj/effect/decal/cleanable/dirt,/obj/machinery/light/small/red{dir = 1},/turf/simulated/floor/tiled/techfloor,/area/template_noop)
"O" = (/obj/effect/floor_decal/industrial/warning{dir = 5},/obj/effect/decal/cleanable/dirt,/obj/effect/decal/cleanable/dirt,/obj/effect/decal/cleanable/generic,/obj/structure/reagent_dispensers/fueltank,/turf/simulated/floor/tiled/techfloor,/area/template_noop)
"P" = (/obj/effect/floor_decal/industrial/warning{dir = 6},/obj/random/trash,/turf/simulated/floor/tiled/techfloor,/area/template_noop)
"Q" = (/obj/structure/catwalk,/obj/effect/decal/cleanable/dirt,/obj/machinery/atmospherics/pipe/manifold4w/hidden/scrubbers,/obj/machinery/atmospherics/pipe/manifold4w/hidden/supply,/obj/structure/cable/green{d1 = 1; d2 = 2; icon_state = "1-2"},/turf/simulated/floor/plating,/area/template_noop)
"R" = (/obj/effect/floor_decal/industrial/outline/yellow,/obj/structure/closet/chefcloset,/obj/machinery/alarm{pixel_y = 24; req_access = newlist()},/turf/simulated/floor/tiled/techfloor/grid,/area/template_noop)
"S" = (/obj/structure/catwalk,/obj/machinery/atmospherics/pipe/simple/hidden/scrubbers,/obj/machinery/atmospherics/pipe/simple/hidden/supply,/obj/structure/cable/green{d1 = 1; d2 = 2; icon_state = "1-2"},/turf/simulated/floor/plating,/area/template_noop)
"T" = (/obj/structure/catwalk,/obj/machinery/atmospherics/pipe/simple/hidden/supply{dir = 4},/obj/machinery/atmospherics/pipe/simple/hidden/scrubbers{dir = 8},/obj/structure/cable/green{d1 = 4; d2 = 8; icon_state = "4-8"},/turf/simulated/floor/plating,/area/template_noop)
"U" = (/obj/effect/floor_decal/borderfloor{dir = 4},/obj/structure/railing/mapped{dir = 4; icon_state = "railing0-1"},/obj/structure/closet/secure_closet/bar,/obj/random/clothing{spawn_nothing_percentage = 50},/obj/random/clothing{spawn_nothing_percentage = 50},/turf/simulated/floor/tiled/techfloor/grid,/area/template_noop)
"V" = (/obj/structure/catwalk,/obj/effect/decal/cleanable/dirt,/obj/effect/decal/cleanable/dirt,/obj/machinery/atmospherics/pipe/simple/hidden/scrubbers,/obj/machinery/atmospherics/pipe/simple/hidden/supply,/obj/structure/cable/green{d1 = 1; d2 = 2; icon_state = "1-2"},/obj/random/trash,/obj/random/trash,/turf/simulated/floor/plating,/area/template_noop)
"W" = (/obj/effect/floor_decal/borderfloor{dir = 8},/obj/structure/railing/mapped{dir = 8; icon_state = "railing0-1"},/obj/effect/decal/cleanable/dirt,/turf/simulated/floor/tiled/techfloor/grid,/area/template_noop)
"X" = (/obj/structure/catwalk,/obj/machinery/atmospherics/pipe/simple/hidden/supply{dir = 6},/obj/machinery/atmospherics/pipe/simple/hidden/scrubbers{dir = 6},/turf/simulated/floor/plating,/area/template_noop)
"Y" = (/obj/structure/catwalk,/obj/structure/railing/mapped{dir = 1; icon_state = "railing0-1"},/obj/structure/ore_box,/obj/machinery/atmospherics/pipe/simple/hidden/scrubbers{dir = 8},/obj/machinery/atmospherics/pipe/simple/hidden/supply{dir = 4},/turf/simulated/floor/plating,/area/template_noop)
"Z" = (/obj/effect/floor_decal/industrial/warning/fulltile,/obj/structure/closet/crate/solar_assembly,/obj/structure/cable/green{d1 = 4; d2 = 8; icon_state = "4-8"},/turf/simulated/floor/tiled/techfloor,/area/template_noop)

(1,1,1) = {"
UrhRJSnIiNC
sPXBHuBfMtE
llkZcLezvTT
bOpjxQYoGdW
awDyqVKqAFg
"}
