"a" = (/obj/effect/floor_decal/borderfloor{dir = 8},/obj/effect/floor_decal/industrial/warning{dir = 4},/obj/structure/closet/emcloset,/obj/effect/decal/cleanable/generic,/turf/simulated/floor/tiled/techfloor,/area/space)
"b" = (/obj/structure/catwalk,/obj/structure/cable/green{d1 = 2; d2 = 4; icon_state = "2-4"},/obj/machinery/atmospherics/pipe/simple/hidden/scrubbers{dir = 6},/turf/simulated/floor/plating,/area/space)
"c" = (/obj/structure/catwalk,/obj/structure/cable/green{d1 = 2; d2 = 8; icon_state = "2-8"},/obj/machinery/atmospherics/pipe/simple/hidden/scrubbers{dir = 10},/obj/effect/decal/cleanable/dirt,/turf/simulated/floor/plating,/area/space)
"d" = (/obj/effect/floor_decal/floordetail/tiled,/obj/effect/floor_decal/industrial/warning,/turf/simulated/floor/tiled/steel_grid,/area/space)
"e" = (/obj/effect/floor_decal/floordetail/tiled,/obj/effect/floor_decal/industrial/warning,/obj/structure/reagent_dispensers/watertank,/obj/effect/decal/cleanable/dirt,/turf/simulated/floor/tiled/steel_grid,/area/space)
"f" = (/obj/effect/floor_decal/borderfloor{dir = 4},/obj/effect/floor_decal/industrial/warning{dir = 8},/obj/structure/table/rack,/obj/item/material/hatchet,/obj/item/material/minihoe,/obj/effect/decal/cleanable/dirt,/obj/effect/decal/cleanable/cobweb2,/turf/simulated/floor/tiled/techfloor,/area/space)
"g" = (/obj/effect/floor_decal/floordetail/tiled,/obj/effect/floor_decal/industrial/warning{dir = 1},/obj/structure/cable/green{d1 = 4; d2 = 8; icon_state = "4-8"},/obj/machinery/atmospherics/pipe/simple/hidden/scrubbers{dir = 8},/turf/simulated/floor/tiled/steel_grid,/area/space)
"j" = (/obj/structure/table/standard,/obj/effect/floor_decal/industrial/outline/yellow,/obj/machinery/reagentgrinder/juicer{pixel_x = 3; pixel_y = 17},/obj/item/reagent_containers/glass/beaker{pixel_x = 5},/obj/item/reagent_containers/dropper{pixel_y = 3},/turf/simulated/floor/tiled/techfloor,/area/space)
"k" = (/obj/effect/floor_decal/floordetail/tiled,/obj/effect/floor_decal/industrial/warning{dir = 1},/obj/structure/cable/green{d1 = 4; d2 = 8; icon_state = "4-8"},/obj/machinery/atmospherics/pipe/simple/hidden/scrubbers{dir = 8},/obj/structure/hygiene/drain,/turf/simulated/floor/tiled/steel_grid,/area/space)
"l" = (/obj/effect/floor_decal/industrial/outline/blue,/obj/machinery/portable_atmospherics/hydroponics,/turf/simulated/floor/tiled/steel_ridged,/area/space)
"m" = (/obj/structure/catwalk,/obj/machinery/seed_extractor,/turf/simulated/floor/plating,/area/space)
"n" = (/obj/machinery/vending/hydronutrients/generic,/obj/effect/floor_decal/industrial/hatch/yellow,/turf/simulated/floor/tiled/techfloor,/area/space)
"o" = (/obj/effect/floor_decal/industrial/outline/blue,/obj/machinery/portable_atmospherics/hydroponics,/obj/machinery/light/small{dir = 1},/obj/effect/decal/cleanable/dirt,/turf/simulated/floor/tiled/steel_ridged,/area/space)
"p" = (/obj/structure/catwalk,/obj/structure/cable/green{d1 = 1; d2 = 8; icon_state = "1-8"},/obj/structure/cable/green{d1 = 2; d2 = 8; icon_state = "2-8"},/obj/machinery/atmospherics/pipe/simple/hidden/supply{dir = 10},/obj/machinery/atmospherics/pipe/simple/hidden/scrubbers{dir = 9},/turf/simulated/floor/plating,/area/space)
"r" = (/obj/effect/floor_decal/borderfloor{dir = 8},/obj/effect/floor_decal/industrial/warning{dir = 4},/obj/machinery/chem_master/condimaster{name = "CondiMaster Neo"},/turf/simulated/floor/tiled/techfloor,/area/space)
"s" = (/obj/effect/floor_decal/floordetail/tiled,/obj/effect/floor_decal/industrial/warning,/obj/structure/cable/green{d1 = 4; d2 = 8; icon_state = "4-8"},/obj/machinery/atmospherics/pipe/simple/hidden/supply{dir = 4},/obj/structure/hygiene/drain,/obj/effect/decal/cleanable/generic,/turf/simulated/floor/tiled/steel_grid,/area/space)
"t" = (/obj/structure/catwalk,/obj/structure/cable/green{d1 = 1; d2 = 4; icon_state = "1-4"},/obj/machinery/atmospherics/pipe/simple/hidden/supply{dir = 5},/turf/simulated/floor/plating,/area/space)
"u" = (/obj/effect/floor_decal/industrial/outline/blue,/obj/machinery/portable_atmospherics/hydroponics,/obj/machinery/light/small{dir = 1},/turf/simulated/floor/tiled/steel_ridged,/area/space)
"v" = (/obj/effect/floor_decal/floordetail/tiled,/obj/effect/floor_decal/industrial/warning,/obj/structure/cable/green{d1 = 4; d2 = 8; icon_state = "4-8"},/obj/machinery/atmospherics/pipe/simple/hidden/supply{dir = 4},/turf/simulated/floor/tiled/steel_grid,/area/space)
"w" = (/obj/structure/cable/green{d1 = 4; d2 = 8; icon_state = "4-8"},/obj/machinery/atmospherics/pipe/simple/hidden/scrubbers{dir = 8},/obj/machinery/atmospherics/pipe/simple/hidden/supply{dir = 4},/obj/structure/catwalk,/turf/simulated/floor/plating,/area/space)
"x" = (/obj/structure/catwalk,/obj/structure/cable/green{d1 = 4; d2 = 8; icon_state = "4-8"},/obj/machinery/atmospherics/pipe/simple/hidden/supply{dir = 4},/obj/machinery/atmospherics/pipe/simple/hidden/scrubbers{dir = 8},/obj/item/reagent_containers/glass/bucket/wood{pixel_x = -20; pixel_y = -18},/turf/simulated/floor/plating,/area/space)
"y" = (/obj/structure/catwalk,/obj/structure/cable/green{d1 = 4; d2 = 8; icon_state = "4-8"},/obj/machinery/atmospherics/pipe/simple/hidden/supply{dir = 4},/obj/machinery/atmospherics/pipe/simple/hidden/scrubbers{dir = 8},/turf/simulated/floor/plating,/area/space)
"z" = (/obj/effect/floor_decal/borderfloor{dir = 8},/obj/effect/floor_decal/industrial/warning/corner{dir = 4},/obj/random/trash,/turf/simulated/floor/tiled/techfloor,/area/space)
"A" = (/obj/structure/catwalk,/obj/structure/cable/green{d1 = 4; d2 = 8; icon_state = "4-8"},/obj/machinery/atmospherics/pipe/simple/hidden/supply{dir = 4},/obj/machinery/atmospherics/pipe/simple/hidden/scrubbers{dir = 8},/obj/effect/decal/cleanable/dirt,/turf/simulated/floor/plating,/area/space)
"B" = (/obj/structure/cable/green{d1 = 4; d2 = 8; icon_state = "4-8"},/obj/machinery/atmospherics/pipe/simple/hidden/supply{dir = 4},/obj/machinery/atmospherics/pipe/simple/hidden/scrubbers{dir = 8},/obj/structure/catwalk,/turf/simulated/floor/plating,/area/space)
"C" = (/obj/structure/catwalk,/obj/machinery/smartfridge/drying_rack,/turf/simulated/floor/plating,/area/space)
"D" = (/obj/effect/floor_decal/borderfloor{dir = 4},/obj/effect/floor_decal/industrial/warning/corner{dir = 1},/turf/simulated/floor/tiled/techfloor,/area/space)
"E" = (/obj/effect/floor_decal/industrial/outline/blue,/obj/machinery/portable_atmospherics/hydroponics,/obj/machinery/firealarm{pixel_y = 13},/turf/simulated/floor/tiled/steel_ridged,/area/space)
"G" = (/obj/effect/floor_decal/industrial/outline/blue,/obj/machinery/portable_atmospherics/hydroponics,/obj/machinery/alarm{pixel_y = 24; req_access = newlist()},/turf/simulated/floor/tiled/steel_ridged,/area/space)
"H" = (/obj/structure/catwalk,/obj/structure/cable/green{d1 = 2; d2 = 4; icon_state = "2-4"},/obj/structure/cable/green{d1 = 1; d2 = 4; icon_state = "1-4"},/obj/machinery/atmospherics/pipe/simple/hidden/supply{dir = 6},/obj/machinery/atmospherics/pipe/simple/hidden/scrubbers{dir = 5},/obj/random/trash,/turf/simulated/floor/plating,/area/space)
"I" = (/obj/effect/floor_decal/borderfloor{dir = 4},/obj/effect/floor_decal/industrial/warning/corner{dir = 8},/turf/simulated/floor/tiled/techfloor,/area/space)
"J" = (/obj/effect/floor_decal/industrial/outline/blue,/obj/machinery/portable_atmospherics/hydroponics,/obj/machinery/light/small,/obj/effect/decal/cleanable/dirt,/obj/effect/decal/cleanable/dirt,/turf/simulated/floor/tiled/steel_ridged,/area/space)
"K" = (/obj/machinery/seed_storage/garden,/obj/effect/floor_decal/industrial/hatch/yellow,/obj/effect/decal/cleanable/dirt,/turf/simulated/floor/tiled/techfloor,/area/space)
"M" = (/obj/structure/catwalk,/obj/structure/cable/green{d1 = 1; d2 = 8; icon_state = "1-8"},/obj/machinery/atmospherics/pipe/simple/hidden/supply{dir = 9},/obj/effect/decal/cleanable/dirt,/turf/simulated/floor/plating,/area/space)
"N" = (/obj/effect/floor_decal/floordetail/tiled,/obj/effect/floor_decal/industrial/warning{dir = 1},/turf/simulated/floor/tiled/steel_grid,/area/space)
"O" = (/obj/effect/floor_decal/borderfloor{dir = 8},/obj/effect/floor_decal/industrial/warning/corner,/turf/simulated/floor/tiled/techfloor,/area/space)
"S" = (/obj/effect/floor_decal/floordetail/tiled,/obj/effect/floor_decal/industrial/warning,/obj/structure/cable/green{d1 = 4; d2 = 8; icon_state = "4-8"},/obj/machinery/atmospherics/pipe/simple/hidden/supply{dir = 4},/obj/random/trash,/obj/random/trash,/turf/simulated/floor/tiled/steel_grid,/area/space)
"T" = (/obj/effect/floor_decal/borderfloor{dir = 4},/obj/effect/floor_decal/industrial/warning{dir = 8},/obj/structure/table/rack,/turf/simulated/floor/tiled/techfloor,/area/space)
"U" = (/obj/effect/floor_decal/floordetail/tiled,/obj/effect/floor_decal/industrial/warning,/obj/effect/decal/cleanable/dirt,/turf/simulated/floor/tiled/steel_grid,/area/space)
"V" = (/obj/structure/catwalk,/obj/machinery/biogenerator,/obj/effect/decal/cleanable/dirt,/turf/simulated/floor/plating,/area/space)
"W" = (/obj/effect/floor_decal/industrial/outline/blue,/obj/machinery/portable_atmospherics/hydroponics,/obj/machinery/light/small,/turf/simulated/floor/tiled/steel_ridged,/area/space)
"X" = (/obj/effect/floor_decal/floordetail/tiled,/obj/effect/floor_decal/industrial/warning{dir = 1},/obj/effect/decal/cleanable/flour,/turf/simulated/floor/tiled/steel_grid,/area/space)
"Y" = (/obj/effect/floor_decal/industrial/outline/blue,/obj/machinery/portable_atmospherics/hydroponics,/obj/effect/decal/cleanable/dirt,/turf/simulated/floor/tiled/steel_ridged,/area/space)
"Z" = (/obj/effect/floor_decal/floordetail/tiled,/obj/effect/floor_decal/industrial/warning{dir = 1},/obj/effect/decal/cleanable/dirt,/turf/simulated/floor/tiled/steel_grid,/area/space)

(1,1,1) = {"
roECGulClof
zXZbgkgcNND
AwypnjKHxBA
OUdtvsSMeUI
aWYVlWlmlJT
"}
