"a" = (/obj/effect/floor_decal/spline/fancy/wood{dir = 8},/obj/structure/flora/ausbushes/genericbush,/obj/machinery/light/small{dir = 8},/turf/simulated/floor/grass,/area/template_noop)
"b" = (/obj/effect/floor_decal/spline/fancy/wood{dir = 10},/obj/structure/flora/ausbushes/ppflowers,/obj/structure/railing/mapped,/obj/structure/railing/mapped{dir = 8; icon_state = "railing0-1"},/turf/simulated/floor/grass,/area/template_noop)
"g" = (/obj/effect/floor_decal/spline/fancy/wood,/obj/structure/railing/mapped,/turf/simulated/floor/grass,/area/template_noop)
"h" = (/obj/effect/floor_decal/industrial/warning{dir = 8},/obj/structure/holoplant{pixel_y = 8},/obj/machinery/light/small{dir = 1},/turf/simulated/floor/tiled/steel_grid,/area/template_noop)
"j" = (/obj/effect/floor_decal/industrial/warning{dir = 9},/turf/simulated/floor/tiled/steel_grid,/area/template_noop)
"l" = (/obj/effect/floor_decal/industrial/warning{dir = 4},/obj/structure/holoplant{pixel_y = 8},/obj/machinery/light/small,/obj/effect/decal/cleanable/dirt,/obj/effect/decal/cleanable/dirt,/turf/simulated/floor/tiled/steel_grid,/area/template_noop)
"m" = (/obj/effect/floor_decal/industrial/warning{dir = 6},/turf/simulated/floor/tiled/steel_grid,/area/template_noop)
"n" = (/obj/effect/floor_decal/industrial/warning{dir = 5},/obj/effect/decal/cleanable/dirt,/turf/simulated/floor/tiled/steel_grid,/area/template_noop)
"p" = (/obj/structure/catwalk,/obj/machinery/atmospherics/pipe/simple/hidden/scrubbers,/obj/machinery/atmospherics/pipe/simple/hidden/supply,/obj/structure/cable/green{d1 = 1; d2 = 2; icon_state = "1-2"},/obj/effect/decal/cleanable/dirt,/turf/simulated/floor/plating,/area/template_noop)
"q" = (/obj/structure/flora/ausbushes/brflowers,/obj/machinery/firealarm{pixel_y = 13},/turf/simulated/floor/grass,/area/template_noop)
"s" = (/obj/effect/floor_decal/spline/fancy/wood{dir = 9},/obj/structure/railing/mapped{dir = 1; icon_state = "railing0-1"},/obj/structure/railing/mapped{dir = 8; icon_state = "railing0-1"},/turf/simulated/floor/grass,/area/template_noop)
"t" = (/obj/structure/catwalk,/obj/machinery/atmospherics/pipe/simple/hidden/scrubbers,/obj/machinery/atmospherics/pipe/simple/hidden/supply,/obj/structure/cable/green{d1 = 1; d2 = 2; icon_state = "1-2"},/obj/effect/decal/cleanable/dirt,/obj/effect/decal/cleanable/dirt,/turf/simulated/floor/plating,/area/template_noop)
"u" = (/obj/effect/floor_decal/spline/fancy/wood{dir = 4},/obj/structure/flora/ausbushes/ywflowers,/obj/machinery/light/small{dir = 4},/turf/simulated/floor/grass,/area/template_noop)
"w" = (/obj/effect/floor_decal/spline/fancy/wood{dir = 6},/obj/structure/railing/mapped,/obj/structure/railing/mapped{dir = 4; icon_state = "railing0-1"},/obj/machinery/alarm{pixel_y = 24; req_access = newlist()},/turf/simulated/floor/grass,/area/template_noop)
"x" = (/turf/simulated/floor/grass,/area/template_noop)
"y" = (/obj/structure/flora/ausbushes/ywflowers,/turf/simulated/floor/grass,/area/template_noop)
"B" = (/obj/effect/floor_decal/industrial/warning,/obj/item/stool/padded,/obj/effect/decal/cleanable/dirt,/turf/simulated/floor/tiled/steel_grid,/area/template_noop)
"C" = (/obj/effect/floor_decal/spline/fancy/wood{dir = 4},/obj/machinery/light/small{dir = 4},/turf/simulated/floor/grass,/area/template_noop)
"E" = (/obj/structure/catwalk,/obj/machinery/atmospherics/pipe/simple/hidden/scrubbers{dir = 8},/obj/machinery/atmospherics/pipe/simple/hidden/supply{dir = 4},/obj/structure/cable/green{d1 = 4; d2 = 8; icon_state = "4-8"},/turf/simulated/floor/plating,/area/template_noop)
"F" = (/obj/structure/catwalk,/obj/machinery/atmospherics/pipe/simple/hidden/scrubbers,/obj/machinery/atmospherics/pipe/simple/hidden/supply,/obj/structure/cable/green{d1 = 1; d2 = 2; icon_state = "1-2"},/turf/simulated/floor/plating,/area/template_noop)
"G" = (/obj/effect/floor_decal/industrial/warning{dir = 4},/obj/structure/holoplant{pixel_y = 8},/obj/machinery/light/small{dir = 1},/obj/effect/decal/cleanable/generic,/turf/simulated/floor/tiled/steel_grid,/area/template_noop)
"H" = (/obj/effect/floor_decal/spline/fancy/wood{dir = 6},/obj/structure/railing/mapped{dir = 4; icon_state = "railing0-1"},/obj/structure/railing/mapped,/turf/simulated/floor/grass,/area/template_noop)
"I" = (/obj/effect/floor_decal/industrial/warning{dir = 8},/obj/structure/holoplant{pixel_y = 8},/obj/machinery/light/small,/obj/effect/decal/cleanable/dirt,/turf/simulated/floor/tiled/steel_grid,/area/template_noop)
"J" = (/obj/effect/floor_decal/spline/fancy/wood{dir = 10},/obj/structure/railing/mapped,/obj/structure/railing/mapped{dir = 8; icon_state = "railing0-1"},/turf/simulated/floor/grass,/area/template_noop)
"K" = (/obj/effect/floor_decal/spline/fancy/wood{dir = 5},/obj/structure/flora/ausbushes/sparsegrass,/obj/structure/railing/mapped{dir = 4; icon_state = "railing0-1"},/obj/structure/railing/mapped{dir = 4; icon_state = "railing0-1"},/obj/structure/railing/mapped{dir = 4; icon_state = "railing0-1"},/obj/structure/railing/mapped{dir = 1; icon_state = "railing0-1"},/turf/simulated/floor/grass,/area/template_noop)
"L" = (/obj/effect/floor_decal/spline/fancy/wood{dir = 8},/obj/machinery/light/small{dir = 8},/turf/simulated/floor/grass,/area/template_noop)
"M" = (/obj/effect/floor_decal/spline/fancy/wood{dir = 9},/obj/structure/railing/mapped{dir = 8; icon_state = "railing0-1"},/obj/structure/railing/mapped{dir = 1; icon_state = "railing0-1"},/turf/simulated/floor/grass,/area/template_noop)
"N" = (/obj/structure/catwalk,/obj/structure/cable/green{d1 = 4; d2 = 8; icon_state = "4-8"},/obj/structure/cable/green{d1 = 1; d2 = 4; icon_state = "1-4"},/obj/structure/cable/green{d1 = 1; d2 = 8; icon_state = "1-8"},/obj/structure/cable/green{d1 = 2; d2 = 4; icon_state = "2-4"},/obj/structure/cable/green{d1 = 2; d2 = 8; icon_state = "2-8"},/obj/machinery/atmospherics/pipe/manifold4w/hidden/scrubbers,/obj/machinery/atmospherics/pipe/manifold4w/hidden/supply,/turf/simulated/floor/plating,/area/template_noop)
"O" = (/obj/effect/floor_decal/spline/fancy/wood{dir = 6},/obj/structure/railing/mapped,/obj/structure/railing/mapped{dir = 4; icon_state = "railing0-1"},/turf/simulated/floor/grass,/area/template_noop)
"P" = (/obj/effect/floor_decal/spline/fancy/wood{dir = 1},/obj/structure/flora/ausbushes/ywflowers,/obj/structure/railing/mapped{dir = 1; icon_state = "railing0-1"},/turf/simulated/floor/grass,/area/template_noop)
"Q" = (/obj/effect/floor_decal/industrial/warning,/obj/item/stool/padded,/turf/simulated/floor/tiled/steel_grid,/area/template_noop)
"R" = (/obj/effect/floor_decal/spline/fancy/wood{dir = 1},/obj/structure/flora/ausbushes/ppflowers,/obj/structure/railing/mapped{dir = 1; icon_state = "railing0-1"},/turf/simulated/floor/grass,/area/template_noop)
"T" = (/obj/effect/floor_decal/industrial/warning{dir = 1},/obj/item/stool/padded,/turf/simulated/floor/tiled/steel_grid,/area/template_noop)
"U" = (/obj/structure/flora/ausbushes/sparsegrass,/turf/simulated/floor/grass,/area/template_noop)
"W" = (/obj/effect/floor_decal/industrial/warning{dir = 10},/obj/effect/decal/cleanable/dirt,/obj/effect/decal/cleanable/dirt,/obj/effect/decal/cleanable/dirt,/turf/simulated/floor/tiled/steel_grid,/area/template_noop)
"X" = (/obj/effect/floor_decal/spline/fancy/wood{dir = 5},/obj/structure/railing/mapped{dir = 1; icon_state = "railing0-1"},/obj/structure/railing/mapped{dir = 4; icon_state = "railing0-1"},/turf/simulated/floor/grass,/area/template_noop)
"Y" = (/obj/structure/flora/ausbushes/pointybush,/turf/simulated/floor/grass,/area/template_noop)
"Z" = (/obj/effect/floor_decal/spline/fancy/wood{dir = 10},/obj/structure/flora/ausbushes/ywflowers,/obj/structure/railing/mapped{dir = 8; icon_state = "railing0-1"},/obj/structure/railing/mapped,/turf/simulated/floor/grass,/area/template_noop)

(1,1,1) = {"
LUqwGthJxYu
ZgOBmFWQbgH
EEEEENEEEEE
MRXTntjTsPK
axUXlpIsyyC
"}
