"a" = (/obj/effect/floor_decal/industrial/warning{dir = 4},/turf/simulated/floor/tiled/techfloor,/area/space)
"c" = (/obj/structure/catwalk,/obj/machinery/firealarm{pixel_y = 13},/obj/random/trash,/turf/simulated/floor/plating,/area/space)
"e" = (/obj/effect/floor_decal/industrial/warning{dir = 8},/turf/simulated/floor/tiled/techfloor,/area/space)
"g" = (/obj/structure/catwalk,/obj/machinery/atmospherics/pipe/simple/hidden/scrubbers{dir = 8},/obj/structure/cable/green{d1 = 4; d2 = 8; icon_state = "4-8"},/obj/machinery/atmospherics/pipe/simple/hidden/supply{dir = 4},/turf/simulated/floor/plating,/area/space)
"h" = (/obj/effect/floor_decal/techfloor,/obj/structure/filingcabinet,/obj/structure/filingcabinet{pixel_x = -10},/obj/structure/filingcabinet{pixel_x = 10},/obj/effect/decal/cleanable/dirt,/turf/simulated/floor/tiled/techfloor/grid,/area/space)
"i" = (/obj/effect/floor_decal/techfloor{dir = 5},/obj/structure/filingcabinet,/obj/structure/filingcabinet{pixel_x = -10},/obj/structure/filingcabinet{pixel_x = 10},/obj/machinery/light/small{dir = 1},/turf/simulated/floor/tiled/techfloor/grid,/area/space)
"j" = (/obj/effect/floor_decal/techfloor{dir = 4; icon_state = "techfloor_edges"},/obj/structure/filingcabinet,/obj/structure/filingcabinet{pixel_x = 10},/turf/simulated/floor/tiled/techfloor/grid,/area/space)
"k" = (/obj/effect/floor_decal/techfloor{dir = 1; icon_state = "techfloor_edges"},/obj/item/stool/wood,/turf/simulated/floor/tiled/techfloor/grid,/area/space)
"l" = (/obj/effect/floor_decal/industrial/warning{dir = 9},/turf/simulated/floor/tiled/techfloor,/area/space)
"n" = (/obj/effect/floor_decal/techfloor{dir = 4; icon_state = "techfloor_edges"},/obj/structure/filingcabinet,/obj/structure/filingcabinet{pixel_x = -10},/obj/structure/filingcabinet{pixel_x = 10},/turf/simulated/floor/tiled/techfloor/grid,/area/space)
"o" = (/obj/effect/floor_decal/industrial/warning,/obj/structure/table/standard,/obj/item/reagent_containers/food/drinks/bottle/specialwhiskey{pixel_x = 7; pixel_y = 15},/obj/item/deck/cards{pixel_x = -5},/obj/item/material/ashtray/plastic{pixel_x = 6; pixel_y = 2},/obj/effect/decal/cleanable/dirt,/turf/simulated/floor/tiled/techfloor,/area/space)
"p" = (/obj/structure/catwalk,/turf/simulated/floor/plating,/area/space)
"r" = (/obj/effect/floor_decal/industrial/warning{dir = 1},/obj/structure/filingcabinet,/obj/structure/filingcabinet{pixel_x = -10},/obj/structure/filingcabinet{pixel_x = 10},/turf/simulated/floor/tiled/techfloor,/area/space)
"t" = (/obj/effect/floor_decal/industrial/warning,/turf/simulated/floor/tiled/techfloor,/area/space)
"u" = (/obj/effect/floor_decal/techfloor{dir = 1; icon_state = "techfloor_edges"},/obj/machinery/alarm{pixel_y = 24; req_access = newlist()},/obj/effect/decal/cleanable/dirt,/turf/simulated/floor/tiled/techfloor/grid,/area/space)
"v" = (/obj/effect/floor_decal/industrial/warning{dir = 6},/turf/simulated/floor/tiled/techfloor,/area/space)
"w" = (/obj/effect/floor_decal/industrial/warning{dir = 5},/turf/simulated/floor/tiled/techfloor,/area/space)
"y" = (/obj/effect/floor_decal/industrial/warning{dir = 1},/obj/effect/decal/cleanable/dirt,/turf/simulated/floor/tiled/techfloor,/area/space)
"B" = (/obj/effect/floor_decal/techfloor,/obj/machinery/light/small,/obj/random/trash,/obj/random/trash,/turf/simulated/floor/tiled/techfloor/grid,/area/space)
"D" = (/obj/effect/floor_decal/industrial/warning{dir = 1},/obj/structure/filingcabinet{pixel_x = -10},/turf/simulated/floor/tiled/techfloor,/area/space)
"E" = (/obj/structure/catwalk,/obj/effect/decal/cleanable/dirt,/turf/simulated/floor/plating,/area/space)
"G" = (/obj/structure/catwalk,/obj/machinery/atmospherics/pipe/simple/hidden/scrubbers{dir = 8},/obj/structure/cable/green{d1 = 4; d2 = 8; icon_state = "4-8"},/obj/machinery/atmospherics/pipe/simple/hidden/supply{dir = 4},/obj/effect/decal/cleanable/dirt,/turf/simulated/floor/plating,/area/space)
"H" = (/obj/effect/floor_decal/industrial/warning{dir = 8},/obj/effect/decal/cleanable/dirt,/obj/effect/decal/cleanable/dirt,/obj/effect/decal/cleanable/cobweb2,/turf/simulated/floor/tiled/techfloor,/area/space)
"J" = (/obj/effect/floor_decal/techfloor{dir = 1; icon_state = "techfloor_edges"},/obj/structure/filingcabinet,/obj/structure/filingcabinet{pixel_x = 10},/turf/simulated/floor/tiled/techfloor/grid,/area/space)
"K" = (/obj/effect/floor_decal/techfloor{dir = 6},/obj/structure/filingcabinet,/obj/structure/filingcabinet{pixel_x = -10},/obj/structure/filingcabinet{pixel_x = 10},/obj/machinery/light/small,/turf/simulated/floor/tiled/techfloor/grid,/area/space)
"L" = (/obj/effect/floor_decal/techfloor{dir = 1; icon_state = "techfloor_edges"},/obj/machinery/light/small{dir = 1},/turf/simulated/floor/tiled/techfloor/grid,/area/space)
"M" = (/obj/effect/floor_decal/industrial/warning,/obj/item/stool/wood,/turf/simulated/floor/tiled/techfloor,/area/space)
"P" = (/obj/effect/floor_decal/industrial/warning,/obj/item/stool/wood,/obj/effect/decal/cleanable/dirt,/turf/simulated/floor/tiled/techfloor,/area/space)
"Q" = (/obj/effect/floor_decal/techfloor{dir = 10},/obj/structure/filingcabinet,/obj/structure/filingcabinet{pixel_x = -10},/obj/structure/filingcabinet{pixel_x = 10},/obj/machinery/light/small,/turf/simulated/floor/tiled/techfloor/grid,/area/space)
"R" = (/obj/effect/floor_decal/industrial/warning,/obj/structure/filingcabinet,/obj/structure/filingcabinet{pixel_x = 10},/turf/simulated/floor/tiled/techfloor,/area/space)
"S" = (/obj/effect/floor_decal/techfloor,/obj/structure/filingcabinet,/obj/structure/filingcabinet{pixel_x = -10},/obj/structure/filingcabinet{pixel_x = 10},/turf/simulated/floor/tiled/techfloor/grid,/area/space)
"T" = (/obj/effect/floor_decal/techfloor{dir = 8; icon_state = "techfloor_edges"},/obj/structure/filingcabinet,/obj/structure/filingcabinet{pixel_x = -10},/obj/structure/filingcabinet{pixel_x = 10},/turf/simulated/floor/tiled/techfloor/grid,/area/space)
"W" = (/obj/effect/floor_decal/industrial/warning{dir = 4},/obj/effect/decal/cleanable/dirt,/turf/simulated/floor/tiled/techfloor,/area/space)
"X" = (/obj/effect/floor_decal/industrial/warning{dir = 10},/turf/simulated/floor/tiled/techfloor,/area/space)
"Y" = (/obj/effect/floor_decal/techfloor{dir = 9},/obj/structure/filingcabinet,/obj/structure/filingcabinet{pixel_x = -10},/obj/machinery/light/small{dir = 1},/turf/simulated/floor/tiled/techfloor/grid,/area/space)
"Z" = (/obj/effect/floor_decal/techfloor{dir = 1; icon_state = "techfloor_edges"},/turf/simulated/floor/tiled/techfloor/grid,/area/space)

(1,1,1) = {"
WYcuJLkZpiH
vTEtRMoPpnX
gGggGgggggg
wTpDryrrEjl
aQEhSBhhpKe
"}
