"a" = (/obj/effect/floor_decal/industrial/warning{dir = 4},/obj/structure/railing/mapped{dir = 4; icon_state = "railing0-1"},/turf/simulated/floor/tiled/techfloor/grid,/area/space)
"b" = (/obj/effect/floor_decal/industrial/hatch/yellow,/obj/structure/ore_box,/turf/simulated/floor/tiled/steel_ridged,/area/space)
"i" = (/obj/effect/wallframe_spawn/reinforced/no_grille,/turf/simulated/floor/plating,/area/space)
"j" = (/obj/machinery/computer/mining,/turf/simulated/wall/r_wall,/area/space)
"m" = (/obj/effect/floor_decal/industrial/warning,/turf/simulated/floor/tiled/techfloor/grid,/area/space)
"n" = (/obj/effect/floor_decal/industrial/outline/yellow,/obj/item/pickaxe/drill{pixel_x = -3; pixel_y = 18},/turf/simulated/floor/tiled/steel_ridged,/area/space)
"p" = (/obj/effect/floor_decal/industrial/hatch/yellow,/turf/simulated/floor/tiled/steel_ridged,/area/space)
"q" = (/obj/effect/floor_decal/industrial/warning{dir = 8},/obj/effect/floor_decal/industrial/warning{dir = 4},/obj/structure/railing/mapped{dir = 8; icon_state = "railing0-1"},/obj/structure/railing/mapped{dir = 4; icon_state = "railing0-1"},/turf/simulated/floor/tiled/steel_grid,/area/space)
"s" = (/obj/structure/catwalk,/obj/structure/ore_box,/obj/machinery/atmospherics/pipe/simple/hidden/supply{dir = 4},/obj/machinery/atmospherics/pipe/simple/hidden/scrubbers{dir = 8},/obj/structure/cable/green{d1 = 4; d2 = 8; icon_state = "4-8"},/turf/simulated/floor/plating,/area/space)
"t" = (/obj/effect/floor_decal/industrial/outline/yellow,/obj/structure/closet/crate/large,/obj/random/junkyard/material,/obj/random/junkyard/material,/obj/random/junkyard/material,/turf/simulated/floor/tiled/steel_ridged,/area/space)
"u" = (/obj/machinery/conveyor_switch/oneway{id = "cs_mining"; name = "mining conveyor"},/obj/effect/floor_decal/industrial/warning{dir = 8},/obj/effect/floor_decal/industrial/warning{dir = 4},/obj/structure/railing/mapped{dir = 8; icon_state = "railing0-1"},/obj/structure/railing/mapped{dir = 4; icon_state = "railing0-1"},/obj/machinery/light/small,/turf/simulated/floor/tiled/steel_grid,/area/space)
"v" = (/turf/simulated/wall/r_wall,/area/space)
"w" = (/obj/effect/floor_decal/industrial/outline/yellow,/turf/simulated/floor/plating,/area/space)
"x" = (/obj/machinery/conveyor{dir = 4; id = "cs_mining"},/turf/simulated/floor/plating,/area/space)
"C" = (/obj/effect/floor_decal/industrial/warning{dir = 9},/obj/structure/railing/mapped{dir = 8; icon_state = "railing0-1"},/turf/simulated/floor/tiled/techfloor/grid,/area/space)
"D" = (/obj/effect/floor_decal/industrial/outline/yellow,/obj/machinery/light/small,/turf/simulated/floor/tiled/steel_ridged,/area/space)
"F" = (/obj/effect/floor_decal/industrial/outline/yellow,/obj/machinery/firealarm{pixel_y = 13},/turf/simulated/floor/tiled/techfloor/grid,/area/space)
"G" = (/obj/machinery/mineral/unloading_machine,/obj/effect/floor_decal/industrial/hatch/yellow,/turf/simulated/floor/plating,/area/space)
"I" = (/obj/effect/floor_decal/industrial/outline/yellow,/turf/simulated/floor/tiled/techfloor/grid,/area/space)
"K" = (/obj/effect/floor_decal/industrial/outline/yellow,/obj/structure/closet/crate/large,/turf/simulated/floor/tiled/steel_ridged,/area/space)
"L" = (/obj/structure/catwalk,/obj/machinery/atmospherics/pipe/simple/hidden/supply{dir = 4},/obj/machinery/atmospherics/pipe/simple/hidden/scrubbers{dir = 8},/obj/structure/cable/green{d1 = 4; d2 = 8; icon_state = "4-8"},/turf/simulated/floor/plating,/area/space)
"M" = (/obj/effect/floor_decal/industrial/warning{dir = 5},/obj/structure/railing/mapped{dir = 4; icon_state = "railing0-1"},/turf/simulated/floor/tiled/techfloor/grid,/area/space)
"O" = (/obj/machinery/mineral/processing_unit{input_turf = 8; output_turf = 4},/obj/effect/floor_decal/industrial/hatch/yellow,/obj/machinery/light/small/red{dir = 1},/turf/simulated/floor/plating,/area/space)
"Q" = (/obj/structure/catwalk,/obj/machinery/atmospherics/pipe/simple/hidden/supply{dir = 4},/obj/machinery/atmospherics/pipe/simple/hidden/scrubbers{dir = 8},/obj/structure/cable/green{d1 = 4; d2 = 8; icon_state = "4-8"},/obj/machinery/alarm{pixel_y = 24; req_access = newlist()},/turf/simulated/floor/plating,/area/space)
"S" = (/obj/effect/floor_decal/industrial/warning{dir = 8},/obj/structure/railing/mapped{dir = 8; icon_state = "railing0-1"},/turf/simulated/floor/tiled/techfloor/grid,/area/space)
"T" = (/obj/machinery/mineral/stacking_machine{input_turf = 8; output_turf = 4},/obj/effect/floor_decal/industrial/hatch/yellow,/turf/simulated/floor/plating,/area/space)
"V" = (/obj/effect/floor_decal/industrial/outline/yellow,/turf/simulated/floor/tiled/steel_ridged,/area/space)
"X" = (/obj/effect/floor_decal/industrial/outline/yellow,/obj/random/junkyard/tech_supply,/turf/simulated/floor/tiled/steel_ridged,/area/space)

(1,1,1) = {"
FGxxwOxwTxI
mvviijiijvm
LQLLsLLLLLL
MVbpXqnpbtC
aDpbVuKppDS
"}
