"a" = (/turf/simulated/floor/plating,/area/template_noop)
"c" = (/obj/random/junkyard/obstruction,/obj/machinery/light/small/red{dir = 8},/turf/simulated/floor/plating,/area/template_noop)
"d" = (/obj/random/junkyard/obstruction,/obj/structure/catwalk,/obj/machinery/atmospherics/pipe/simple/hidden/scrubbers,/obj/machinery/atmospherics/pipe/simple/hidden/supply,/obj/structure/cable/green{d1 = 1; d2 = 2; icon_state = "1-2"},/turf/simulated/floor/plating,/area/template_noop)
"e" = (/obj/machinery/light/small/red{dir = 4},/turf/simulated/floor/plating,/area/template_noop)
"j" = (/obj/random/junkyard/material,/obj/random/junkyard/tech_supply,/obj/random/junkyard/tech_supply,/obj/random/junkyard/tech_supply,/turf/simulated/floor/plating,/area/template_noop)
"k" = (/obj/random/junkyard/obstruction,/turf/simulated/floor/plating,/area/template_noop)
"m" = (/obj/effect/decal/cleanable/dirt,/turf/simulated/floor/plating,/area/template_noop)
"n" = (/obj/random/trash,/turf/simulated/floor/plating,/area/template_noop)
"q" = (/obj/structure/catwalk,/obj/machinery/atmospherics/pipe/simple/hidden/scrubbers,/obj/machinery/atmospherics/pipe/simple/hidden/supply,/obj/structure/cable/green{d1 = 1; d2 = 2; icon_state = "1-2"},/obj/random/trash,/obj/random/trash,/obj/random/trash,/turf/simulated/floor/plating,/area/template_noop)
"r" = (/obj/random/circuitboard,/obj/random/trash,/turf/simulated/floor/plating,/area/template_noop)
"v" = (/obj/structure/catwalk,/obj/machinery/atmospherics/pipe/simple/hidden/scrubbers,/obj/machinery/atmospherics/pipe/simple/hidden/supply,/obj/structure/cable/green{d1 = 1; d2 = 2; icon_state = "1-2"},/obj/effect/decal/cleanable/dirt,/turf/simulated/floor/plating,/area/template_noop)
"y" = (/obj/structure/catwalk,/obj/machinery/atmospherics/pipe/simple/hidden/scrubbers,/obj/machinery/atmospherics/pipe/simple/hidden/supply,/obj/structure/cable/green{d1 = 1; d2 = 2; icon_state = "1-2"},/obj/random/junkyard/tech_supply,/turf/simulated/floor/plating,/area/template_noop)
"B" = (/obj/structure/catwalk,/obj/machinery/atmospherics/pipe/simple/hidden/scrubbers,/obj/machinery/atmospherics/pipe/simple/hidden/supply,/obj/structure/cable/green{d1 = 1; d2 = 2; icon_state = "1-2"},/obj/random/junkyard/material,/obj/random/junkyard/tool,/turf/simulated/floor/plating,/area/template_noop)
"C" = (/obj/structure/catwalk,/obj/machinery/atmospherics/pipe/simple/hidden/scrubbers,/obj/machinery/atmospherics/pipe/simple/hidden/supply,/obj/structure/cable/green{d1 = 1; d2 = 2; icon_state = "1-2"},/turf/simulated/floor/plating,/area/template_noop)
"E" = (/obj/random/junkyard/obstruction,/obj/structure/catwalk,/obj/machinery/atmospherics/pipe/simple/hidden/scrubbers{dir = 4},/obj/machinery/atmospherics/pipe/simple/hidden/supply{dir = 4},/obj/structure/cable/green{d1 = 4; d2 = 8; icon_state = "4-8"},/obj/effect/decal/cleanable/dirt,/obj/effect/decal/cleanable/dirt,/turf/simulated/floor/plating,/area/template_noop)
"G" = (/obj/random/junkyard/obstruction,/obj/effect/decal/cleanable/dirt,/obj/effect/decal/cleanable/dirt,/turf/simulated/floor/plating,/area/template_noop)
"J" = (/obj/machinery/light/small/red{dir = 8},/obj/effect/decal/cleanable/dirt,/turf/simulated/floor/plating,/area/template_noop)
"K" = (/obj/random/junkyard/toolbox,/obj/random/junkyard/bomb_supply,/obj/effect/decal/cleanable/dirt,/obj/effect/decal/cleanable/dirt,/turf/simulated/floor/plating,/area/template_noop)
"M" = (/obj/random/junkyard/obstruction,/obj/structure/catwalk,/obj/machinery/atmospherics/pipe/simple/hidden/scrubbers{dir = 4},/obj/machinery/atmospherics/pipe/simple/hidden/supply{dir = 4},/obj/structure/cable/green{d1 = 4; d2 = 8; icon_state = "4-8"},/turf/simulated/floor/plating,/area/template_noop)
"N" = (/obj/effect/decal/cleanable/dirt,/obj/random/trash,/obj/random/trash,/turf/simulated/floor/plating,/area/template_noop)
"P" = (/obj/structure/catwalk,/obj/machinery/atmospherics/pipe/manifold4w/hidden/supply,/obj/machinery/atmospherics/pipe/manifold4w/hidden/scrubbers,/obj/structure/cable/green{d1 = 1; d2 = 2; icon_state = "1-2"},/obj/structure/cable/green{d1 = 2; d2 = 4; icon_state = "2-4"},/obj/structure/cable/green{d1 = 2; d2 = 8; icon_state = "2-8"},/obj/structure/cable/green{d1 = 1; d2 = 4; icon_state = "1-4"},/obj/structure/cable/green{d1 = 1; d2 = 8; icon_state = "1-8"},/turf/simulated/floor/plating,/area/template_noop)
"R" = (/obj/random/junkyard/powercell,/obj/random/junkyard/tool,/turf/simulated/floor/plating,/area/template_noop)
"U" = (/obj/structure/catwalk,/obj/machinery/atmospherics/pipe/simple/hidden/scrubbers{dir = 4},/obj/machinery/atmospherics/pipe/simple/hidden/supply{dir = 4},/obj/structure/cable/green{d1 = 4; d2 = 8; icon_state = "4-8"},/turf/simulated/floor/plating,/area/template_noop)
"W" = (/obj/effect/decal/cleanable/dirt,/obj/effect/decal/cleanable/dirt,/turf/simulated/floor/plating,/area/template_noop)
"X" = (/obj/random/junkyard/obstruction,/obj/effect/decal/cleanable/dirt,/turf/simulated/floor/plating,/area/template_noop)
"Z" = (/obj/machinery/light/small/red{dir = 4},/obj/random/junkyard/tech_supply,/turf/simulated/floor/plating,/area/template_noop)

(1,1,1) = {"
nmyaa
JkCRe
aaCkk
aadmr
jnCam
MEPUU
kGBWm
aWCXN
aWvXn
cKvkZ
akqam
"}
