"a" = (/turf/simulated/floor/plating,/area/space)
"d" = (/obj/machinery/atmospherics/pipe/simple/hidden/scrubbers{dir = 4},/obj/machinery/atmospherics/pipe/simple/hidden/supply{dir = 4},/obj/structure/cable/green{d1 = 4; d2 = 8; icon_state = "4-8"},/obj/structure/catwalk,/obj/effect/decal/cleanable/dirt,/turf/simulated/floor/plating,/area/space)
"h" = (/obj/effect/decal/cleanable/dirt,/obj/random/junkyard/tech_supply,/obj/random/junkyard/tech_supply,/turf/simulated/floor/plating,/area/space)
"s" = (/obj/machinery/atmospherics/pipe/simple/hidden/scrubbers{dir = 4},/obj/machinery/atmospherics/pipe/simple/hidden/supply{dir = 4},/obj/structure/cable/green{d1 = 4; d2 = 8; icon_state = "4-8"},/obj/structure/catwalk,/obj/effect/decal/cleanable/dirt,/obj/effect/decal/cleanable/dirt,/turf/simulated/floor/plating,/area/space)
"t" = (/obj/random/trash,/obj/random/trash,/obj/random/junkyard/powercell,/turf/simulated/floor/plating,/area/space)
"A" = (/obj/machinery/atmospherics/pipe/simple/hidden/scrubbers{dir = 4},/obj/machinery/atmospherics/pipe/simple/hidden/supply{dir = 4},/obj/structure/cable/green{d1 = 4; d2 = 8; icon_state = "4-8"},/obj/structure/catwalk,/turf/simulated/floor/plating,/area/space)
"F" = (/obj/effect/decal/cleanable/dirt,/turf/simulated/floor/plating,/area/space)
"G" = (/obj/random/junkyard/obstruction,/turf/simulated/floor/plating,/area/space)
"H" = (/obj/machinery/atmospherics/pipe/simple/hidden/scrubbers{dir = 4},/obj/machinery/atmospherics/pipe/simple/hidden/supply{dir = 4},/obj/structure/cable/green{d1 = 4; d2 = 8; icon_state = "4-8"},/obj/structure/catwalk,/obj/effect/decal/cleanable/dirt,/obj/effect/decal/cleanable/dirt,/obj/random/trash,/obj/random/trash,/turf/simulated/floor/plating,/area/space)
"Q" = (/obj/effect/decal/cleanable/dirt,/obj/random/trash,/turf/simulated/floor/plating,/area/space)
"R" = (/obj/effect/decal/cleanable/dirt,/obj/effect/decal/cleanable/dirt,/turf/simulated/floor/plating,/area/space)
"U" = (/obj/random/trash,/obj/random/junkyard/tool,/obj/random/junkyard/tool,/turf/simulated/floor/plating,/area/space)
"V" = (/obj/random/junkyard/obstruction,/obj/effect/decal/cleanable/dirt,/turf/simulated/floor/plating,/area/space)
"W" = (/obj/random/junkyard/material,/obj/random/junkyard/material,/obj/random/junkyard/tech_supply,/turf/simulated/floor/plating,/area/space)
"Y" = (/obj/random/trash,/turf/simulated/floor/plating,/area/space)
"Z" = (/obj/effect/decal/cleanable/dirt,/obj/random/junkyard/bomb_supply,/turf/simulated/floor/plating,/area/space)

(1,1,1) = {"
YZaaaGGGFRa
GVUaaVGWRQa
AAAAAsddHdA
GtaGFRQFFFG
aGGGVFaaFhQ
"}
