"a" = (/obj/structure/catwalk,/obj/machinery/atmospherics/pipe/simple/hidden/supply{dir = 5},/turf/simulated/floor/plating,/area/template_noop)
"b" = (/obj/structure/catwalk,/obj/effect/decal/cleanable/dirt,/obj/machinery/atmospherics/pipe/simple/hidden/scrubbers{dir = 6},/turf/simulated/floor/plating,/area/template_noop)
"c" = (/obj/effect/floor_decal/industrial/warning{dir = 4},/obj/effect/floor_decal/borderfloor{dir = 8},/obj/machinery/atmospherics/pipe/simple/hidden/scrubbers,/turf/simulated/floor/tiled/techfloor,/area/template_noop)
"d" = (/obj/structure/catwalk,/obj/machinery/atmospherics/pipe/simple/hidden/scrubbers{dir = 8},/obj/random/trash,/turf/simulated/floor/plating,/area/template_noop)
"e" = (/obj/effect/floor_decal/industrial/outline/yellow,/obj/structure/railing/mapped,/obj/structure/closet/crate,/turf/simulated/floor/tiled/steel_ridged,/area/template_noop)
"f" = (/obj/structure/catwalk,/obj/effect/decal/cleanable/dirt,/obj/effect/decal/cleanable/dirt,/obj/machinery/atmospherics/pipe/simple/hidden/supply{dir = 4},/turf/simulated/floor/plating,/area/template_noop)
"g" = (/obj/effect/floor_decal/industrial/warning{dir = 4},/obj/effect/floor_decal/borderfloorblack{dir = 8},/turf/simulated/floor/tiled/techfloor,/area/template_noop)
"h" = (/obj/effect/floor_decal/industrial/warning{dir = 8},/obj/effect/floor_decal/borderfloorblack{dir = 4},/obj/structure/cable/green{d1 = 4; d2 = 8; icon_state = "4-8"},/obj/random/trash,/turf/simulated/floor/tiled/techfloor,/area/template_noop)
"i" = (/obj/effect/floor_decal/industrial/outline/yellow,/obj/effect/decal/cleanable/dirt,/turf/simulated/floor/tiled/steel_ridged,/area/template_noop)
"j" = (/obj/structure/catwalk,/obj/structure/railing/mapped,/obj/machinery/atmospherics/pipe/simple/hidden/scrubbers{dir = 8},/obj/structure/reagent_dispensers/fueltank,/turf/simulated/floor/plating,/area/template_noop)
"k" = (/obj/effect/floor_decal/industrial/outline/yellow,/obj/structure/railing/mapped,/obj/structure/closet,/turf/simulated/floor/tiled/steel_ridged,/area/template_noop)
"l" = (/obj/structure/catwalk,/obj/machinery/atmospherics/pipe/simple/hidden/supply{dir = 4},/turf/simulated/floor/plating,/area/template_noop)
"m" = (/obj/structure/catwalk,/obj/machinery/light/small/red,/obj/machinery/atmospherics/pipe/simple/hidden/supply{dir = 4},/turf/simulated/floor/plating,/area/template_noop)
"n" = (/obj/effect/floor_decal/industrial/warning{dir = 8},/obj/effect/floor_decal/borderfloor{dir = 4},/obj/machinery/atmospherics/pipe/simple/hidden/scrubbers{dir = 5},/obj/machinery/atmospherics/pipe/simple/hidden/supply{dir = 6},/obj/structure/cable/green{d1 = 4; d2 = 8; icon_state = "4-8"},/turf/simulated/floor/tiled/techfloor,/area/template_noop)
"o" = (/obj/effect/floor_decal/industrial/warning{dir = 4},/obj/effect/floor_decal/borderfloor{dir = 8},/obj/effect/decal/cleanable/dirt,/obj/effect/decal/cleanable/dirt,/obj/machinery/atmospherics/pipe/simple/hidden/scrubbers{dir = 9},/obj/machinery/atmospherics/pipe/simple/hidden/supply{dir = 10},/obj/structure/cable/green{d1 = 4; d2 = 8; icon_state = "4-8"},/turf/simulated/floor/tiled/techfloor,/area/template_noop)
"p" = (/obj/effect/floor_decal/industrial/warning{dir = 8},/obj/effect/floor_decal/borderfloor{dir = 4},/obj/machinery/atmospherics/pipe/simple/hidden/scrubbers,/turf/simulated/floor/tiled/techfloor,/area/template_noop)
"q" = (/obj/effect/floor_decal/industrial/warning{dir = 8},/obj/effect/floor_decal/borderfloorblack{dir = 4},/obj/structure/closet/crate/plastic,/turf/simulated/floor/tiled/techfloor,/area/template_noop)
"r" = (/obj/structure/catwalk,/obj/effect/decal/cleanable/dirt,/obj/machinery/light/small/red,/obj/machinery/atmospherics/pipe/simple/hidden/supply{dir = 4},/turf/simulated/floor/plating,/area/template_noop)
"s" = (/obj/effect/floor_decal/industrial/warning{dir = 4},/obj/effect/floor_decal/borderfloor{dir = 8},/obj/effect/decal/cleanable/dirt,/obj/machinery/atmospherics/pipe/simple/hidden/supply,/obj/random/trash,/obj/random/trash,/turf/simulated/floor/tiled/techfloor,/area/template_noop)
"t" = (/obj/effect/floor_decal/industrial/outline/yellow,/obj/structure/cable/green{d1 = 4; d2 = 8; icon_state = "4-8"},/obj/structure/closet/crate/secure/gear,/turf/simulated/floor/tiled/steel_ridged,/area/template_noop)
"u" = (/obj/structure/catwalk,/obj/structure/railing/mapped,/obj/machinery/atmospherics/pipe/simple/hidden/scrubbers{dir = 8},/obj/machinery/firealarm{pixel_y = 13},/turf/simulated/floor/plating,/area/template_noop)
"v" = (/obj/effect/floor_decal/industrial/warning{dir = 4},/obj/effect/floor_decal/borderfloorblack{dir = 8},/obj/structure/cable/green{d1 = 4; d2 = 8; icon_state = "4-8"},/obj/structure/reagent_dispensers/fueltank,/turf/simulated/floor/tiled/techfloor,/area/template_noop)
"w" = (/obj/effect/floor_decal/industrial/outline/yellow,/obj/effect/decal/cleanable/dirt,/obj/structure/cable/green{d1 = 4; d2 = 8; icon_state = "4-8"},/obj/structure/closet,/turf/simulated/floor/tiled/steel_ridged,/area/template_noop)
"x" = (/obj/structure/catwalk,/obj/structure/railing/mapped,/obj/machinery/atmospherics/pipe/simple/hidden/scrubbers{dir = 8},/turf/simulated/floor/plating,/area/template_noop)
"y" = (/obj/effect/floor_decal/industrial/outline/yellow,/obj/structure/table/rack,/obj/random/trash,/obj/random/junkyard/powercell,/turf/simulated/floor/tiled/steel_ridged,/area/template_noop)
"z" = (/obj/effect/floor_decal/industrial/warning{dir = 8},/obj/effect/floor_decal/borderfloorblack{dir = 4},/obj/structure/closet/crate/medical,/turf/simulated/floor/tiled/techfloor,/area/template_noop)
"A" = (/obj/effect/floor_decal/industrial/outline/yellow,/obj/structure/railing/mapped,/obj/structure/table/rack,/obj/random/junkyard/smokes,/obj/random/junkyard/tool,/obj/random/junkyard/tool,/turf/simulated/floor/tiled/steel_ridged,/area/template_noop)
"B" = (/obj/effect/floor_decal/industrial/warning{dir = 8},/obj/effect/floor_decal/borderfloor{dir = 4},/obj/machinery/atmospherics/pipe/simple/hidden/supply,/turf/simulated/floor/tiled/techfloor,/area/template_noop)
"D" = (/obj/effect/floor_decal/industrial/outline/yellow,/obj/structure/railing/mapped,/obj/effect/decal/cleanable/dirt,/obj/structure/closet/crate,/obj/random/junkyard/material,/obj/random/junkyard/material,/obj/random/junkyard/material,/obj/random/junkyard/material,/turf/simulated/floor/tiled/steel_ridged,/area/template_noop)
"E" = (/obj/machinery/atmospherics/pipe/simple/hidden/supply{dir = 4},/obj/structure/catwalk,/turf/simulated/floor/plating,/area/template_noop)
"F" = (/obj/effect/floor_decal/industrial/warning{dir = 8},/obj/effect/floor_decal/borderfloorblack{dir = 4},/turf/simulated/floor/tiled/techfloor,/area/template_noop)
"G" = (/obj/structure/catwalk,/obj/machinery/atmospherics/pipe/simple/hidden/supply{dir = 4},/obj/structure/closet/crate/secure/weapon,/obj/random/junkyard/biggun,/obj/random/junkyard/biggun,/obj/random/junkyard/ammo,/obj/random/junkyard/ammo,/obj/random/junkyard/ammo,/obj/random/junkyard/ammo,/obj/random/junkyard/ammo,/obj/random/junkyard/ammo,/obj/random/junkyard/biggun,/turf/simulated/floor/plating,/area/template_noop)
"H" = (/obj/structure/catwalk,/obj/effect/decal/cleanable/dirt,/obj/machinery/atmospherics/pipe/simple/hidden/supply{dir = 9},/obj/random/trash,/obj/random/trash,/obj/random/trash,/turf/simulated/floor/plating,/area/template_noop)
"I" = (/obj/structure/catwalk,/obj/machinery/atmospherics/pipe/simple/hidden/scrubbers{dir = 10},/obj/structure/closet/crate/freezer,/obj/item/reagent_containers/ivbag/blood/OMinus,/obj/item/reagent_containers/ivbag/blood/OMinus,/obj/item/reagent_containers/ivbag/blood/OMinus,/obj/item/reagent_containers/ivbag/blood/OMinus,/turf/simulated/floor/plating,/area/template_noop)
"J" = (/obj/effect/floor_decal/industrial/outline/yellow,/obj/structure/closet,/obj/random/junkyard/tech_supply,/obj/random/junkyard/tech_supply,/obj/random/junkyard/tech_supply,/obj/random/junkyard/tech_supply,/obj/random/junkyard/tech_supply,/obj/random/junkyard/tech_supply,/obj/random/junkyard/tech_supply,/obj/random/junkyard/bomb_supply,/obj/random/junkyard/bomb_supply,/obj/random/junkyard/bomb_supply,/obj/random/junkyard/tech_supply,/obj/random/junkyard/tech_supply,/obj/random/junkyard/tech_supply,/obj/random/junkyard/bomb_supply,/turf/simulated/floor/tiled/steel_ridged,/area/template_noop)
"K" = (/obj/effect/floor_decal/industrial/outline/yellow,/obj/structure/railing/mapped,/obj/effect/decal/cleanable/dirt,/obj/structure/table/rack,/turf/simulated/floor/tiled/steel_ridged,/area/template_noop)
"L" = (/obj/effect/floor_decal/industrial/outline/yellow,/obj/structure/closet/crate/large,/turf/simulated/floor/tiled/steel_ridged,/area/template_noop)
"N" = (/obj/effect/floor_decal/industrial/outline/yellow,/obj/effect/decal/cleanable/dirt,/obj/structure/cable/green{d1 = 4; d2 = 8; icon_state = "4-8"},/turf/simulated/floor/tiled/steel_ridged,/area/template_noop)
"P" = (/obj/structure/catwalk,/obj/structure/railing/mapped,/obj/machinery/light/small/red{dir = 1},/obj/machinery/atmospherics/pipe/simple/hidden/scrubbers{dir = 8},/obj/structure/closet/crate/large,/obj/random/junkyard/loot,/obj/random/junkyard/loot,/obj/random/junkyard/loot,/obj/random/junkyard/loot,/obj/random/junkyard/loot,/obj/random/junkyard/loot,/obj/random/junkyard/loot,/obj/random/junkyard/loot,/obj/random/junkyard/loot,/obj/random/junkyard/loot,/obj/random/junkyard/loot,/obj/random/junkyard/loot,/obj/random/junkyard/loot,/obj/random/junkyard/loot,/obj/random/junkyard/loot,/turf/simulated/floor/plating,/area/template_noop)
"Q" = (/obj/machinery/alarm{pixel_y = 24; req_access = newlist()},/obj/machinery/atmospherics/pipe/simple/hidden/scrubbers{dir = 8},/obj/structure/catwalk,/turf/simulated/floor/plating,/area/template_noop)
"S" = (/obj/effect/floor_decal/industrial/outline/yellow,/obj/structure/cable/green{d1 = 4; d2 = 8; icon_state = "4-8"},/turf/simulated/floor/tiled/steel_ridged,/area/template_noop)
"T" = (/obj/effect/floor_decal/industrial/warning{dir = 4},/obj/effect/floor_decal/borderfloorblack{dir = 8},/obj/effect/decal/cleanable/dirt,/turf/simulated/floor/tiled/techfloor,/area/template_noop)
"U" = (/obj/effect/floor_decal/industrial/warning{dir = 4},/obj/effect/floor_decal/borderfloorblack{dir = 8},/obj/structure/cable/green{d1 = 4; d2 = 8; icon_state = "4-8"},/turf/simulated/floor/tiled/techfloor,/area/template_noop)
"V" = (/obj/effect/floor_decal/industrial/warning{dir = 8},/obj/effect/floor_decal/borderfloorblack{dir = 4},/obj/structure/cable/green{d1 = 4; d2 = 8; icon_state = "4-8"},/obj/effect/decal/cleanable/generic,/turf/simulated/floor/tiled/techfloor,/area/template_noop)
"W" = (/obj/effect/floor_decal/industrial/outline/yellow,/obj/structure/table/rack,/turf/simulated/floor/tiled/steel_ridged,/area/template_noop)
"X" = (/obj/machinery/atmospherics/pipe/simple/hidden/scrubbers{dir = 8},/obj/structure/catwalk,/turf/simulated/floor/plating,/area/template_noop)
"Y" = (/obj/structure/catwalk,/obj/machinery/atmospherics/pipe/simple/hidden/scrubbers{dir = 8},/turf/simulated/floor/plating,/area/template_noop)
"Z" = (/obj/structure/catwalk,/obj/structure/railing/mapped,/obj/effect/decal/cleanable/dirt,/obj/machinery/light/small/red{dir = 1},/obj/machinery/atmospherics/pipe/simple/hidden/scrubbers{dir = 8},/turf/simulated/floor/plating,/area/template_noop)

(1,1,1) = {"
bPuQXxYdjZI
cyWFgJqTiLp
oNSVUwhvtNn
sKAzTkFTDeB
arflEGlElmH
"}
