"a" = (/obj/effect/floor_decal/borderfloor{dir = 4},/obj/structure/railing/mapped{dir = 4; icon_state = "railing0-1"},/turf/simulated/floor/tiled/techfloor/grid,/area/space)
"b" = (/obj/effect/floor_decal/borderfloor{dir = 4},/obj/structure/railing/mapped{dir = 4; icon_state = "railing0-1"},/obj/random/junkyard/smokes,/obj/random/trash,/turf/simulated/floor/tiled/techfloor/grid,/area/space)
"c" = (/obj/effect/floor_decal/industrial/warning/fulltile,/obj/structure/reagent_dispensers/fueltank,/obj/structure/cable/green{d1 = 4; d2 = 8; icon_state = "4-8"},/turf/simulated/floor/tiled/techfloor,/area/space)
"d" = (/obj/effect/floor_decal/industrial/warning{dir = 9},/obj/effect/decal/cleanable/dirt,/obj/effect/decal/cleanable/dirt,/obj/structure/table/rack,/obj/random/junkyard/material,/obj/random/junkyard/material,/obj/random/junkyard/material,/obj/random/junkyard/material,/obj/random/circuitboard{spawn_nothing_percentage = 50},/obj/random/circuitboard{spawn_nothing_percentage = 50},/turf/simulated/floor/tiled/techfloor,/area/space)
"e" = (/obj/effect/floor_decal/industrial/warning/fulltile,/obj/structure/closet/crate/radiation_gear,/obj/effect/decal/cleanable/dirt,/obj/effect/decal/cleanable/dirt,/obj/structure/cable/green{d1 = 4; d2 = 8; icon_state = "4-8"},/obj/random/trash,/turf/simulated/floor/tiled/techfloor,/area/space)
"f" = (/obj/structure/catwalk,/obj/structure/railing/mapped,/obj/effect/decal/cleanable/dirt,/obj/machinery/atmospherics/pipe/simple/hidden/scrubbers{dir = 8},/obj/machinery/atmospherics/pipe/simple/hidden/supply{dir = 4},/turf/simulated/floor/plating,/area/space)
"g" = (/obj/effect/floor_decal/borderfloor{dir = 8},/obj/structure/railing/mapped{dir = 8; icon_state = "railing0-1"},/obj/structure/reagent_dispensers/watertank,/obj/effect/decal/cleanable/dirt,/turf/simulated/floor/tiled/techfloor/grid,/area/space)
"h" = (/obj/effect/floor_decal/industrial/outline/yellow,/obj/structure/closet,/obj/machinery/firealarm{pixel_y = 13},/obj/random/junkyard/bomb_supply,/obj/random/junkyard/loot,/turf/simulated/floor/tiled/techfloor/grid,/area/space)
"i" = (/obj/effect/floor_decal/industrial/outline/yellow,/obj/structure/closet/crate/large,/obj/random/junkyard/loot,/obj/random/junkyard/loot,/obj/random/junkyard/loot,/obj/random/junkyard/loot,/obj/random/junkyard/loot,/obj/random/junkyard/loot,/obj/random/junkyard/loot,/obj/random/junkyard/loot,/obj/random/junkyard/loot,/obj/random/junkyard/loot,/obj/random/junkyard/loot,/obj/random/junkyard/loot,/obj/random/junkyard/loot,/obj/random/junkyard/loot,/obj/random/junkyard/loot,/obj/random/contraband{spawn_nothing_percentage = 90},/turf/simulated/floor/tiled/techfloor/grid,/area/space)
"j" = (/obj/structure/catwalk,/obj/structure/railing/mapped{dir = 1; icon_state = "railing0-1"},/obj/machinery/atmospherics/pipe/simple/hidden/scrubbers{dir = 8},/obj/machinery/atmospherics/pipe/simple/hidden/supply{dir = 4},/obj/machinery/atmospherics/pipe/simple/hidden/supply{dir = 4},/turf/simulated/floor/plating,/area/space)
"k" = (/obj/structure/catwalk,/obj/machinery/atmospherics/pipe/manifold/hidden/scrubbers{dir = 4},/obj/machinery/atmospherics/pipe/manifold/hidden/supply{dir = 4},/obj/structure/cable/green{d1 = 4; d2 = 8; icon_state = "4-8"},/turf/simulated/floor/plating,/area/space)
"l" = (/obj/structure/catwalk,/obj/machinery/atmospherics/pipe/simple/hidden/scrubbers{dir = 8},/obj/machinery/atmospherics/pipe/simple/hidden/supply{dir = 4},/obj/structure/cable/green{d1 = 4; d2 = 8; icon_state = "4-8"},/turf/simulated/floor/plating,/area/space)
"n" = (/obj/effect/floor_decal/industrial/outline/yellow,/obj/structure/closet/toolcloset,/obj/effect/decal/cleanable/dirt,/obj/random/junkyard/tech_supply,/obj/random/junkyard/tech_supply,/obj/random/junkyard/tech_supply,/obj/random/junkyard/tech_supply,/obj/random/junkyard/tech_supply,/obj/random/junkyard/tech_supply,/obj/random/junkyard/toolbox,/obj/random/junkyard/toolbox,/obj/random/junkyard/tech_supply,/obj/random/junkyard/bomb_supply,/obj/random/junkyard/bomb_supply,/turf/simulated/floor/tiled/techfloor/grid,/area/space)
"o" = (/obj/structure/catwalk,/obj/structure/railing/mapped{dir = 1; icon_state = "railing0-1"},/obj/machinery/atmospherics/pipe/simple/hidden/scrubbers{dir = 8},/obj/machinery/atmospherics/pipe/simple/hidden/supply{dir = 4},/turf/simulated/floor/plating,/area/space)
"p" = (/obj/structure/catwalk,/obj/structure/catwalk,/obj/machinery/atmospherics/pipe/simple/hidden/supply{dir = 5},/obj/machinery/atmospherics/pipe/simple/hidden/scrubbers{dir = 5},/turf/simulated/floor/plating,/area/space)
"q" = (/obj/effect/floor_decal/industrial/outline/yellow,/turf/simulated/floor/tiled/techfloor/grid,/area/space)
"r" = (/obj/effect/floor_decal/industrial/warning{dir = 4},/obj/structure/ore_box,/obj/effect/decal/cleanable/dirt,/obj/machinery/light/small/red{dir = 1},/turf/simulated/floor/tiled/techfloor,/area/space)
"s" = (/obj/effect/floor_decal/borderfloor{dir = 4},/obj/structure/railing/mapped{dir = 4; icon_state = "railing0-1"},/obj/effect/decal/cleanable/dirt,/obj/structure/table/rack,/obj/random/junkyard/loot,/obj/random/junkyard/loot,/turf/simulated/floor/tiled/techfloor/grid,/area/space)
"t" = (/obj/effect/floor_decal/industrial/warning{dir = 10},/obj/effect/decal/cleanable/dirt,/obj/effect/decal/cleanable/dirt,/obj/effect/decal/cleanable/dirt,/obj/effect/decal/cleanable/dirt,/turf/simulated/floor/tiled/techfloor,/area/space)
"u" = (/obj/structure/catwalk,/obj/machinery/atmospherics/pipe/manifold4w/hidden/scrubbers,/obj/machinery/atmospherics/pipe/manifold4w/hidden/supply,/obj/structure/cable/green{d1 = 1; d2 = 2; icon_state = "1-2"},/turf/simulated/floor/plating,/area/space)
"v" = (/obj/structure/catwalk,/obj/machinery/atmospherics/pipe/manifold/hidden/scrubbers{dir = 8},/obj/machinery/atmospherics/pipe/manifold/hidden/supply{dir = 8},/obj/structure/cable/green{d1 = 4; d2 = 8; icon_state = "4-8"},/turf/simulated/floor/plating,/area/space)
"w" = (/obj/effect/floor_decal/industrial/warning{dir = 4; icon_state = "warning"},/obj/machinery/light/small/red,/obj/structure/table/rack,/turf/simulated/floor/tiled/techfloor,/area/space)
"x" = (/obj/structure/catwalk,/obj/structure/railing/mapped{dir = 1; icon_state = "railing0-1"},/obj/structure/closet/crate/secure/gear,/obj/machinery/atmospherics/pipe/simple/hidden/scrubbers{dir = 8},/obj/machinery/atmospherics/pipe/simple/hidden/supply{dir = 4},/obj/random/junkyard/biggun,/obj/random/junkyard/biggun,/obj/random/junkyard/biggun,/obj/random/junkyard/ammo,/obj/random/junkyard/ammo,/obj/random/junkyard/ammo,/obj/random/junkyard/ammo,/obj/random/junkyard/ammo,/turf/simulated/floor/plating,/area/space)
"y" = (/obj/effect/floor_decal/industrial/outline/yellow,/obj/structure/closet/crate/freezer,/obj/item/reagent_containers/ivbag/blood/AMinus,/obj/item/reagent_containers/ivbag/blood/AMinus,/obj/item/reagent_containers/ivbag/blood/BPlus,/obj/item/reagent_containers/ivbag/blood/BPlus,/obj/item/reagent_containers/ivbag/blood/OMinus,/obj/item/reagent_containers/ivbag/blood/AMinus,/obj/item/reagent_containers/ivbag/blood/AMinus,/obj/item/reagent_containers/ivbag/blood/OPlus,/obj/item/reagent_containers/ivbag/blood/OMinus,/obj/item/reagent_containers/ivbag/blood/OMinus,/obj/item/reagent_containers/ivbag/blood/APlus,/obj/item/reagent_containers/ivbag/blood/APlus,/obj/item/reagent_containers/ivbag/blood/APlus,/obj/item/reagent_containers/ivbag/blood/APlus,/obj/item/reagent_containers/ivbag/blood/APlus,/obj/item/reagent_containers/ivbag/blood/BMinus,/turf/simulated/floor/tiled/techfloor/grid,/area/space)
"z" = (/obj/effect/floor_decal/industrial/warning/fulltile,/obj/effect/decal/cleanable/dirt,/obj/structure/cable/green{d1 = 4; d2 = 8; icon_state = "4-8"},/turf/simulated/floor/tiled/techfloor,/area/space)
"A" = (/obj/effect/floor_decal/industrial/outline/yellow,/obj/structure/closet/crate/plastic,/obj/random/hat,/obj/random/hat,/obj/random/hat,/obj/random/hat,/obj/random/accessory,/obj/random/accessory,/obj/random/accessory,/obj/random/accessory,/obj/random/hat,/obj/random/clothing{spawn_nothing_percentage = 50},/obj/random/clothing{spawn_nothing_percentage = 50},/obj/random/clothing{spawn_nothing_percentage = 50},/obj/random/clothing{spawn_nothing_percentage = 50},/obj/random/accessory,/obj/random/accessory,/obj/random/accessory,/turf/simulated/floor/tiled/techfloor/grid,/area/space)
"B" = (/obj/structure/catwalk,/obj/structure/railing/mapped,/obj/machinery/atmospherics/pipe/simple/hidden/scrubbers{dir = 8},/obj/machinery/atmospherics/pipe/simple/hidden/supply{dir = 4},/turf/simulated/floor/plating,/area/space)
"C" = (/obj/effect/floor_decal/industrial/outline/yellow,/obj/structure/reagent_dispensers/fueltank,/turf/simulated/floor/tiled/techfloor/grid,/area/space)
"D" = (/obj/effect/floor_decal/industrial/outline/yellow,/obj/structure/closet/crate/medical,/obj/effect/decal/cleanable/dirt,/obj/effect/decal/cleanable/dirt,/obj/effect/decal/cleanable/dirt,/obj/random/junkyard/medical,/obj/random/junkyard/medical,/obj/random/junkyard/medical,/obj/random/junkyard/medical/lite,/obj/random/junkyard/medical/lite,/obj/random/junkyard/medical/lite,/obj/random/junkyard/medical/lite,/obj/random/junkyard/medical/lite,/obj/random/junkyard/medical/lite,/obj/random/junkyard/medical,/obj/random/junkyard/medical/lite,/obj/random/junkyard/medical/lite,/obj/random/junkyard/medical/lite,/turf/simulated/floor/tiled/techfloor/grid,/area/space)
"E" = (/obj/effect/floor_decal/borderfloor{dir = 8},/obj/structure/railing/mapped{dir = 8; icon_state = "railing0-1"},/obj/random/trash,/obj/random/trash,/turf/simulated/floor/tiled/techfloor/grid,/area/space)
"F" = (/obj/effect/floor_decal/industrial/warning{dir = 8},/obj/effect/decal/cleanable/dirt,/obj/machinery/light/small/red,/obj/structure/table/rack,/turf/simulated/floor/tiled/techfloor,/area/space)
"G" = (/obj/structure/catwalk,/obj/machinery/atmospherics/pipe/simple/hidden/supply{dir = 9},/obj/machinery/atmospherics/pipe/simple/hidden/scrubbers{dir = 9},/turf/simulated/floor/plating,/area/space)
"H" = (/obj/structure/catwalk,/obj/structure/railing/mapped,/obj/machinery/atmospherics/pipe/simple/hidden/scrubbers{dir = 8},/obj/machinery/atmospherics/pipe/simple/hidden/supply{dir = 4},/obj/machinery/atmospherics/pipe/simple/hidden/supply{dir = 4},/turf/simulated/floor/plating,/area/space)
"I" = (/obj/effect/floor_decal/industrial/outline/yellow,/obj/structure/closet/jcloset,/obj/effect/decal/cleanable/dirt,/obj/effect/decal/cleanable/generic,/turf/simulated/floor/tiled/techfloor/grid,/area/space)
"J" = (/obj/effect/floor_decal/industrial/outline/yellow,/obj/structure/closet,/obj/random/junkyard/advdevice,/obj/random/junkyard/advdevice,/obj/random/circuitboard{spawn_nothing_percentage = 50},/obj/random/circuitboard{spawn_nothing_percentage = 50},/obj/random/circuitboard{spawn_nothing_percentage = 50},/turf/simulated/floor/tiled/techfloor/grid,/area/space)
"K" = (/obj/effect/floor_decal/industrial/outline/yellow,/obj/structure/closet/emcloset,/obj/random/action_figure,/turf/simulated/floor/tiled/techfloor/grid,/area/space)
"L" = (/obj/structure/catwalk,/obj/effect/decal/cleanable/dirt,/obj/machinery/atmospherics/pipe/simple/hidden/supply,/obj/machinery/atmospherics/pipe/simple/hidden/scrubbers,/obj/structure/cable/green{d1 = 4; d2 = 8; icon_state = "4-8"},/obj/structure/cable/green{d1 = 1; d2 = 8; icon_state = "1-8"},/obj/structure/cable/green{d1 = 2; d2 = 4; icon_state = "2-4"},/obj/structure/cable/green{d1 = 1; d2 = 4; icon_state = "1-4"},/obj/structure/cable/green{d1 = 2; d2 = 8; icon_state = "2-8"},/turf/simulated/floor/plating,/area/space)
"M" = (/obj/structure/catwalk,/obj/structure/closet/crate/trashcart,/obj/effect/decal/cleanable/dirt,/obj/machinery/atmospherics/pipe/simple/hidden/supply{dir = 10},/obj/machinery/atmospherics/pipe/simple/hidden/scrubbers{dir = 10},/obj/random/junkyard/powercell,/obj/random/trash,/obj/random/trash,/obj/random/trash,/obj/random/trash,/obj/random/junkyard/bomb_supply,/obj/random/junkyard/toolbox,/obj/random/trash,/obj/random/trash,/obj/random/junkyard/lilgun,/obj/random/trash,/obj/random/trash,/obj/random/trash,/obj/random/relic,/obj/random/trash,/obj/random/trash,/obj/random/trash,/obj/random/trash,/obj/random/trash,/turf/simulated/floor/plating,/area/space)
"N" = (/obj/effect/floor_decal/industrial/warning{dir = 8},/obj/effect/decal/cleanable/dirt,/obj/machinery/light/small/red{dir = 1},/turf/simulated/floor/tiled/techfloor,/area/space)
"O" = (/obj/effect/floor_decal/industrial/warning{dir = 5},/obj/effect/decal/cleanable/dirt,/obj/effect/decal/cleanable/dirt,/obj/effect/decal/cleanable/generic,/turf/simulated/floor/tiled/techfloor,/area/space)
"P" = (/obj/effect/floor_decal/industrial/warning{dir = 6},/obj/random/trash,/turf/simulated/floor/tiled/techfloor,/area/space)
"Q" = (/obj/structure/catwalk,/obj/effect/decal/cleanable/dirt,/obj/machinery/atmospherics/pipe/manifold4w/hidden/scrubbers,/obj/machinery/atmospherics/pipe/manifold4w/hidden/supply,/obj/structure/cable/green{d1 = 1; d2 = 2; icon_state = "1-2"},/turf/simulated/floor/plating,/area/space)
"R" = (/obj/effect/floor_decal/industrial/outline/yellow,/obj/structure/closet/chefcloset,/obj/machinery/alarm{pixel_y = 24; req_access = newlist()},/turf/simulated/floor/tiled/techfloor/grid,/area/space)
"S" = (/obj/structure/catwalk,/obj/machinery/atmospherics/pipe/simple/hidden/scrubbers,/obj/machinery/atmospherics/pipe/simple/hidden/supply,/obj/structure/cable/green{d1 = 1; d2 = 2; icon_state = "1-2"},/turf/simulated/floor/plating,/area/space)
"T" = (/obj/structure/catwalk,/obj/machinery/atmospherics/pipe/simple/hidden/supply{dir = 4},/obj/machinery/atmospherics/pipe/simple/hidden/scrubbers{dir = 8},/obj/structure/cable/green{d1 = 4; d2 = 8; icon_state = "4-8"},/turf/simulated/floor/plating,/area/space)
"U" = (/obj/effect/floor_decal/borderfloor{dir = 4},/obj/structure/railing/mapped{dir = 4; icon_state = "railing0-1"},/obj/structure/closet/secure_closet/bar,/obj/random/clothing{spawn_nothing_percentage = 50},/obj/random/clothing{spawn_nothing_percentage = 50},/turf/simulated/floor/tiled/techfloor/grid,/area/space)
"V" = (/obj/structure/catwalk,/obj/effect/decal/cleanable/dirt,/obj/effect/decal/cleanable/dirt,/obj/machinery/atmospherics/pipe/simple/hidden/scrubbers,/obj/machinery/atmospherics/pipe/simple/hidden/supply,/obj/structure/cable/green{d1 = 1; d2 = 2; icon_state = "1-2"},/obj/random/trash,/obj/random/trash,/turf/simulated/floor/plating,/area/space)
"W" = (/obj/effect/floor_decal/borderfloor{dir = 8},/obj/structure/railing/mapped{dir = 8; icon_state = "railing0-1"},/obj/effect/decal/cleanable/dirt,/turf/simulated/floor/tiled/techfloor/grid,/area/space)
"X" = (/obj/structure/catwalk,/obj/machinery/atmospherics/pipe/simple/hidden/supply{dir = 6},/obj/machinery/atmospherics/pipe/simple/hidden/scrubbers{dir = 6},/turf/simulated/floor/plating,/area/space)
"Y" = (/obj/structure/catwalk,/obj/structure/railing/mapped{dir = 1; icon_state = "railing0-1"},/obj/structure/ore_box,/obj/machinery/atmospherics/pipe/simple/hidden/scrubbers{dir = 8},/obj/machinery/atmospherics/pipe/simple/hidden/supply{dir = 4},/turf/simulated/floor/plating,/area/space)
"Z" = (/obj/effect/floor_decal/industrial/warning/fulltile,/obj/structure/closet/crate/solar_assembly,/obj/structure/cable/green{d1 = 4; d2 = 8; icon_state = "4-8"},/turf/simulated/floor/tiled/techfloor,/area/space)

(1,1,1) = {"
UrhRJSnIiNW
sPXBHuBfMtE
llkZcLezvTT
bOpjxQYoGdW
awDyqVKCAFg
"}
