"a" = (/obj/effect/floor_decal/borderfloorblack{dir = 4},/obj/effect/floor_decal/industrial/warning{dir = 8},/turf/simulated/floor/tiled/steel_ridged,/area/template_noop)
"b" = (/turf/simulated/floor/grass,/area/template_noop)
"d" = (/obj/effect/floor_decal/borderfloorblack{dir = 10},/obj/effect/floor_decal/industrial/warning/corner{dir = 4},/obj/effect/decal/cleanable/dirt,/turf/simulated/floor/tiled/steel_ridged,/area/template_noop)
"f" = (/obj/machinery/atmospherics/pipe/simple/hidden/scrubbers{dir = 8},/obj/machinery/atmospherics/pipe/simple/hidden/supply{dir = 4},/obj/structure/cable/green{d1 = 4; d2 = 8; icon_state = "4-8"},/turf/simulated/floor/grass,/area/template_noop)
"g" = (/obj/structure/flora/ausbushes/sparsegrass,/turf/simulated/floor/grass,/area/template_noop)
"h" = (/obj/structure/catwalk,/obj/machinery/atmospherics/pipe/simple/hidden/scrubbers{dir = 8},/obj/machinery/atmospherics/pipe/simple/hidden/supply{dir = 4},/obj/structure/cable/green{d1 = 4; d2 = 8; icon_state = "4-8"},/obj/effect/landmark/explosion/random,/turf/simulated/floor/plating,/area/template_noop)
"i" = (/obj/machinery/light/small{dir = 1},/turf/simulated/floor/grass,/area/template_noop)
"k" = (/obj/structure/catwalk,/obj/structure/railing/mapped{dir = 8; icon_state = "railing0-1"},/obj/machinery/light/small,/turf/simulated/floor/plating,/area/template_noop)
"l" = (/obj/effect/floor_decal/spline/plain/black{dir = 8},/obj/machinery/firealarm{pixel_y = 13},/turf/simulated/floor/grass,/area/template_noop)
"o" = (/obj/structure/flora/ausbushes/brflowers,/obj/item/stool/wood,/turf/simulated/floor/grass,/area/template_noop)
"p" = (/obj/structure/catwalk,/obj/machinery/atmospherics/pipe/simple/hidden/scrubbers{dir = 8},/obj/machinery/atmospherics/pipe/simple/hidden/supply{dir = 4},/obj/structure/cable/green{d1 = 4; d2 = 8; icon_state = "4-8"},/obj/effect/decal/cleanable/dirt,/turf/simulated/floor/plating,/area/template_noop)
"t" = (/obj/item/stack/cable_coil/single{pixel_x = -16; pixel_y = 11},/turf/simulated/floor/grass,/area/template_noop)
"v" = (/obj/effect/floor_decal/spline/plain/black{dir = 8},/obj/machinery/atmospherics/pipe/simple/hidden/scrubbers{dir = 8},/obj/machinery/atmospherics/pipe/simple/hidden/supply{dir = 4},/obj/structure/cable/green{d1 = 4; d2 = 8; icon_state = "4-8"},/turf/simulated/floor/grass,/area/template_noop)
"w" = (/obj/structure/catwalk,/turf/simulated/floor/plating,/area/template_noop)
"x" = (/obj/structure/flora/tree/jungle,/obj/machinery/atmospherics/pipe/simple/hidden/scrubbers{dir = 8},/obj/machinery/atmospherics/pipe/simple/hidden/supply{dir = 4},/obj/structure/cable/green{d1 = 4; d2 = 8; icon_state = "4-8"},/turf/simulated/floor/grass,/area/template_noop)
"y" = (/obj/structure/flora/ausbushes/brflowers,/obj/machinery/alarm{pixel_y = 24; req_access = newlist()},/turf/simulated/floor/grass,/area/template_noop)
"z" = (/obj/effect/floor_decal/spline/plain/black{dir = 4},/obj/machinery/atmospherics/pipe/simple/hidden/scrubbers{dir = 8},/obj/machinery/atmospherics/pipe/simple/hidden/supply{dir = 4},/obj/structure/cable/green{d1 = 4; d2 = 8; icon_state = "4-8"},/turf/simulated/floor/grass,/area/template_noop)
"A" = (/obj/effect/floor_decal/borderfloorblack{dir = 5},/obj/effect/floor_decal/industrial/warning/corner{dir = 8},/turf/simulated/floor/tiled/steel_ridged,/area/template_noop)
"D" = (/obj/effect/floor_decal/borderfloorblack{dir = 6},/obj/effect/floor_decal/industrial/warning/corner{dir = 1},/turf/simulated/floor/tiled/steel_ridged,/area/template_noop)
"F" = (/obj/machinery/light/small,/turf/simulated/floor/grass,/area/template_noop)
"G" = (/obj/structure/flora/ausbushes/sparsegrass,/obj/effect/floor_decal/spline/plain/black{dir = 8},/turf/simulated/floor/grass,/area/template_noop)
"H" = (/obj/structure/catwalk,/obj/structure/railing/mapped{dir = 4; icon_state = "railing0-1"},/obj/machinery/light/small,/obj/effect/decal/cleanable/dirt,/turf/simulated/floor/plating,/area/template_noop)
"I" = (/obj/structure/catwalk,/obj/machinery/atmospherics/pipe/simple/hidden/scrubbers{dir = 8},/obj/machinery/atmospherics/pipe/simple/hidden/supply{dir = 4},/obj/structure/cable/green{d1 = 4; d2 = 8; icon_state = "4-8"},/turf/simulated/floor/plating,/area/template_noop)
"J" = (/obj/item/soap{pixel_x = 14; pixel_y = -20},/turf/simulated/floor/grass,/area/template_noop)
"L" = (/obj/effect/floor_decal/borderfloorblack{dir = 8},/obj/effect/floor_decal/industrial/warning{dir = 4},/obj/effect/decal/cleanable/dirt,/obj/effect/decal/cleanable/dirt,/turf/simulated/floor/tiled/steel_ridged,/area/template_noop)
"M" = (/obj/structure/catwalk,/obj/structure/railing/mapped{dir = 8; icon_state = "railing0-1"},/obj/machinery/light/small{dir = 1},/obj/effect/decal/cleanable/dirt,/turf/simulated/floor/plating,/area/template_noop)
"P" = (/obj/effect/floor_decal/spline/plain/black{dir = 4},/turf/simulated/floor/grass,/area/template_noop)
"Q" = (/obj/structure/catwalk,/obj/effect/decal/cleanable/dirt,/turf/simulated/floor/plating,/area/template_noop)
"R" = (/obj/effect/floor_decal/borderfloorblack{dir = 8},/obj/effect/floor_decal/industrial/warning{dir = 4},/turf/simulated/floor/tiled/steel_ridged,/area/template_noop)
"S" = (/obj/structure/flora/ausbushes/sparsegrass,/obj/effect/floor_decal/spline/plain/black{dir = 4},/turf/simulated/floor/grass,/area/template_noop)
"U" = (/obj/effect/floor_decal/borderfloorblack{dir = 4},/obj/effect/floor_decal/industrial/warning{dir = 8},/obj/effect/decal/cleanable/generic,/turf/simulated/floor/tiled/steel_ridged,/area/template_noop)
"V" = (/obj/structure/catwalk,/obj/structure/railing/mapped{dir = 4; icon_state = "railing0-1"},/obj/machinery/light/small{dir = 1},/turf/simulated/floor/plating,/area/template_noop)
"W" = (/obj/effect/floor_decal/spline/plain/black{dir = 8},/turf/simulated/floor/grass,/area/template_noop)
"Y" = (/obj/effect/floor_decal/borderfloorblack{dir = 9},/obj/effect/floor_decal/industrial/warning/corner,/obj/effect/decal/cleanable/dirt,/obj/effect/decal/cleanable/dirt,/turf/simulated/floor/tiled/steel_ridged,/area/template_noop)
"Z" = (/obj/structure/flora/ausbushes/ywflowers,/obj/machinery/atmospherics/pipe/simple/hidden/scrubbers{dir = 8},/obj/machinery/atmospherics/pipe/simple/hidden/supply{dir = 4},/obj/structure/cable/green{d1 = 4; d2 = 8; icon_state = "4-8"},/turf/simulated/floor/grass,/area/template_noop)

(1,1,1) = {"
UVlyibbbSMR
DQWbbbbbPwd
pIvffxZfzhp
AQGgJotgPwY
aHWgbbFbPkL
"}
