"a" = (/obj/effect/floor_decal/borderfloor{dir = 8},/obj/effect/floor_decal/industrial/warning{dir = 4},/obj/structure/closet/emcloset,/obj/effect/decal/cleanable/generic,/turf/simulated/floor/tiled/techfloor,/area/template_noop)
"b" = (/obj/structure/catwalk,/obj/structure/cable/green{d1 = 2; d2 = 4; icon_state = "2-4"},/obj/machinery/atmospherics/pipe/simple/hidden/scrubbers{dir = 6},/turf/simulated/floor/plating,/area/template_noop)
"c" = (/obj/structure/catwalk,/obj/structure/cable/green{d1 = 2; d2 = 8; icon_state = "2-8"},/obj/machinery/atmospherics/pipe/simple/hidden/scrubbers{dir = 10},/obj/effect/decal/cleanable/dirt,/turf/simulated/floor/plating,/area/template_noop)
"d" = (/obj/effect/floor_decal/floordetail/tiled,/obj/effect/floor_decal/industrial/warning,/turf/simulated/floor/tiled/steel_grid,/area/template_noop)
"e" = (/obj/effect/floor_decal/floordetail/tiled,/obj/effect/floor_decal/industrial/warning,/obj/structure/reagent_dispensers/watertank,/obj/effect/decal/cleanable/dirt,/turf/simulated/floor/tiled/steel_grid,/area/template_noop)
"f" = (/obj/effect/floor_decal/borderfloor{dir = 4},/obj/effect/floor_decal/industrial/warning{dir = 8},/obj/structure/table/rack,/obj/item/material/hatchet,/obj/item/material/minihoe,/obj/effect/decal/cleanable/dirt,/obj/effect/decal/cleanable/cobweb2,/turf/simulated/floor/tiled/techfloor,/area/template_noop)
"g" = (/obj/effect/floor_decal/floordetail/tiled,/obj/effect/floor_decal/industrial/warning{dir = 1},/obj/structure/cable/green{d1 = 4; d2 = 8; icon_state = "4-8"},/obj/machinery/atmospherics/pipe/simple/hidden/scrubbers{dir = 8},/turf/simulated/floor/tiled/steel_grid,/area/template_noop)
"j" = (/obj/structure/table/standard,/obj/effect/floor_decal/industrial/outline/yellow,/obj/machinery/reagentgrinder/juicer{pixel_x = 3; pixel_y = 17},/obj/item/reagent_containers/glass/beaker{pixel_x = 5},/obj/item/reagent_containers/dropper{pixel_y = 3},/turf/simulated/floor/tiled/techfloor,/area/template_noop)
"k" = (/obj/effect/floor_decal/floordetail/tiled,/obj/effect/floor_decal/industrial/warning{dir = 1},/obj/structure/cable/green{d1 = 4; d2 = 8; icon_state = "4-8"},/obj/machinery/atmospherics/pipe/simple/hidden/scrubbers{dir = 8},/obj/structure/hygiene/drain,/turf/simulated/floor/tiled/steel_grid,/area/template_noop)
"l" = (/obj/effect/floor_decal/industrial/outline/blue,/obj/machinery/portable_atmospherics/hydroponics,/turf/simulated/floor/tiled/steel_ridged,/area/template_noop)
"m" = (/obj/structure/catwalk,/obj/machinery/seed_extractor,/turf/simulated/floor/plating,/area/template_noop)
"n" = (/obj/machinery/vending/hydronutrients/generic,/obj/effect/floor_decal/industrial/hatch/yellow,/turf/simulated/floor/tiled/techfloor,/area/template_noop)
"o" = (/obj/effect/floor_decal/industrial/outline/blue,/obj/machinery/portable_atmospherics/hydroponics,/obj/machinery/light/small{dir = 1},/obj/effect/decal/cleanable/dirt,/turf/simulated/floor/tiled/steel_ridged,/area/template_noop)
"p" = (/obj/structure/catwalk,/obj/structure/cable/green{d1 = 1; d2 = 8; icon_state = "1-8"},/obj/structure/cable/green{d1 = 2; d2 = 8; icon_state = "2-8"},/obj/machinery/atmospherics/pipe/simple/hidden/supply{dir = 10},/obj/machinery/atmospherics/pipe/simple/hidden/scrubbers{dir = 9},/turf/simulated/floor/plating,/area/template_noop)
"r" = (/obj/effect/floor_decal/borderfloor{dir = 8},/obj/effect/floor_decal/industrial/warning{dir = 4},/obj/machinery/chem_master/condimaster{name = "CondiMaster Neo"},/turf/simulated/floor/tiled/techfloor,/area/template_noop)
"s" = (/obj/effect/floor_decal/floordetail/tiled,/obj/effect/floor_decal/industrial/warning,/obj/structure/cable/green{d1 = 4; d2 = 8; icon_state = "4-8"},/obj/machinery/atmospherics/pipe/simple/hidden/supply{dir = 4},/obj/structure/hygiene/drain,/turf/simulated/floor/tiled/steel_grid,/area/template_noop)
"t" = (/obj/structure/catwalk,/obj/structure/cable/green{d1 = 1; d2 = 4; icon_state = "1-4"},/obj/machinery/atmospherics/pipe/simple/hidden/supply{dir = 5},/turf/simulated/floor/plating,/area/template_noop)
"u" = (/obj/effect/floor_decal/industrial/outline/blue,/obj/machinery/portable_atmospherics/hydroponics,/obj/machinery/light/small{dir = 1},/turf/simulated/floor/tiled/steel_ridged,/area/template_noop)
"v" = (/obj/effect/floor_decal/floordetail/tiled,/obj/effect/floor_decal/industrial/warning,/obj/structure/cable/green{d1 = 4; d2 = 8; icon_state = "4-8"},/obj/machinery/atmospherics/pipe/simple/hidden/supply{dir = 4},/turf/simulated/floor/tiled/steel_grid,/area/template_noop)
"w" = (/obj/structure/cable/green{d1 = 4; d2 = 8; icon_state = "4-8"},/obj/machinery/atmospherics/pipe/simple/hidden/scrubbers{dir = 8},/obj/machinery/atmospherics/pipe/simple/hidden/supply{dir = 4},/obj/structure/catwalk,/turf/simulated/floor/plating,/area/template_noop)
"x" = (/obj/structure/catwalk,/obj/structure/cable/green{d1 = 4; d2 = 8; icon_state = "4-8"},/obj/machinery/atmospherics/pipe/simple/hidden/supply{dir = 4},/obj/machinery/atmospherics/pipe/simple/hidden/scrubbers{dir = 8},/obj/item/reagent_containers/glass/bucket/wood{pixel_x = -20; pixel_y = -18},/turf/simulated/floor/plating,/area/template_noop)
"y" = (/obj/structure/catwalk,/obj/structure/cable/green{d1 = 4; d2 = 8; icon_state = "4-8"},/obj/machinery/atmospherics/pipe/simple/hidden/supply{dir = 4},/obj/machinery/atmospherics/pipe/simple/hidden/scrubbers{dir = 8},/turf/simulated/floor/plating,/area/template_noop)
"z" = (/obj/effect/floor_decal/borderfloor{dir = 8},/obj/effect/floor_decal/industrial/warning/corner{dir = 4},/obj/random/trash,/turf/simulated/floor/tiled/techfloor,/area/template_noop)
"A" = (/obj/structure/catwalk,/obj/structure/cable/green{d1 = 4; d2 = 8; icon_state = "4-8"},/obj/machinery/atmospherics/pipe/simple/hidden/supply{dir = 4},/obj/machinery/atmospherics/pipe/simple/hidden/scrubbers{dir = 8},/obj/effect/decal/cleanable/dirt,/turf/simulated/floor/plating,/area/template_noop)
"B" = (/obj/structure/cable/green{d1 = 4; d2 = 8; icon_state = "4-8"},/obj/machinery/atmospherics/pipe/simple/hidden/supply{dir = 4},/obj/machinery/atmospherics/pipe/simple/hidden/scrubbers{dir = 8},/obj/structure/catwalk,/turf/simulated/floor/plating,/area/template_noop)
"C" = (/obj/structure/catwalk,/obj/machinery/smartfridge/drying_rack,/turf/simulated/floor/plating,/area/template_noop)
"D" = (/obj/effect/floor_decal/borderfloor{dir = 4},/obj/effect/floor_decal/industrial/warning/corner{dir = 1},/turf/simulated/floor/tiled/techfloor,/area/template_noop)
"E" = (/obj/effect/floor_decal/industrial/outline/blue,/obj/machinery/portable_atmospherics/hydroponics,/obj/machinery/firealarm{pixel_y = 13},/turf/simulated/floor/tiled/steel_ridged,/area/template_noop)
"G" = (/obj/effect/floor_decal/industrial/outline/blue,/obj/machinery/portable_atmospherics/hydroponics,/obj/machinery/alarm{pixel_y = 24; req_access = newlist()},/turf/simulated/floor/tiled/steel_ridged,/area/template_noop)
"H" = (/obj/structure/catwalk,/obj/structure/cable/green{d1 = 2; d2 = 4; icon_state = "2-4"},/obj/structure/cable/green{d1 = 1; d2 = 4; icon_state = "1-4"},/obj/machinery/atmospherics/pipe/simple/hidden/supply{dir = 6},/obj/machinery/atmospherics/pipe/simple/hidden/scrubbers{dir = 5},/obj/random/trash,/turf/simulated/floor/plating,/area/template_noop)
"I" = (/obj/effect/floor_decal/borderfloor{dir = 4},/obj/effect/floor_decal/industrial/warning/corner{dir = 8},/turf/simulated/floor/tiled/techfloor,/area/template_noop)
"J" = (/obj/effect/floor_decal/industrial/outline/blue,/obj/machinery/portable_atmospherics/hydroponics,/obj/machinery/light/small,/obj/effect/decal/cleanable/dirt,/obj/effect/decal/cleanable/dirt,/turf/simulated/floor/tiled/steel_ridged,/area/template_noop)
"K" = (/obj/machinery/seed_storage/garden,/obj/effect/floor_decal/industrial/hatch/yellow,/obj/effect/decal/cleanable/dirt,/turf/simulated/floor/tiled/techfloor,/area/template_noop)
"M" = (/obj/structure/catwalk,/obj/structure/cable/green{d1 = 1; d2 = 8; icon_state = "1-8"},/obj/machinery/atmospherics/pipe/simple/hidden/supply{dir = 9},/obj/effect/decal/cleanable/dirt,/turf/simulated/floor/plating,/area/template_noop)
"N" = (/obj/effect/floor_decal/floordetail/tiled,/obj/effect/floor_decal/industrial/warning{dir = 1},/turf/simulated/floor/tiled/steel_grid,/area/template_noop)
"O" = (/obj/effect/floor_decal/borderfloor{dir = 8},/obj/effect/floor_decal/industrial/warning/corner,/turf/simulated/floor/tiled/techfloor,/area/template_noop)
"P" = (/obj/effect/floor_decal/floordetail/tiled,/obj/effect/floor_decal/industrial/warning{dir = 1},/obj/effect/landmark/explosion/random,/turf/simulated/floor/tiled/steel_grid,/area/template_noop)
"S" = (/obj/effect/floor_decal/floordetail/tiled,/obj/effect/floor_decal/industrial/warning,/obj/structure/cable/green{d1 = 4; d2 = 8; icon_state = "4-8"},/obj/machinery/atmospherics/pipe/simple/hidden/supply{dir = 4},/obj/random/trash,/obj/random/trash,/obj/effect/decal/cleanable/generic,/turf/simulated/floor/tiled/steel_grid,/area/template_noop)
"T" = (/obj/effect/floor_decal/borderfloor{dir = 4},/obj/effect/floor_decal/industrial/warning{dir = 8},/obj/structure/table/rack,/turf/simulated/floor/tiled/techfloor,/area/template_noop)
"U" = (/obj/effect/floor_decal/floordetail/tiled,/obj/effect/floor_decal/industrial/warning,/obj/effect/decal/cleanable/dirt,/turf/simulated/floor/tiled/steel_grid,/area/template_noop)
"V" = (/obj/structure/catwalk,/obj/machinery/biogenerator,/obj/effect/decal/cleanable/dirt,/turf/simulated/floor/plating,/area/template_noop)
"W" = (/obj/effect/floor_decal/industrial/outline/blue,/obj/machinery/portable_atmospherics/hydroponics,/obj/machinery/light/small,/turf/simulated/floor/tiled/steel_ridged,/area/template_noop)
"X" = (/obj/effect/floor_decal/floordetail/tiled,/obj/effect/floor_decal/industrial/warning{dir = 1},/obj/effect/decal/cleanable/flour,/turf/simulated/floor/tiled/steel_grid,/area/template_noop)
"Y" = (/obj/effect/floor_decal/industrial/outline/blue,/obj/machinery/portable_atmospherics/hydroponics,/obj/effect/decal/cleanable/dirt,/turf/simulated/floor/tiled/steel_ridged,/area/template_noop)
"Z" = (/obj/effect/floor_decal/floordetail/tiled,/obj/effect/floor_decal/industrial/warning{dir = 1},/obj/effect/decal/cleanable/dirt,/turf/simulated/floor/tiled/steel_grid,/area/template_noop)

(1,1,1) = {"
roECGulClof
zXZbgkgcNPD
AwypnjKHxBA
OUdtvsSMeUI
aWYVlWlmlJT
"}
