"a" = (/obj/structure/catwalk,/turf/simulated/floor/plating,/area/space)
"b" = (/obj/structure/catwalk,/obj/machinery/atmospherics/pipe/simple/hidden/scrubbers{dir = 4},/obj/machinery/atmospherics/pipe/simple/hidden/scrubbers{dir = 4},/obj/structure/cable/green{d1 = 4; d2 = 8; icon_state = "4-8"},/turf/simulated/floor/plating,/area/space)
"c" = (/obj/structure/catwalk,/obj/structure/closet/crate,/obj/random/junkyard/loot,/obj/random/junkyard/loot,/obj/random/junkyard/loot,/obj/random/junkyard/loot,/obj/machinery/atmospherics/pipe/simple/hidden/scrubbers{dir = 4},/obj/structure/cable/green{d1 = 4; d2 = 8; icon_state = "4-8"},/turf/simulated/floor/plating,/area/space)
"d" = (/obj/structure/catwalk,/obj/machinery/atmospherics/pipe/simple/hidden/supply{dir = 5},/obj/structure/cable/green{d1 = 1; d2 = 4; icon_state = "1-4"},/turf/simulated/floor/plating,/area/space)
"e" = (/obj/structure/catwalk,/obj/machinery/atmospherics/pipe/simple/hidden/scrubbers{dir = 5},/obj/machinery/atmospherics/pipe/simple/hidden/supply{dir = 6},/obj/structure/cable/green{d1 = 1; d2 = 4; icon_state = "1-4"},/obj/structure/cable/green{d1 = 2; d2 = 4; icon_state = "2-4"},/turf/simulated/floor/plating,/area/space)
"f" = (/obj/structure/catwalk,/obj/item/flame/candle,/obj/machinery/atmospherics/pipe/simple/hidden/supply{dir = 4},/obj/structure/cable/green{d1 = 4; d2 = 8; icon_state = "4-8"},/turf/simulated/floor/plating,/area/space)
"g" = (/obj/structure/catwalk,/obj/structure/ore_box,/obj/effect/decal/cleanable/dirt,/obj/effect/decal/cleanable/cobweb,/turf/simulated/floor/plating,/area/space)
"h" = (/obj/structure/catwalk,/obj/random/trash,/obj/effect/decal/cleanable/dirt,/obj/machinery/atmospherics/pipe/simple/hidden/scrubbers{dir = 4},/obj/structure/cable/green{d1 = 4; d2 = 8; icon_state = "4-8"},/turf/simulated/floor/plating,/area/space)
"i" = (/obj/effect/floor_decal/techfloor/orange,/obj/structure/sign{icon = 'icons/obj/contraband.dmi'; icon_state = "bsposter55"; pixel_y = 31},/obj/random/trash,/obj/random/trash,/turf/simulated/floor/tiled/techfloor/grid,/area/space)
"j" = (/obj/structure/catwalk,/obj/item/flame/candle{pixel_x = -15; pixel_y = 4},/obj/random/trash,/obj/random/trash,/obj/effect/decal/cleanable/dirt,/obj/machinery/atmospherics/pipe/simple/hidden/supply{dir = 4},/obj/structure/cable/green{d1 = 4; d2 = 8; icon_state = "4-8"},/turf/simulated/floor/plating,/area/space)
"k" = (/obj/structure/catwalk,/obj/structure/ore_box,/obj/machinery/light/small/red{dir = 1},/turf/simulated/floor/plating,/area/space)
"l" = (/obj/effect/floor_decal/borderfloor{dir = 4},/obj/structure/railing/mapped{dir = 4; icon_state = "railing0-1"},/obj/structure/closet,/obj/machinery/atmospherics/pipe/simple/hidden/scrubbers{dir = 4},/obj/machinery/atmospherics/pipe/simple/hidden/supply{dir = 4},/obj/structure/cable/green{d1 = 4; d2 = 8; icon_state = "4-8"},/turf/simulated/floor/tiled/techmaint,/area/space)
"m" = (/obj/effect/floor_decal/borderfloor{dir = 8},/obj/structure/railing/mapped{dir = 8; icon_state = "railing0-1"},/obj/structure/closet,/obj/random/junkyard/material,/obj/random/junkyard/material,/obj/random/circuitboard{spawn_nothing_percentage = 50},/obj/random/circuitboard{spawn_nothing_percentage = 50},/obj/random/circuitboard{spawn_nothing_percentage = 50},/obj/random/junkyard/material,/obj/random/junkyard/material,/obj/random/junkyard/material,/turf/simulated/floor/tiled/techmaint,/area/space)
"n" = (/obj/structure/catwalk,/obj/item/flame/candle,/obj/machinery/atmospherics/pipe/simple/hidden/scrubbers{dir = 4},/obj/structure/cable/green{d1 = 4; d2 = 8; icon_state = "4-8"},/turf/simulated/floor/plating,/area/space)
"o" = (/obj/structure/catwalk,/obj/machinery/light/small/red,/obj/random/trash,/turf/simulated/floor/plating,/area/space)
"p" = (/obj/structure/catwalk,/obj/effect/decal/cleanable/dirt,/obj/machinery/atmospherics/pipe/simple/hidden/supply{dir = 9},/obj/structure/cable/green{d1 = 1; d2 = 8; icon_state = "1-8"},/turf/simulated/floor/plating,/area/space)
"q" = (/obj/effect/floor_decal/borderfloor{dir = 4},/obj/structure/table/rack,/obj/structure/railing/mapped{dir = 4; icon_state = "railing0-1"},/obj/random/junkyard/tool,/obj/random/junkyard/tool,/obj/random/junkyard/tool,/obj/random/circuitboard{spawn_nothing_percentage = 50},/obj/random/contraband{spawn_nothing_percentage = 90},/turf/simulated/floor/tiled/techmaint,/area/space)
"r" = (/obj/effect/floor_decal/industrial/warning,/obj/effect/floor_decal/industrial/warning{dir = 1},/obj/item/clothing/glasses/hipster{pixel_x = 9; pixel_y = 9},/obj/effect/decal/cleanable/ash,/turf/simulated/floor/tiled/techfloor/grid,/area/space)
"s" = (/obj/structure/catwalk,/obj/structure/ore_box,/obj/machinery/atmospherics/pipe/simple/hidden/scrubbers{dir = 6},/obj/structure/cable/green{d1 = 2; d2 = 4; icon_state = "2-4"},/turf/simulated/floor/plating,/area/space)
"t" = (/obj/structure/catwalk,/obj/effect/decal/cleanable/dirt,/obj/machinery/atmospherics/pipe/simple/hidden/supply{dir = 4},/obj/structure/cable/green{d1 = 4; d2 = 8; icon_state = "4-8"},/turf/simulated/floor/plating,/area/space)
"u" = (/obj/effect/floor_decal/industrial/warning,/obj/effect/floor_decal/industrial/warning{dir = 1},/obj/item/flame/candle{pixel_x = -5; pixel_y = 24},/obj/item/flame/candle,/obj/item/flame/candle{pixel_x = 6; pixel_y = 9},/obj/effect/decal/cleanable/dirt,/turf/simulated/floor/tiled/techfloor/grid,/area/space)
"v" = (/obj/structure/catwalk,/obj/item/flame/candle{pixel_y = 14},/obj/machinery/atmospherics/pipe/simple/hidden/supply{dir = 4},/obj/structure/cable/green{d1 = 4; d2 = 8; icon_state = "4-8"},/turf/simulated/floor/plating,/area/space)
"w" = (/obj/effect/floor_decal/techfloor/orange{dir = 6},/turf/simulated/floor/tiled/techfloor/grid,/area/space)
"x" = (/obj/effect/floor_decal/techfloor/orange{dir = 10},/obj/machinery/firealarm{pixel_y = 13},/obj/random/trash,/turf/simulated/floor/tiled/techfloor/grid,/area/space)
"y" = (/obj/effect/floor_decal/techfloor/orange{dir = 1},/obj/item/flame/candle{pixel_x = 4; pixel_y = 6},/obj/item/flame/candle,/obj/effect/decal/cleanable/dirt,/turf/simulated/floor/tiled/techfloor/grid,/area/space)
"z" = (/obj/effect/floor_decal/industrial/warning,/obj/effect/floor_decal/industrial/warning{dir = 1},/obj/item/material/cross/gold{pixel_x = 3; pixel_y = 8},/obj/item/flame/candle{pixel_x = -12; pixel_y = 16},/obj/effect/decal/cleanable/dirt,/turf/simulated/floor/tiled/techfloor/grid,/area/space)
"A" = (/obj/effect/floor_decal/industrial/warning,/obj/effect/floor_decal/industrial/warning{dir = 1},/obj/effect/decal/cleanable/generic,/turf/simulated/floor/tiled/techfloor/grid,/area/space)
"B" = (/obj/effect/floor_decal/techfloor/orange{dir = 9},/obj/structure/ore_box,/turf/simulated/floor/tiled/techfloor/grid,/area/space)
"C" = (/obj/structure/catwalk,/obj/structure/closet/crate/large,/obj/random/junkyard/advdevice,/obj/random/junkyard/tech_supply,/obj/random/junkyard/tech_supply,/obj/random/junkyard/tech_supply,/obj/random/junkyard/advdevice,/obj/random/junkyard/bomb_supply,/obj/random/junkyard/bomb_supply,/obj/machinery/atmospherics/pipe/simple/hidden/supply{dir = 4},/obj/structure/cable/green{d1 = 4; d2 = 8; icon_state = "4-8"},/turf/simulated/floor/plating,/area/space)
"D" = (/obj/effect/floor_decal/industrial/warning,/obj/effect/floor_decal/industrial/warning{dir = 1},/obj/effect/decal/cleanable/dirt,/turf/simulated/floor/tiled/techfloor/grid,/area/space)
"E" = (/obj/effect/floor_decal/borderfloor{dir = 8},/obj/structure/railing/mapped{dir = 8; icon_state = "railing0-1"},/obj/structure/closet,/obj/machinery/atmospherics/pipe/simple/hidden/scrubbers{dir = 4},/obj/machinery/atmospherics/pipe/simple/hidden/supply{dir = 4},/obj/structure/cable/green{d1 = 4; d2 = 8; icon_state = "4-8"},/turf/simulated/floor/tiled/techmaint,/area/space)
"F" = (/obj/effect/floor_decal/techfloor/orange{dir = 5},/obj/effect/decal/cleanable/dirt,/turf/simulated/floor/tiled/techfloor/grid,/area/space)
"G" = (/obj/effect/floor_decal/borderfloor{dir = 4},/obj/structure/table/rack,/obj/structure/railing/mapped{dir = 4; icon_state = "railing0-1"},/turf/simulated/floor/tiled/techmaint,/area/space)
"H" = (/obj/structure/catwalk,/obj/structure/closet/crate/large,/obj/effect/decal/cleanable/dirt,/obj/effect/decal/cleanable/dirt,/obj/machinery/atmospherics/pipe/simple/hidden/scrubbers{dir = 10},/obj/structure/cable/green{d1 = 2; d2 = 8; icon_state = "2-8"},/turf/simulated/floor/plating,/area/space)
"I" = (/obj/effect/floor_decal/industrial/warning,/obj/effect/floor_decal/industrial/warning{dir = 1},/obj/item/flame/candle,/obj/random/trash,/turf/simulated/floor/tiled/techfloor/grid,/area/space)
"J" = (/obj/effect/floor_decal/industrial/warning,/obj/effect/floor_decal/industrial/warning{dir = 1},/obj/item/flame/candle,/turf/simulated/floor/tiled/techfloor/grid,/area/space)
"K" = (/obj/effect/floor_decal/techfloor/orange{dir = 1},/turf/simulated/floor/tiled/techfloor/grid,/area/space)
"L" = (/obj/structure/catwalk,/obj/machinery/atmospherics/pipe/simple/hidden/scrubbers{dir = 9},/obj/machinery/atmospherics/pipe/simple/hidden/supply{dir = 10},/obj/structure/cable/green{d1 = 1; d2 = 8; icon_state = "1-8"},/obj/structure/cable/green{d1 = 2; d2 = 8; icon_state = "2-8"},/turf/simulated/floor/plating,/area/space)
"M" = (/obj/structure/catwalk,/obj/machinery/atmospherics/pipe/simple/hidden/scrubbers{dir = 4},/obj/structure/cable/green{d1 = 4; d2 = 8; icon_state = "4-8"},/turf/simulated/floor/plating,/area/space)
"O" = (/obj/effect/floor_decal/techfloor/orange,/obj/item/flame/candle,/obj/effect/decal/cleanable/dirt,/obj/effect/decal/cleanable/dirt,/obj/effect/decal/cleanable/ash{pixel_x = 8; pixel_y = 13},/turf/simulated/floor/tiled/techfloor/grid,/area/space)
"P" = (/obj/structure/catwalk,/obj/structure/catwalk,/obj/machinery/light/small/red,/turf/simulated/floor/plating,/area/space)
"Q" = (/obj/effect/floor_decal/techfloor/orange,/obj/random/trash,/obj/random/trash,/obj/effect/decal/cleanable/dirt,/turf/simulated/floor/tiled/techfloor/grid,/area/space)
"R" = (/obj/structure/catwalk,/obj/effect/decal/cleanable/dirt,/turf/simulated/floor/plating,/area/space)
"S" = (/obj/effect/floor_decal/techfloor/orange,/obj/random/trash,/turf/simulated/floor/tiled/techfloor/grid,/area/space)
"T" = (/obj/structure/catwalk,/obj/machinery/light/small/red{dir = 1},/obj/effect/decal/cleanable/dirt,/turf/simulated/floor/plating,/area/space)
"U" = (/obj/structure/catwalk,/obj/machinery/atmospherics/pipe/simple/hidden/supply{dir = 4},/obj/structure/cable/green{d1 = 4; d2 = 8; icon_state = "4-8"},/turf/simulated/floor/plating,/area/space)
"V" = (/obj/structure/catwalk,/obj/random/trash,/obj/machinery/atmospherics/pipe/simple/hidden/scrubbers{dir = 4},/obj/structure/cable/green{d1 = 4; d2 = 8; icon_state = "4-8"},/turf/simulated/floor/plating,/area/space)
"W" = (/obj/effect/floor_decal/techfloor/orange{dir = 1},/obj/effect/decal/cleanable/dirt,/obj/effect/decal/cleanable/dirt,/turf/simulated/floor/tiled/techfloor/grid,/area/space)
"Y" = (/obj/effect/floor_decal/techfloor/orange,/obj/machinery/alarm{pixel_y = 24; req_access = newlist()},/turf/simulated/floor/tiled/techfloor/grid,/area/space)
"Z" = (/obj/effect/floor_decal/borderfloor{dir = 8},/obj/structure/railing/mapped{dir = 8; icon_state = "railing0-1"},/obj/structure/closet,/obj/effect/decal/cleanable/dirt,/obj/effect/decal/cleanable/generic,/obj/random/clothing{spawn_nothing_percentage = 50},/obj/random/clothing{spawn_nothing_percentage = 50},/obj/random/clothing{spawn_nothing_percentage = 50},/obj/random/clothing{spawn_nothing_percentage = 50},/obj/random/clothing{spawn_nothing_percentage = 50},/obj/random/clothing{spawn_nothing_percentage = 50},/turf/simulated/floor/tiled/techmaint,/area/space)

(1,1,1) = {"
gTxYSiOQwkR
GscVnhMMbHm
lLAJrzuIDeE
qdUtvjfUCpZ
aoBKyKKWFPa
"}
