"a" = (/obj/structure/table/standard,/obj/structure/table/standard,/obj/random/junkyard/tool,/obj/random/junkyard/tool,/obj/random/junkyard/material,/obj/random/junkyard/material,/obj/random/junkyard/material,/obj/machinery/light/small,/turf/simulated/floor/tiled/techmaint,/area/template_noop)
"b" = (/obj/machinery/atmospherics/pipe/manifold4w/hidden/scrubbers,/obj/machinery/atmospherics/pipe/manifold4w/hidden/supply,/obj/structure/cable/green{d1 = 1; d2 = 2; icon_state = "1-2"},/obj/structure/cable/green{d1 = 1; d2 = 8; icon_state = "1-8"},/obj/structure/cable/green{d1 = 2; d2 = 4; icon_state = "2-4"},/obj/structure/cable/green{d1 = 2; d2 = 8; icon_state = "2-8"},/obj/structure/cable/green{d1 = 1; d2 = 4; icon_state = "1-4"},/obj/structure/catwalk,/turf/simulated/floor/plating,/area/template_noop)
"c" = (/obj/machinery/fabricator/hacked,/obj/effect/floor_decal/industrial/hatch/yellow,/obj/effect/floor_decal/industrial/hatch/yellow,/turf/simulated/floor/tiled/steel_ridged,/area/template_noop)
"d" = (/obj/effect/floor_decal/borderfloorblack{dir = 6},/obj/effect/floor_decal/industrial/warning/corner{dir = 1},/obj/effect/decal/cleanable/dirt,/turf/simulated/floor/tiled/techfloor,/area/template_noop)
"e" = (/obj/effect/floor_decal/borderfloorblack,/obj/effect/floor_decal/industrial/warning{dir = 1},/obj/effect/decal/cleanable/dirt,/obj/effect/decal/cleanable/dirt,/obj/random/trash,/obj/random/trash,/obj/random/trash,/obj/random/trash,/obj/random/trash,/obj/machinery/light/small{dir = 8},/turf/simulated/floor/tiled/techfloor,/area/template_noop)
"f" = (/obj/structure/table/rack,/obj/machinery/atmospherics/pipe/simple/hidden/scrubbers,/obj/machinery/atmospherics/pipe/simple/hidden/supply,/obj/structure/cable/green{d1 = 1; d2 = 2; icon_state = "1-2"},/obj/structure/catwalk,/turf/simulated/floor/plating,/area/template_noop)
"g" = (/obj/effect/floor_decal/borderfloorblack{dir = 8},/obj/effect/floor_decal/industrial/warning{dir = 4},/obj/effect/decal/cleanable/dirt,/obj/effect/decal/cleanable/dirt,/obj/effect/decal/cleanable/dirt,/obj/random/trash,/obj/random/trash,/turf/simulated/floor/tiled/techfloor,/area/template_noop)
"h" = (/obj/structure/table/standard,/obj/random/junkyard/advdevice,/obj/random/junkyard/advdevice,/obj/random/junkyard/tech_supply,/obj/random/junkyard/tech_supply,/turf/simulated/floor/tiled/techmaint,/area/template_noop)
"i" = (/obj/machinery/computer/modular/preset/civilian{dir = 8},/obj/machinery/computer/modular/preset/civilian{dir = 8},/obj/effect/floor_decal/industrial/outline/yellow,/obj/effect/decal/cleanable/dirt,/turf/simulated/floor/tiled/steel_ridged,/area/template_noop)
"j" = (/obj/structure/table/rack,/obj/machinery/light/small,/turf/simulated/floor/tiled/techmaint,/area/template_noop)
"k" = (/obj/structure/table/rack,/obj/effect/floor_decal/borderfloorblack{dir = 4},/obj/effect/floor_decal/industrial/warning{dir = 8},/obj/random/junkyard/toolbox,/obj/random/junkyard/tool,/turf/simulated/floor/tiled/techfloor,/area/template_noop)
"l" = (/obj/effect/floor_decal/borderfloorblack{dir = 4},/obj/effect/floor_decal/industrial/warning{dir = 8},/obj/effect/decal/cleanable/dirt,/turf/simulated/floor/tiled/techfloor,/area/template_noop)
"n" = (/obj/machinery/atmospherics/pipe/simple/hidden/scrubbers,/obj/machinery/atmospherics/pipe/simple/hidden/supply,/obj/structure/cable/green{d1 = 1; d2 = 2; icon_state = "1-2"},/obj/structure/catwalk,/turf/simulated/floor/plating,/area/template_noop)
"o" = (/obj/structure/table/standard,/obj/effect/floor_decal/borderfloorblack{dir = 8},/obj/effect/floor_decal/industrial/warning{dir = 4},/turf/simulated/floor/tiled/techfloor,/area/template_noop)
"t" = (/obj/effect/floor_decal/borderfloorblack{dir = 4},/obj/effect/floor_decal/industrial/warning{dir = 8},/turf/simulated/floor/tiled/techfloor,/area/template_noop)
"u" = (/obj/effect/floor_decal/borderfloorblack{dir = 8},/obj/effect/floor_decal/industrial/warning{dir = 4},/obj/effect/decal/cleanable/dirt,/turf/simulated/floor/tiled/techfloor,/area/template_noop)
"w" = (/obj/effect/floor_decal/borderfloorblack,/obj/effect/floor_decal/industrial/warning{dir = 1},/obj/machinery/light/small{dir = 4},/turf/simulated/floor/tiled/techfloor,/area/template_noop)
"x" = (/obj/machinery/computer/modular/preset/civilian{dir = 8},/obj/effect/floor_decal/industrial/outline/yellow,/obj/effect/decal/cleanable/dirt,/obj/effect/decal/cleanable/dirt,/turf/simulated/floor/tiled/steel_ridged,/area/template_noop)
"y" = (/obj/effect/decal/cleanable/dirt,/obj/effect/decal/cleanable/generic,/turf/simulated/floor/tiled/techmaint,/area/template_noop)
"z" = (/obj/structure/table/rack,/obj/effect/floor_decal/borderfloorblack{dir = 1},/obj/effect/floor_decal/industrial/warning,/obj/random/junkyard/material,/obj/random/junkyard/material,/obj/random/junkyard/material,/obj/random/junkyard/material,/obj/machinery/light/small{dir = 8},/turf/simulated/floor/tiled/techfloor,/area/template_noop)
"A" = (/obj/effect/floor_decal/borderfloorblack{dir = 9},/obj/effect/floor_decal/industrial/warning/corner,/turf/simulated/floor/tiled/techfloor,/area/template_noop)
"B" = (/obj/structure/table/rack,/obj/machinery/light/small{dir = 1},/turf/simulated/floor/tiled/techmaint,/area/template_noop)
"C" = (/obj/machinery/atmospherics/pipe/simple/hidden/scrubbers,/obj/machinery/atmospherics/pipe/simple/hidden/supply,/obj/structure/cable/green{d1 = 1; d2 = 2; icon_state = "1-2"},/obj/structure/catwalk,/obj/effect/decal/cleanable/dirt,/turf/simulated/floor/plating,/area/template_noop)
"D" = (/obj/machinery/atmospherics/pipe/simple/hidden/scrubbers,/obj/machinery/atmospherics/pipe/simple/hidden/supply,/obj/structure/cable/green{d1 = 1; d2 = 2; icon_state = "1-2"},/obj/structure/catwalk,/obj/random/trash,/turf/simulated/floor/plating,/area/template_noop)
"F" = (/obj/effect/floor_decal/borderfloorblack{dir = 4},/obj/effect/floor_decal/industrial/warning{dir = 8},/obj/effect/decal/cleanable/dirt,/obj/random/trash,/turf/simulated/floor/tiled/techfloor,/area/template_noop)
"G" = (/obj/machinery/computer/modular/preset/merchant{dir = 8},/obj/effect/floor_decal/industrial/outline/yellow,/turf/simulated/floor/tiled/steel_ridged,/area/template_noop)
"H" = (/obj/effect/floor_decal/borderfloorblack{dir = 10},/obj/effect/floor_decal/industrial/warning/corner{dir = 4},/obj/effect/decal/cleanable/generic,/obj/effect/decal/cleanable/generic,/turf/simulated/floor/tiled/techfloor,/area/template_noop)
"I" = (/obj/structure/table/standard,/obj/machinery/atmospherics/pipe/simple/hidden/scrubbers,/obj/machinery/atmospherics/pipe/simple/hidden/supply,/obj/structure/cable/green{d1 = 1; d2 = 2; icon_state = "1-2"},/obj/structure/catwalk,/turf/simulated/floor/plating,/area/template_noop)
"J" = (/obj/machinery/computer/modular/preset/library{dir = 4},/obj/effect/floor_decal/industrial/outline/yellow,/obj/machinery/firealarm{dir = 8; pixel_x = -24; pixel_y = 6},/obj/machinery/firealarm{dir = 8; pixel_x = -24; pixel_y = 6},/turf/simulated/floor/tiled/steel_ridged,/area/template_noop)
"K" = (/obj/machinery/atmospherics/pipe/simple/hidden/scrubbers,/obj/machinery/atmospherics/pipe/simple/hidden/supply,/obj/structure/cable/green{d1 = 1; d2 = 2; icon_state = "1-2"},/obj/structure/catwalk,/obj/effect/decal/cleanable/dirt,/obj/random/trash,/obj/random/trash,/obj/random/trash,/obj/random/trash,/turf/simulated/floor/plating,/area/template_noop)
"L" = (/obj/machinery/vending/tool{dir = 4},/obj/effect/floor_decal/industrial/outline/yellow,/turf/simulated/floor/tiled/steel_ridged,/area/template_noop)
"M" = (/obj/machinery/vending/assist{dir = 4},/obj/effect/floor_decal/industrial/outline/yellow,/obj/effect/decal/cleanable/dirt,/turf/simulated/floor/tiled/steel_ridged,/area/template_noop)
"N" = (/obj/structure/table/standard,/obj/effect/floor_decal/borderfloorblack{dir = 1},/obj/effect/floor_decal/industrial/warning,/obj/effect/decal/cleanable/dirt,/obj/random/junkyard/bomb_supply,/obj/random/junkyard/bomb_supply,/obj/random/junkyard/bomb_supply,/obj/random/junkyard/bomb_supply,/obj/random/junkyard/powercell,/obj/machinery/light/small{dir = 4},/turf/simulated/floor/tiled/techfloor,/area/template_noop)
"O" = (/obj/effect/floor_decal/borderfloorblack{dir = 4},/obj/effect/floor_decal/industrial/warning{dir = 8},/obj/random/trash,/turf/simulated/floor/tiled/techfloor,/area/template_noop)
"P" = (/obj/machinery/atmospherics/pipe/simple/hidden/scrubbers{dir = 4},/obj/machinery/atmospherics/pipe/simple/hidden/supply{dir = 4},/obj/structure/cable/green{d1 = 4; d2 = 8; icon_state = "4-8"},/obj/structure/catwalk,/turf/simulated/floor/plating,/area/template_noop)
"Q" = (/obj/effect/floor_decal/borderfloorblack{dir = 5},/obj/effect/floor_decal/industrial/warning/corner{dir = 8},/turf/simulated/floor/tiled/techfloor,/area/template_noop)
"R" = (/obj/effect/floor_decal/borderfloorblack{dir = 8},/obj/effect/floor_decal/industrial/warning{dir = 4},/obj/effect/decal/cleanable/generic,/turf/simulated/floor/tiled/techfloor,/area/template_noop)
"S" = (/obj/structure/table/standard,/obj/effect/decal/cleanable/dirt,/obj/random/trash,/obj/machinery/light/small{dir = 1},/turf/simulated/floor/tiled/techmaint,/area/template_noop)
"V" = (/obj/machinery/computer/modular/preset/civilian{dir = 4},/obj/effect/floor_decal/industrial/outline/yellow,/obj/effect/decal/cleanable/dirt,/turf/simulated/floor/tiled/steel_ridged,/area/template_noop)
"W" = (/obj/machinery/atmospherics/pipe/simple/hidden/scrubbers{dir = 4},/obj/machinery/atmospherics/pipe/simple/hidden/supply{dir = 4},/obj/structure/cable/green{d1 = 4; d2 = 8; icon_state = "4-8"},/obj/structure/catwalk,/obj/effect/landmark/explosion/random,/turf/simulated/floor/plating,/area/template_noop)
"X" = (/obj/structure/table/standard,/obj/structure/table/standard,/obj/machinery/alarm{dir = 4; pixel_x = -22; req_access = newlist()},/obj/machinery/alarm{dir = 4; pixel_x = -22; req_access = newlist()},/turf/simulated/floor/tiled/techmaint,/area/template_noop)
"Y" = (/obj/structure/table/standard,/turf/simulated/floor/tiled/techmaint,/area/template_noop)

(1,1,1) = {"
BkCuS
LFCuG
MtCgc
ytIoh
edfHw
PPbPW
zQDAN
XOnRY
JtCux
VlCui
alKuj
"}
