"a" = (/obj/structure/bed/padded,/obj/structure/bed/padded{buckle_pixel_shift = "x=0;y=8;z=0"; layer = 2.24; pixel_y = 8},/obj/effect/floor_decal/industrial/outline/yellow,/obj/machinery/light/small,/obj/effect/decal/cleanable/dirt,/turf/simulated/floor/tiled/steel_ridged,/area/space)
"b" = (/obj/machinery/washing_machine,/obj/machinery/washing_machine{pixel_y = 18},/obj/effect/floor_decal/industrial/warning,/obj/effect/floor_decal/borderfloor{dir = 1},/obj/effect/decal/cleanable/dirt,/turf/simulated/floor/tiled/techfloor,/area/space)
"c" = (/obj/structure/bed/padded,/obj/structure/bed/padded{buckle_pixel_shift = "x=0;y=8;z=0"; layer = 2.24; pixel_y = 8},/obj/effect/floor_decal/industrial/outline/yellow,/obj/effect/decal/cleanable/dirt,/turf/simulated/floor/tiled/steel_ridged,/area/space)
"d" = (/obj/effect/floor_decal/industrial/warning{dir = 4},/obj/effect/floor_decal/borderfloor{dir = 8},/obj/random/trash,/obj/random/trash,/turf/simulated/floor/tiled/techfloor,/area/space)
"e" = (/obj/structure/catwalk,/obj/structure/closet/secure_closet/personal/empty,/obj/machinery/atmospherics/pipe/simple/hidden/supply,/obj/machinery/atmospherics/pipe/simple/hidden/scrubbers,/obj/structure/cable/green{d1 = 1; d2 = 2; icon_state = "1-2"},/turf/simulated/floor/plating,/area/space)
"g" = (/obj/effect/floor_decal/industrial/warning/corner,/obj/effect/floor_decal/borderfloor{dir = 9},/turf/simulated/floor/tiled/techfloor,/area/space)
"h" = (/obj/structure/catwalk,/obj/item/stool/padded,/obj/effect/decal/cleanable/dirt,/obj/machinery/atmospherics/pipe/simple/hidden/supply,/obj/machinery/atmospherics/pipe/simple/hidden/scrubbers,/obj/structure/cable/green{d1 = 1; d2 = 2; icon_state = "1-2"},/turf/simulated/floor/plating,/area/space)
"i" = (/obj/structure/table/standard,/obj/structure/catwalk,/obj/item/reagent_containers/food/drinks/coffee{pixel_x = 7; pixel_y = 11},/obj/item/deck/cards,/obj/machinery/atmospherics/pipe/manifold4w/hidden/scrubbers,/obj/machinery/atmospherics/pipe/manifold4w/hidden/supply,/obj/structure/cable/green{d1 = 1; d2 = 2; icon_state = "1-2"},/obj/structure/cable/green{d1 = 2; d2 = 8; icon_state = "2-8"},/obj/structure/cable/green{d1 = 2; d2 = 4; icon_state = "2-4"},/obj/structure/cable/green{d1 = 1; d2 = 8; icon_state = "1-8"},/obj/structure/cable/green{d1 = 1; d2 = 4; icon_state = "1-4"},/turf/simulated/floor/plating,/area/space)
"j" = (/obj/structure/bed/padded,/obj/structure/bed/padded{buckle_pixel_shift = "x=0;y=8;z=0"; layer = 2.24; pixel_y = 8},/obj/effect/floor_decal/industrial/outline/yellow,/obj/machinery/light/small{dir = 1},/obj/effect/decal/cleanable/cobweb,/obj/random/trash,/obj/random/trash,/obj/random/trash,/turf/simulated/floor/tiled/steel_ridged,/area/space)
"k" = (/obj/effect/floor_decal/industrial/warning/fulltile,/turf/simulated/floor/tiled/steel_ridged,/area/space)
"l" = (/obj/structure/bed/padded,/obj/structure/bed/padded{buckle_pixel_shift = "x=0;y=8;z=0"; layer = 2.24; pixel_y = 8},/obj/effect/floor_decal/industrial/outline/yellow,/obj/machinery/alarm{dir = 4; pixel_x = -22; req_access = newlist()},/obj/effect/decal/cleanable/dirt,/turf/simulated/floor/tiled/steel_ridged,/area/space)
"m" = (/obj/effect/floor_decal/industrial/warning/fulltile,/obj/machinery/light/small{dir = 4},/obj/random/trash,/turf/simulated/floor/tiled/steel_ridged,/area/space)
"o" = (/obj/effect/floor_decal/industrial/warning{dir = 4},/obj/effect/floor_decal/borderfloor{dir = 8},/obj/effect/decal/cleanable/dirt,/obj/effect/decal/cleanable/dirt,/obj/effect/decal/cleanable/dirt,/obj/effect/decal/cleanable/dirt,/turf/simulated/floor/tiled/techfloor,/area/space)
"p" = (/obj/effect/floor_decal/industrial/warning/fulltile,/obj/machinery/light/small{dir = 4},/turf/simulated/floor/tiled/steel_ridged,/area/space)
"q" = (/obj/effect/floor_decal/industrial/warning{dir = 8},/obj/effect/floor_decal/borderfloor{dir = 4},/obj/effect/decal/cleanable/dirt,/obj/effect/decal/cleanable/dirt,/obj/effect/decal/cleanable/dirt,/obj/effect/decal/cleanable/dirt,/turf/simulated/floor/tiled/techfloor,/area/space)
"s" = (/obj/structure/bed/padded,/obj/structure/bed/padded{buckle_pixel_shift = "x=0;y=8;z=0"; layer = 2.24; pixel_y = 8},/obj/effect/floor_decal/industrial/outline/yellow,/turf/simulated/floor/tiled/steel_ridged,/area/space)
"t" = (/obj/structure/bed/padded,/obj/structure/bed/padded{buckle_pixel_shift = "x=0;y=8;z=0"; layer = 2.24; pixel_y = 8},/obj/effect/floor_decal/industrial/outline/yellow,/obj/machinery/light/small,/turf/simulated/floor/tiled/steel_ridged,/area/space)
"u" = (/obj/effect/floor_decal/industrial/warning/fulltile,/obj/effect/decal/cleanable/dirt,/obj/random/trash,/turf/simulated/floor/tiled/steel_ridged,/area/space)
"w" = (/obj/effect/floor_decal/industrial/warning{dir = 8},/obj/effect/floor_decal/borderfloor{dir = 4},/obj/random/trash,/turf/simulated/floor/tiled/techfloor,/area/space)
"x" = (/obj/effect/floor_decal/industrial/warning/corner{dir = 8},/obj/effect/floor_decal/borderfloor{dir = 5},/turf/simulated/floor/tiled/techfloor,/area/space)
"z" = (/obj/structure/catwalk,/obj/effect/decal/cleanable/dirt,/obj/machinery/atmospherics/pipe/simple/hidden/supply,/obj/machinery/atmospherics/pipe/simple/hidden/scrubbers,/obj/structure/cable/green{d1 = 1; d2 = 2; icon_state = "1-2"},/turf/simulated/floor/plating,/area/space)
"A" = (/obj/structure/catwalk,/obj/random/trash,/obj/machinery/atmospherics/pipe/simple/hidden/supply{dir = 4},/obj/machinery/atmospherics/pipe/simple/hidden/scrubbers{dir = 4},/obj/structure/cable/green{d1 = 4; d2 = 8; icon_state = "4-8"},/turf/simulated/floor/plating,/area/space)
"B" = (/obj/effect/floor_decal/industrial/warning{dir = 4},/obj/effect/floor_decal/borderfloor{dir = 8},/obj/effect/decal/cleanable/generic,/turf/simulated/floor/tiled/techfloor,/area/space)
"C" = (/obj/effect/floor_decal/industrial/warning{dir = 8},/obj/effect/floor_decal/borderfloor{dir = 4},/turf/simulated/floor/tiled/techfloor,/area/space)
"D" = (/obj/effect/floor_decal/industrial/warning/fulltile,/obj/item/stool/padded,/obj/item/stool/padded,/turf/simulated/floor/tiled/steel_ridged,/area/space)
"E" = (/obj/effect/floor_decal/industrial/warning{dir = 4},/obj/effect/floor_decal/borderfloor{dir = 8},/obj/effect/decal/cleanable/dirt,/obj/effect/decal/cleanable/dirt,/turf/simulated/floor/tiled/techfloor,/area/space)
"F" = (/obj/structure/table/standard,/obj/effect/floor_decal/industrial/warning{dir = 1},/obj/effect/floor_decal/borderfloor,/obj/structure/bedsheetbin{pixel_y = 7},/obj/machinery/cell_charger{pixel_x = -3; pixel_y = 2},/obj/item/material/ashtray/plastic{pixel_x = 6; pixel_y = -5},/turf/simulated/floor/tiled/techfloor,/area/space)
"G" = (/obj/effect/floor_decal/industrial/warning{dir = 4},/obj/effect/floor_decal/borderfloor{dir = 8},/obj/effect/decal/cleanable/dirt,/turf/simulated/floor/tiled/techfloor,/area/space)
"H" = (/obj/structure/catwalk,/obj/structure/closet/secure_closet/personal/empty,/obj/random/trash,/obj/machinery/atmospherics/pipe/simple/hidden/supply,/obj/machinery/atmospherics/pipe/simple/hidden/scrubbers,/obj/structure/cable/green{d1 = 1; d2 = 2; icon_state = "1-2"},/turf/simulated/floor/plating,/area/space)
"I" = (/obj/structure/table/standard,/obj/structure/catwalk,/obj/item/reagent_containers/food/drinks/glass2/coffeecup/britcup{pixel_x = -5; pixel_y = 20},/obj/item/reagent_containers/food/drinks/dry_ramen{pixel_x = 4; pixel_y = 10},/obj/machinery/atmospherics/pipe/simple/hidden/supply,/obj/machinery/atmospherics/pipe/simple/hidden/scrubbers,/obj/structure/cable/green{d1 = 1; d2 = 2; icon_state = "1-2"},/turf/simulated/floor/plating,/area/space)
"K" = (/obj/structure/table/standard,/obj/structure/catwalk,/obj/item/towel/random{pixel_x = 4; pixel_y = 7},/obj/item/reagent_containers/food/drinks/glass2/coffeecup/diona{pixel_x = 3},/obj/machinery/atmospherics/pipe/simple/hidden/supply,/obj/machinery/atmospherics/pipe/simple/hidden/scrubbers,/obj/structure/cable/green{d1 = 1; d2 = 2; icon_state = "1-2"},/turf/simulated/floor/plating,/area/space)
"L" = (/obj/effect/floor_decal/industrial/warning/fulltile,/obj/machinery/light/small{dir = 8},/obj/effect/decal/cleanable/dirt,/obj/effect/decal/cleanable/generic,/turf/simulated/floor/tiled/steel_ridged,/area/space)
"M" = (/obj/structure/catwalk,/obj/machinery/atmospherics/pipe/simple/hidden/supply{dir = 4},/obj/machinery/atmospherics/pipe/simple/hidden/scrubbers{dir = 4},/obj/structure/cable/green{d1 = 4; d2 = 8; icon_state = "4-8"},/turf/simulated/floor/plating,/area/space)
"N" = (/obj/structure/table/rack,/obj/effect/floor_decal/industrial/warning{dir = 1},/obj/effect/floor_decal/borderfloor,/turf/simulated/floor/tiled/techfloor,/area/space)
"O" = (/obj/effect/floor_decal/industrial/warning/corner{dir = 1},/obj/effect/floor_decal/borderfloor{dir = 6},/turf/simulated/floor/tiled/techfloor,/area/space)
"P" = (/obj/effect/floor_decal/industrial/warning/corner{dir = 4},/obj/effect/floor_decal/borderfloor{dir = 10},/obj/effect/decal/cleanable/dirt,/turf/simulated/floor/tiled/techfloor,/area/space)
"Q" = (/obj/effect/floor_decal/industrial/warning{dir = 8},/obj/effect/floor_decal/borderfloor{dir = 4},/obj/effect/decal/cleanable/dirt,/turf/simulated/floor/tiled/techfloor,/area/space)
"R" = (/obj/structure/catwalk,/obj/structure/undies_wardrobe,/obj/machinery/atmospherics/pipe/simple/hidden/supply,/obj/machinery/atmospherics/pipe/simple/hidden/scrubbers,/obj/structure/cable/green{d1 = 1; d2 = 2; icon_state = "1-2"},/turf/simulated/floor/plating,/area/space)
"S" = (/obj/structure/table/rack,/obj/effect/floor_decal/industrial/warning,/obj/effect/floor_decal/borderfloor{dir = 1},/turf/simulated/floor/tiled/techfloor,/area/space)
"T" = (/obj/structure/bed/padded,/obj/structure/bed/padded{buckle_pixel_shift = "x=0;y=8;z=0"; layer = 2.24; pixel_y = 8},/obj/effect/floor_decal/industrial/outline/yellow,/obj/machinery/light/small{dir = 1},/turf/simulated/floor/tiled/steel_ridged,/area/space)
"U" = (/obj/structure/catwalk,/obj/item/stool/padded,/obj/machinery/atmospherics/pipe/simple/hidden/supply{dir = 4},/obj/machinery/atmospherics/pipe/simple/hidden/scrubbers{dir = 4},/obj/structure/cable/green{d1 = 4; d2 = 8; icon_state = "4-8"},/turf/simulated/floor/plating,/area/space)
"V" = (/obj/structure/catwalk,/obj/item/stool/padded,/obj/effect/decal/cleanable/dirt,/obj/machinery/atmospherics/pipe/simple/hidden/supply{dir = 4},/obj/machinery/atmospherics/pipe/simple/hidden/scrubbers{dir = 4},/obj/structure/cable/green{d1 = 4; d2 = 8; icon_state = "4-8"},/turf/simulated/floor/plating,/area/space)
"W" = (/obj/structure/bed/padded,/obj/structure/bed/padded{buckle_pixel_shift = "x=0;y=8;z=0"; layer = 2.24; pixel_y = 8},/obj/effect/floor_decal/industrial/outline/yellow,/obj/machinery/firealarm{dir = 8; pixel_x = -24; pixel_y = 6},/obj/effect/decal/cleanable/dirt,/turf/simulated/floor/tiled/steel_ridged,/area/space)
"X" = (/obj/effect/floor_decal/industrial/warning/fulltile,/obj/machinery/light/small{dir = 8},/turf/simulated/floor/tiled/steel_ridged,/area/space)
"Z" = (/obj/structure/catwalk,/obj/random/trash,/obj/random/trash,/obj/random/trash,/obj/machinery/atmospherics/pipe/simple/hidden/supply,/obj/machinery/atmospherics/pipe/simple/hidden/scrubbers,/obj/structure/cable/green{d1 = 1; d2 = 2; icon_state = "1-2"},/turf/simulated/floor/plating,/area/space)

(1,1,1) = {"
jQHBT
sCeos
sCZEc
FOhPN
XuKkp
AViUM
LkIDm
bxRgS
lqzdc
WQeGs
aweGt
"}
