"a" = (/obj/effect/floor_decal/industrial/warning/fulltile,/obj/machinery/chem_master/condimaster{name = "CondiMaster Neo"},/turf/simulated/floor/tiled/techfloor,/area/space)
"c" = (/obj/effect/floor_decal/borderfloor{dir = 4},/obj/effect/floor_decal/industrial/warning{dir = 8},/obj/machinery/atmospherics/pipe/simple/hidden/scrubbers,/obj/structure/cable/green{d1 = 1; d2 = 2; icon_state = "1-2"},/obj/effect/decal/cleanable/dirt,/turf/simulated/floor/tiled/techfloor,/area/space)
"d" = (/obj/effect/floor_decal/techfloor/orange{dir = 1},/obj/effect/floor_decal/techfloor/orange,/obj/machinery/atmospherics/pipe/simple/hidden/supply{dir = 10},/obj/structure/cable/green{d1 = 2; d2 = 8; icon_state = "2-8"},/turf/simulated/floor/tiled/techfloor/grid,/area/space)
"f" = (/obj/effect/floor_decal/industrial/warning/fulltile,/obj/structure/table/standard,/obj/machinery/reagentgrinder/juicer{pixel_x = 3; pixel_y = 17},/obj/item/reagent_containers/dropper{pixel_y = 3},/obj/item/reagent_containers/glass/beaker{pixel_x = 5},/obj/effect/decal/cleanable/dirt,/turf/simulated/floor/tiled/techfloor,/area/space)
"h" = (/obj/effect/floor_decal/industrial/warning/fulltile,/obj/machinery/biogenerator,/obj/machinery/light/small{dir = 8},/turf/simulated/floor/tiled/techfloor,/area/space)
"k" = (/obj/effect/floor_decal/borderfloor{dir = 4},/obj/effect/floor_decal/industrial/warning{dir = 8},/obj/machinery/atmospherics/pipe/simple/hidden/scrubbers,/obj/structure/cable/green{d1 = 1; d2 = 2; icon_state = "1-2"},/turf/simulated/floor/tiled/techfloor,/area/space)
"m" = (/obj/effect/floor_decal/industrial/warning/fulltile,/obj/machinery/smartfridge/drying_rack{dir = 4},/obj/effect/decal/cleanable/dirt,/turf/simulated/floor/tiled/techfloor,/area/space)
"o" = (/obj/structure/catwalk,/obj/effect/decal/cleanable/dirt,/obj/effect/decal/cleanable/generic,/turf/simulated/floor/plating,/area/space)
"p" = (/obj/effect/floor_decal/borderfloor{dir = 8},/obj/effect/floor_decal/industrial/warning{dir = 4},/obj/machinery/atmospherics/pipe/simple/hidden/supply,/obj/structure/cable/green{d1 = 1; d2 = 2; icon_state = "1-2"},/obj/effect/decal/cleanable/dirt,/obj/effect/decal/cleanable/dirt,/obj/effect/decal/cleanable/dirt,/turf/simulated/floor/tiled/techfloor,/area/space)
"r" = (/obj/effect/floor_decal/techfloor/orange{dir = 1},/obj/effect/floor_decal/techfloor/orange,/obj/machinery/atmospherics/pipe/simple/hidden/scrubbers{dir = 8},/obj/structure/cable/green{d1 = 4; d2 = 8; icon_state = "4-8"},/obj/effect/decal/cleanable/dirt,/turf/simulated/floor/tiled/techfloor/grid,/area/space)
"s" = (/obj/effect/floor_decal/techfloor/orange{dir = 1},/obj/effect/floor_decal/techfloor/orange,/obj/machinery/atmospherics/pipe/simple/hidden/scrubbers{dir = 6},/obj/structure/cable/green{d1 = 2; d2 = 4; icon_state = "2-4"},/turf/simulated/floor/tiled/techfloor/grid,/area/space)
"t" = (/obj/effect/floor_decal/industrial/warning/fulltile,/obj/machinery/seed_extractor,/obj/machinery/light/small{dir = 4},/turf/simulated/floor/tiled/techfloor,/area/space)
"u" = (/obj/effect/floor_decal/techfloor/orange{dir = 1},/obj/effect/floor_decal/techfloor/orange,/obj/machinery/atmospherics/pipe/simple/hidden/supply{dir = 9},/obj/structure/cable/green{d1 = 1; d2 = 8; icon_state = "1-8"},/obj/effect/decal/cleanable/dirt,/obj/effect/decal/cleanable/dirt,/turf/simulated/floor/tiled/techfloor/grid,/area/space)
"v" = (/obj/effect/floor_decal/industrial/warning/fulltile,/obj/structure/table/rack,/obj/machinery/light/small{dir = 4},/obj/effect/decal/cleanable/dirt,/obj/item/material/hatchet,/obj/item/material/minihoe,/turf/simulated/floor/tiled/techfloor,/area/space)
"w" = (/obj/effect/floor_decal/industrial/warning/fulltile{color = "#00b8b2"},/obj/machinery/seed_storage/garden{dir = 4},/obj/machinery/light/small{dir = 8},/turf/simulated/floor/tiled/steel_ridged,/area/space)
"z" = (/obj/effect/floor_decal/borderfloor{dir = 8},/obj/effect/floor_decal/industrial/warning{dir = 4},/obj/machinery/atmospherics/pipe/simple/hidden/supply,/obj/structure/cable/green{d1 = 1; d2 = 2; icon_state = "1-2"},/obj/effect/decal/cleanable/generic,/turf/simulated/floor/tiled/techfloor,/area/space)
"A" = (/obj/effect/floor_decal/industrial/warning/fulltile,/obj/machinery/smartfridge/drying_rack{dir = 4},/obj/machinery/light/small{dir = 8},/turf/simulated/floor/tiled/techfloor,/area/space)
"B" = (/obj/effect/floor_decal/techfloor/orange,/obj/effect/floor_decal/techfloor/orange{dir = 1},/obj/machinery/atmospherics/pipe/simple/hidden/supply{dir = 4},/obj/structure/cable/green{d1 = 4; d2 = 8; icon_state = "4-8"},/obj/effect/decal/cleanable/ash,/turf/simulated/floor/tiled/techfloor/grid,/area/space)
"C" = (/obj/structure/catwalk,/obj/machinery/atmospherics/pipe/simple/hidden/scrubbers,/obj/machinery/atmospherics/pipe/simple/hidden/supply,/obj/structure/cable/green{d1 = 1; d2 = 2; icon_state = "1-2"},/obj/effect/decal/cleanable/dirt,/turf/simulated/floor/plating,/area/space)
"D" = (/obj/effect/floor_decal/techfloor/orange{dir = 1},/obj/effect/floor_decal/techfloor/orange,/obj/machinery/atmospherics/pipe/simple/hidden/supply{dir = 4},/obj/structure/cable/green{d1 = 4; d2 = 8; icon_state = "4-8"},/obj/effect/decal/cleanable/dirt,/obj/item/reagent_containers/glass/bucket{pixel_x = -6; pixel_y = 15},/turf/simulated/floor/tiled/techfloor/grid,/area/space)
"F" = (/obj/structure/catwalk,/turf/simulated/floor/plating,/area/space)
"G" = (/obj/effect/floor_decal/borderfloor{dir = 4},/obj/effect/floor_decal/industrial/warning{dir = 8},/obj/machinery/atmospherics/pipe/simple/hidden/scrubbers,/obj/structure/cable/green{d1 = 1; d2 = 2; icon_state = "1-2"},/obj/effect/decal/cleanable/dirt,/obj/effect/decal/cleanable/generic,/turf/simulated/floor/tiled/techfloor,/area/space)
"H" = (/obj/effect/floor_decal/borderfloor{dir = 4},/obj/effect/floor_decal/industrial/warning{dir = 8},/obj/machinery/atmospherics/pipe/simple/hidden/scrubbers,/obj/structure/cable/green{d1 = 1; d2 = 2; icon_state = "1-2"},/obj/effect/decal/cleanable/dirt,/obj/machinery/alarm{dir = 4; pixel_x = -22; req_access = newlist()},/turf/simulated/floor/tiled/techfloor,/area/space)
"I" = (/obj/effect/floor_decal/industrial/warning/fulltile,/obj/structure/table/rack,/obj/effect/decal/cleanable/dirt,/turf/simulated/floor/tiled/techfloor,/area/space)
"J" = (/obj/effect/floor_decal/industrial/outline/blue,/obj/machinery/portable_atmospherics/hydroponics,/obj/effect/decal/cleanable/dirt,/turf/simulated/floor/tiled/steel_ridged,/area/space)
"K" = (/obj/structure/catwalk,/obj/effect/decal/cleanable/dirt,/turf/simulated/floor/plating,/area/space)
"L" = (/obj/effect/floor_decal/industrial/outline/blue,/obj/machinery/portable_atmospherics/hydroponics,/turf/simulated/floor/tiled/steel_ridged,/area/space)
"N" = (/obj/effect/floor_decal/industrial/warning/fulltile{color = "#00b8b2"},/obj/machinery/vending/hydronutrients/generic{dir = 8},/obj/machinery/light/small{dir = 4},/obj/effect/decal/cleanable/dirt,/turf/simulated/floor/tiled/steel_ridged,/area/space)
"O" = (/obj/effect/floor_decal/techfloor/orange,/obj/effect/floor_decal/techfloor/orange{dir = 1},/obj/machinery/atmospherics/pipe/simple/hidden/scrubbers{dir = 9},/obj/machinery/atmospherics/pipe/simple/hidden/supply{dir = 5},/obj/structure/cable/green{d1 = 1; d2 = 8; icon_state = "1-8"},/obj/structure/cable/green{d1 = 1; d2 = 4; icon_state = "1-4"},/turf/simulated/floor/tiled/techfloor/grid,/area/space)
"P" = (/obj/effect/floor_decal/techfloor/orange{dir = 1},/obj/effect/floor_decal/techfloor/orange,/obj/machinery/atmospherics/pipe/simple/hidden/scrubbers{dir = 10},/obj/machinery/atmospherics/pipe/simple/hidden/supply{dir = 6},/obj/structure/cable/green{d1 = 2; d2 = 8; icon_state = "2-8"},/obj/structure/cable/green{d1 = 2; d2 = 4; icon_state = "2-4"},/obj/structure/reagent_dispensers/watertank,/turf/simulated/floor/tiled/techfloor/grid,/area/space)
"Q" = (/obj/effect/decal/cleanable/dirt,/obj/effect/paint/black,/turf/simulated/wall/r_wall,/area/space)
"R" = (/obj/structure/catwalk,/obj/machinery/atmospherics/pipe/simple/hidden/scrubbers,/obj/machinery/atmospherics/pipe/simple/hidden/supply,/obj/structure/cable/green{d1 = 1; d2 = 2; icon_state = "1-2"},/turf/simulated/floor/plating,/area/space)
"S" = (/obj/effect/floor_decal/techfloor/orange{dir = 1},/obj/effect/floor_decal/techfloor/orange,/obj/machinery/atmospherics/pipe/simple/hidden/scrubbers{dir = 5},/obj/structure/cable/green{d1 = 1; d2 = 4; icon_state = "1-4"},/obj/effect/decal/cleanable/dirt,/obj/effect/decal/cleanable/dirt,/obj/effect/decal/cleanable/dirt,/obj/effect/decal/cleanable/dirt,/obj/machinery/firealarm{dir = 8; pixel_x = -24; pixel_y = 6},/turf/simulated/floor/tiled/techfloor/grid,/area/space)
"T" = (/obj/effect/paint/black,/turf/simulated/wall/r_wall,/area/space)
"U" = (/obj/effect/decal/cleanable/dirt,/obj/effect/decal/cleanable/dirt,/obj/effect/paint/black,/turf/simulated/wall/r_wall,/area/space)
"V" = (/obj/effect/floor_decal/techfloor/orange,/obj/effect/floor_decal/techfloor/orange{dir = 1},/obj/machinery/atmospherics/pipe/simple/hidden/scrubbers{dir = 8},/obj/structure/cable/green{d1 = 4; d2 = 8; icon_state = "4-8"},/obj/effect/decal/cleanable/dirt,/turf/simulated/floor/tiled/techfloor/grid,/area/space)
"W" = (/obj/effect/floor_decal/borderfloor{dir = 8},/obj/effect/floor_decal/industrial/warning{dir = 4},/obj/machinery/atmospherics/pipe/simple/hidden/supply,/obj/structure/cable/green{d1 = 1; d2 = 2; icon_state = "1-2"},/turf/simulated/floor/tiled/techfloor,/area/space)

(1,1,1) = {"
mFRFf
AFRFt
sVOBd
GJTJp
cJQLW
cNUwW
kLTLz
HLTLW
SrPDu
hKRFv
aFCoI
"}
