"a" = (/obj/structure/table/rack,/obj/effect/floor_decal/borderfloor{dir = 4},/obj/machinery/light/small{dir = 8},/turf/simulated/floor/tiled/techfloor/grid,/area/template_noop)
"b" = (/obj/effect/floor_decal/floordetail/tiled,/turf/simulated/floor/tiled/steel_grid,/area/template_noop)
"d" = (/obj/effect/floor_decal/borderfloor{dir = 8},/obj/machinery/light/small{dir = 4},/obj/effect/decal/cleanable/generic,/turf/simulated/floor/tiled/techfloor/grid,/area/template_noop)
"e" = (/obj/effect/floor_decal/industrial/hatch/yellow,/obj/machinery/seed_storage/garden,/obj/machinery/atmospherics/pipe/simple/hidden/scrubbers{dir = 8},/obj/machinery/atmospherics/pipe/simple/hidden/supply{dir = 4},/obj/structure/cable/green{d1 = 4; d2 = 8; icon_state = "4-8"},/turf/simulated/floor/tiled/steel_ridged,/area/template_noop)
"f" = (/obj/effect/floor_decal/floordetail/tiled,/obj/effect/decal/cleanable/generic,/turf/simulated/floor/tiled/steel_grid,/area/template_noop)
"g" = (/obj/machinery/chem_master/condimaster{name = "CondiMaster Neo"},/obj/effect/floor_decal/industrial/hatch/yellow,/obj/structure/cable/green{d1 = 4; d2 = 8; icon_state = "4-8"},/obj/structure/cable/green{d1 = 1; d2 = 8; icon_state = "1-8"},/obj/structure/cable/green{d1 = 2; d2 = 8; icon_state = "2-8"},/obj/structure/cable/green{d1 = 2; d2 = 4; icon_state = "2-4"},/obj/structure/cable/green{d1 = 1; d2 = 4; icon_state = "1-4"},/turf/simulated/floor/tiled/steel_ridged,/area/template_noop)
"i" = (/obj/machinery/portable_atmospherics/hydroponics,/obj/effect/floor_decal/industrial/outline/blue,/obj/machinery/light/small,/obj/effect/decal/cleanable/dirt,/turf/simulated/floor/tiled/steel_ridged,/area/template_noop)
"j" = (/obj/effect/floor_decal/industrial/loading{dir = 1; icon_state = "loadingarea"},/turf/simulated/floor/tiled/steel_ridged,/area/template_noop)
"k" = (/obj/structure/table/rack,/obj/effect/floor_decal/borderfloor{dir = 8},/obj/machinery/light/small{dir = 4},/obj/effect/decal/cleanable/dirt,/turf/simulated/floor/tiled/techfloor/grid,/area/template_noop)
"m" = (/obj/structure/table/rack,/obj/effect/floor_decal/borderfloor{dir = 5},/obj/item/reagent_containers/glass/bucket/wood{pixel_x = -3; pixel_y = 17},/obj/item/material/hatchet,/obj/item/material/minihoe,/turf/simulated/floor/tiled/techfloor/grid,/area/template_noop)
"n" = (/obj/structure/catwalk,/obj/machinery/atmospherics/pipe/manifold/hidden/scrubbers{dir = 8},/obj/machinery/atmospherics/pipe/manifold/hidden/supply{dir = 8},/obj/structure/cable/green{d1 = 4; d2 = 8; icon_state = "4-8"},/turf/simulated/floor/plating,/area/template_noop)
"o" = (/obj/machinery/portable_atmospherics/hydroponics,/obj/effect/floor_decal/industrial/outline/blue,/obj/machinery/light/small{dir = 1},/turf/simulated/floor/tiled/steel_ridged,/area/template_noop)
"p" = (/obj/structure/catwalk,/obj/machinery/atmospherics/pipe/manifold/hidden/scrubbers{dir = 4; icon_state = "map-scrubbers"},/obj/machinery/atmospherics/pipe/manifold/hidden/supply{dir = 4},/obj/structure/cable/green{d1 = 4; d2 = 8; icon_state = "4-8"},/turf/simulated/floor/plating,/area/template_noop)
"q" = (/obj/structure/catwalk,/obj/effect/decal/cleanable/dirt,/obj/random/trash,/obj/random/trash,/obj/random/trash,/obj/random/trash,/obj/machinery/atmospherics/pipe/simple/hidden/scrubbers{dir = 8},/obj/machinery/atmospherics/pipe/simple/hidden/supply{dir = 4},/obj/structure/cable/green{d1 = 4; d2 = 8; icon_state = "4-8"},/turf/simulated/floor/plating,/area/template_noop)
"s" = (/obj/structure/catwalk,/obj/machinery/atmospherics/pipe/simple/hidden/scrubbers,/obj/machinery/atmospherics/pipe/simple/hidden/supply,/obj/structure/cable/green{d1 = 1; d2 = 2; icon_state = "1-2"},/turf/simulated/floor/plating,/area/template_noop)
"t" = (/obj/structure/catwalk,/obj/machinery/atmospherics/pipe/manifold/hidden/scrubbers{dir = 1},/obj/machinery/atmospherics/pipe/manifold/hidden/supply{dir = 1},/obj/structure/cable/green{d1 = 1; d2 = 2; icon_state = "1-2"},/turf/simulated/floor/plating,/area/template_noop)
"u" = (/obj/effect/floor_decal/borderfloor{dir = 4},/obj/machinery/light/small{dir = 8},/obj/random/trash,/obj/random/trash,/turf/simulated/floor/tiled/techfloor/grid,/area/template_noop)
"v" = (/obj/machinery/portable_atmospherics/hydroponics,/obj/effect/floor_decal/industrial/outline/blue,/obj/effect/decal/cleanable/dirt,/obj/effect/decal/cleanable/dirt,/turf/simulated/floor/tiled/steel_ridged,/area/template_noop)
"w" = (/obj/machinery/portable_atmospherics/hydroponics,/obj/effect/floor_decal/industrial/outline/blue,/turf/simulated/floor/tiled/steel_ridged,/area/template_noop)
"x" = (/obj/structure/catwalk,/obj/machinery/atmospherics/pipe/simple/hidden/scrubbers{dir = 9},/obj/machinery/atmospherics/pipe/simple/hidden/supply{dir = 9},/turf/simulated/floor/plating,/area/template_noop)
"y" = (/obj/structure/catwalk,/obj/random/trash,/obj/random/trash,/obj/machinery/atmospherics/pipe/simple/hidden/scrubbers{dir = 5},/obj/machinery/atmospherics/pipe/simple/hidden/supply{dir = 5},/turf/simulated/floor/plating,/area/template_noop)
"z" = (/obj/structure/catwalk,/obj/machinery/atmospherics/pipe/simple/hidden/scrubbers{dir = 6},/obj/machinery/atmospherics/pipe/simple/hidden/supply{dir = 6},/turf/simulated/floor/plating,/area/template_noop)
"C" = (/obj/machinery/smartfridge/drying_rack,/obj/effect/floor_decal/industrial/warning/fulltile,/turf/simulated/floor/tiled/steel_grid,/area/template_noop)
"D" = (/obj/machinery/portable_atmospherics/hydroponics,/obj/effect/floor_decal/industrial/outline/blue,/obj/machinery/light/small{dir = 1},/obj/effect/decal/cleanable/dirt,/turf/simulated/floor/tiled/steel_ridged,/area/template_noop)
"E" = (/obj/structure/catwalk,/obj/structure/reagent_dispensers/watertank,/obj/machinery/atmospherics/pipe/simple/hidden/scrubbers{dir = 8},/obj/machinery/atmospherics/pipe/simple/hidden/supply{dir = 4},/obj/structure/cable/green{d1 = 4; d2 = 8; icon_state = "4-8"},/turf/simulated/floor/plating,/area/template_noop)
"F" = (/obj/structure/catwalk,/obj/machinery/atmospherics/pipe/simple/hidden/scrubbers{dir = 8},/obj/machinery/atmospherics/pipe/simple/hidden/supply{dir = 4},/obj/structure/cable/green{d1 = 4; d2 = 8; icon_state = "4-8"},/turf/simulated/floor/plating,/area/template_noop)
"G" = (/obj/structure/catwalk,/obj/machinery/atmospherics/pipe/manifold/hidden/scrubbers,/obj/machinery/atmospherics/pipe/manifold/hidden/supply,/obj/structure/cable/green{d1 = 1; d2 = 2; icon_state = "1-2"},/turf/simulated/floor/plating,/area/template_noop)
"H" = (/obj/effect/floor_decal/borderfloor{dir = 10},/obj/effect/decal/cleanable/dirt,/obj/effect/decal/cleanable/dirt,/obj/effect/decal/cleanable/dirt,/turf/simulated/floor/tiled/techfloor/grid,/area/template_noop)
"I" = (/obj/effect/floor_decal/industrial/loading{dir = 1; icon_state = "loadingarea"},/obj/effect/decal/cleanable/dirt,/obj/random/trash,/turf/simulated/floor/tiled/steel_ridged,/area/template_noop)
"J" = (/obj/effect/floor_decal/floordetail/tiled,/obj/random/trash,/turf/simulated/floor/tiled/steel_grid,/area/template_noop)
"K" = (/obj/structure/catwalk,/obj/random/trash,/obj/machinery/atmospherics/pipe/simple/hidden/scrubbers{dir = 8},/obj/machinery/atmospherics/pipe/simple/hidden/supply{dir = 4},/obj/structure/cable/green{d1 = 4; d2 = 8; icon_state = "4-8"},/turf/simulated/floor/plating,/area/template_noop)
"L" = (/obj/machinery/portable_atmospherics/hydroponics,/obj/effect/floor_decal/industrial/outline/blue,/obj/effect/decal/cleanable/dirt,/turf/simulated/floor/tiled/steel_ridged,/area/template_noop)
"M" = (/obj/effect/floor_decal/industrial/loading,/obj/effect/decal/cleanable/dirt,/turf/simulated/floor/tiled/steel_ridged,/area/template_noop)
"N" = (/obj/machinery/portable_atmospherics/hydroponics,/obj/effect/floor_decal/industrial/outline/blue,/obj/machinery/firealarm{pixel_y = 13},/turf/simulated/floor/tiled/steel_ridged,/area/template_noop)
"O" = (/obj/structure/catwalk,/obj/structure/closet/crate/large/hydroponics,/obj/effect/decal/cleanable/dirt,/obj/machinery/atmospherics/pipe/simple/hidden/scrubbers{dir = 10},/obj/machinery/atmospherics/pipe/simple/hidden/supply{dir = 10},/turf/simulated/floor/plating,/area/template_noop)
"Q" = (/obj/machinery/portable_atmospherics/hydroponics,/obj/effect/floor_decal/industrial/outline/blue,/obj/machinery/alarm{pixel_y = 24; req_access = newlist()},/obj/effect/decal/cleanable/dirt,/turf/simulated/floor/tiled/steel_ridged,/area/template_noop)
"S" = (/obj/effect/floor_decal/borderfloor{dir = 6},/obj/effect/decal/cleanable/dirt,/turf/simulated/floor/tiled/techfloor/grid,/area/template_noop)
"T" = (/obj/effect/floor_decal/floordetail/tiled,/obj/structure/hygiene/drain,/turf/simulated/floor/tiled/steel_grid,/area/template_noop)
"U" = (/obj/effect/floor_decal/floordetail/tiled,/obj/effect/decal/cleanable/dirt,/obj/structure/hygiene/drain,/turf/simulated/floor/tiled/steel_grid,/area/template_noop)
"V" = (/obj/machinery/portable_atmospherics/hydroponics,/obj/effect/floor_decal/industrial/outline/blue,/obj/machinery/light/small,/turf/simulated/floor/tiled/steel_ridged,/area/template_noop)
"W" = (/obj/machinery/smartfridge/drying_rack{dir = 8},/obj/effect/floor_decal/industrial/warning/fulltile,/turf/simulated/floor/tiled/steel_grid,/area/template_noop)
"X" = (/obj/machinery/vending/hydronutrients/generic,/obj/effect/floor_decal/industrial/hatch/yellow,/obj/machinery/atmospherics/pipe/simple/hidden/scrubbers{dir = 8},/obj/machinery/atmospherics/pipe/simple/hidden/supply{dir = 4},/obj/structure/cable/green{d1 = 4; d2 = 8; icon_state = "4-8"},/turf/simulated/floor/tiled/steel_ridged,/area/template_noop)
"Y" = (/obj/machinery/portable_atmospherics/hydroponics,/obj/effect/floor_decal/industrial/outline/blue,/obj/effect/floor_decal/industrial/outline/blue,/turf/simulated/floor/tiled/steel_ridged,/area/template_noop)
"Z" = (/obj/effect/floor_decal/borderfloor{dir = 9},/turf/simulated/floor/tiled/techfloor/grid,/area/template_noop)

(1,1,1) = {"
uNQoCsCDLYk
STjfzGObIbH
FFXKpgnFeEq
mfMbytxJMUZ
awLiWsWVvLd
"}
