"a" = (/turf/simulated/wall/r_wall,/area/space)
"c" = (/obj/effect/floor_decal/industrial/outline/blue,/obj/structure/broken_cryo,/obj/machinery/light/small{dir = 1},/obj/effect/decal/cleanable/cobweb,/turf/simulated/floor/tiled/steel_grid,/area/space)
"f" = (/obj/effect/floor_decal/industrial/outline/blue,/obj/machinery/cryopod{dir = 1},/obj/machinery/light/small,/obj/effect/decal/cleanable/dirt,/obj/effect/decal/cleanable/dirt,/obj/effect/decal/cleanable/cobweb2,/turf/simulated/floor/tiled/steel_grid,/area/space)
"g" = (/obj/structure/catwalk,/obj/machinery/atmospherics/pipe/simple/hidden/scrubbers{dir = 8},/obj/machinery/atmospherics/pipe/simple/hidden/supply{dir = 4},/obj/structure/cable/green{d1 = 4; d2 = 8; icon_state = "4-8"},/obj/effect/decal/cleanable/dirt,/turf/simulated/floor/plating,/area/space)
"h" = (/obj/machinery/computer/cryopod{pixel_y = 26},/obj/machinery/disposal,/obj/effect/floor_decal/industrial/outline/yellow,/turf/simulated/floor/tiled/techfloor/grid,/area/space)
"l" = (/obj/effect/floor_decal/industrial/outline/blue,/obj/machinery/cryopod{dir = 2},/obj/machinery/light/small{dir = 1},/obj/effect/decal/cleanable/dirt,/turf/simulated/floor/tiled/steel_grid,/area/space)
"m" = (/obj/effect/floor_decal/techfloor/orange,/obj/effect/decal/cleanable/dirt,/turf/simulated/floor/tiled/techfloor/grid,/area/space)
"q" = (/obj/effect/floor_decal/techfloor/orange{dir = 9},/obj/item/clothing/accessory/armband/cargo{pixel_x = -13; pixel_y = 7},/turf/simulated/floor/tiled/techfloor,/area/space)
"r" = (/obj/effect/floor_decal/industrial/outline/blue,/obj/structure/broken_cryo{dir = 1},/obj/machinery/light/small,/turf/simulated/floor/tiled/steel_grid,/area/space)
"t" = (/obj/machinery/light/small/red{dir = 1},/turf/simulated/floor/tiled/techfloor/grid,/area/space)
"x" = (/obj/effect/floor_decal/industrial/outline/blue,/obj/machinery/cryopod{dir = 1},/obj/machinery/light/small,/obj/effect/decal/cleanable/dirt,/turf/simulated/floor/tiled/steel_grid,/area/space)
"z" = (/obj/structure/catwalk,/obj/machinery/atmospherics/pipe/simple/hidden/scrubbers{dir = 8},/obj/machinery/atmospherics/pipe/simple/hidden/supply{dir = 4},/obj/structure/cable/green{d1 = 4; d2 = 8; icon_state = "4-8"},/turf/simulated/floor/plating,/area/space)
"B" = (/obj/structure/table/reinforced,/obj/effect/floor_decal/industrial/hatch/yellow,/obj/effect/decal/cleanable/dirt,/obj/effect/decal/cleanable/dirt,/turf/simulated/floor/tiled/techfloor/grid,/area/space)
"C" = (/obj/effect/floor_decal/industrial/loading,/obj/machinery/door/blast/regular{id_tag = "cs_cryo"},/turf/simulated/floor/tiled/steel_ridged,/area/space)
"E" = (/obj/structure/table/reinforced,/obj/effect/floor_decal/industrial/hatch/yellow,/obj/machinery/button/blast_door{id_tag = "cs_cryo"; pixel_y = 23},/obj/item/paper_bin{pixel_x = -4; pixel_y = 5},/obj/item/pen/multi{pixel_x = 10},/turf/simulated/floor/tiled/techfloor/grid,/area/space)
"F" = (/obj/effect/floor_decal/industrial/loading,/obj/machinery/door/blast/regular{id_tag = "cs_cryo"},/obj/effect/decal/cleanable/dirt,/turf/simulated/floor/tiled/steel_ridged,/area/space)
"H" = (/obj/effect/floor_decal/industrial/loading{dir = 1; icon_state = "loadingarea"},/obj/machinery/door/blast/regular{id_tag = "cs_cryo"},/turf/simulated/floor/tiled/steel_ridged,/area/space)
"I" = (/obj/effect/floor_decal/techfloor/orange,/obj/effect/decal/cleanable/generic,/turf/simulated/floor/tiled/techfloor/grid,/area/space)
"O" = (/obj/effect/floor_decal/techfloor/orange{dir = 1},/obj/effect/decal/cleanable/dirt,/obj/effect/decal/cleanable/dirt,/turf/simulated/floor/tiled/techfloor,/area/space)
"Q" = (/obj/effect/decal/cleanable/dirt,/turf/simulated/wall/r_wall,/area/space)
"R" = (/obj/machinery/light/small/red{dir = 1},/obj/random/trash,/obj/random/trash,/turf/simulated/floor/tiled/techfloor/grid,/area/space)
"T" = (/obj/effect/floor_decal/techfloor/orange{dir = 5},/turf/simulated/floor/tiled/techfloor,/area/space)
"U" = (/obj/structure/catwalk,/obj/machinery/atmospherics/pipe/simple/hidden/scrubbers{dir = 8},/obj/machinery/atmospherics/pipe/simple/hidden/supply{dir = 4},/obj/structure/cable/green{d1 = 4; d2 = 8; icon_state = "4-8"},/obj/effect/decal/cleanable/dirt,/obj/random/trash,/turf/simulated/floor/plating,/area/space)

(1,1,1) = {"
acatBhERala
QHQIqOTmQHa
ggUzzzzggzz
aCQFaCQCaCa
araxararafa
"}
