"a" = (/obj/structure/catwalk,/obj/machinery/atmospherics/pipe/simple/hidden/supply{dir = 5},/turf/simulated/floor/plating,/area/space)
"d" = (/obj/effect/floor_decal/industrial/outline/yellow,/obj/structure/closet/crate/large/hydroponics,/turf/simulated/floor/tiled/steel_ridged,/area/space)
"e" = (/obj/effect/floor_decal/industrial/warning{dir = 4},/obj/effect/floor_decal/borderfloorblack{dir = 8},/obj/structure/cable/green{d1 = 4; d2 = 8; icon_state = "4-8"},/turf/simulated/floor/tiled/techfloor,/area/space)
"f" = (/obj/effect/floor_decal/industrial/outline/yellow,/obj/structure/railing/mapped,/obj/structure/table/rack,/obj/random/circuitboard/engineering,/obj/random/circuitboard/engineering,/obj/random/circuitboard/engineering,/turf/simulated/floor/tiled/steel_ridged,/area/space)
"g" = (/obj/structure/catwalk,/obj/effect/decal/cleanable/dirt,/obj/effect/decal/cleanable/dirt,/obj/random/trash,/obj/random/trash,/obj/machinery/atmospherics/pipe/simple/hidden/supply{dir = 4},/turf/simulated/floor/plating,/area/space)
"h" = (/obj/structure/catwalk,/obj/effect/decal/cleanable/dirt,/obj/machinery/light/small/red,/obj/machinery/atmospherics/pipe/simple/hidden/supply{dir = 4},/turf/simulated/floor/plating,/area/space)
"i" = (/obj/structure/catwalk,/obj/effect/decal/cleanable/dirt,/obj/machinery/atmospherics/pipe/simple/hidden/supply{dir = 9},/turf/simulated/floor/plating,/area/space)
"j" = (/obj/effect/floor_decal/industrial/warning{dir = 4},/obj/effect/floor_decal/borderfloorblack{dir = 8},/turf/simulated/floor/tiled/techfloor,/area/space)
"k" = (/obj/effect/floor_decal/industrial/warning{dir = 4},/obj/effect/floor_decal/borderfloor{dir = 8},/obj/effect/decal/cleanable/dirt,/obj/machinery/atmospherics/pipe/simple/hidden/supply,/turf/simulated/floor/tiled/techfloor,/area/space)
"m" = (/obj/effect/floor_decal/industrial/warning{dir = 4},/obj/effect/floor_decal/borderfloorblack{dir = 8},/obj/effect/decal/cleanable/generic,/obj/structure/cable/green{d1 = 4; d2 = 8; icon_state = "4-8"},/turf/simulated/floor/tiled/techfloor,/area/space)
"n" = (/obj/effect/floor_decal/industrial/warning{dir = 8},/obj/effect/floor_decal/borderfloor{dir = 4},/obj/machinery/atmospherics/pipe/simple/hidden/supply,/turf/simulated/floor/tiled/techfloor,/area/space)
"o" = (/obj/structure/catwalk,/obj/random/junkyard/smokes,/obj/machinery/atmospherics/pipe/simple/hidden/supply{dir = 4},/turf/simulated/floor/plating,/area/space)
"p" = (/obj/effect/floor_decal/industrial/outline/yellow,/obj/structure/railing/mapped,/obj/effect/decal/cleanable/dirt,/turf/simulated/floor/tiled/steel_ridged,/area/space)
"q" = (/obj/effect/floor_decal/industrial/outline/yellow,/obj/structure/closet/crate,/obj/random/junkyard/tech_supply,/obj/random/junkyard/tech_supply,/obj/random/junkyard/tech_supply,/obj/random/junkyard/tech_supply,/obj/random/junkyard/tech_supply,/obj/random/junkyard/tech_supply,/obj/random/junkyard/tech_supply,/obj/random/junkyard/tech_supply,/obj/random/junkyard/tech_supply,/obj/random/junkyard/tech_supply,/obj/random/junkyard/tech_supply,/obj/random/contraband{spawn_nothing_percentage = 90},/obj/random/contraband{spawn_nothing_percentage = 90},/turf/simulated/floor/tiled/steel_ridged,/area/space)
"r" = (/obj/effect/floor_decal/industrial/warning{dir = 8},/obj/effect/floor_decal/borderfloor{dir = 4},/obj/machinery/atmospherics/pipe/simple/hidden/scrubbers{dir = 5},/obj/machinery/atmospherics/pipe/simple/hidden/supply{dir = 6},/obj/structure/cable/green{d1 = 4; d2 = 8; icon_state = "4-8"},/turf/simulated/floor/tiled/techfloor,/area/space)
"s" = (/obj/structure/catwalk,/obj/structure/railing/mapped,/obj/machinery/atmospherics/pipe/simple/hidden/scrubbers{dir = 8},/turf/simulated/floor/plating,/area/space)
"t" = (/obj/effect/floor_decal/industrial/outline/yellow,/obj/effect/decal/cleanable/dirt,/obj/structure/cable/green{d1 = 4; d2 = 8; icon_state = "4-8"},/turf/simulated/floor/tiled/steel_ridged,/area/space)
"u" = (/obj/structure/catwalk,/obj/machinery/atmospherics/pipe/simple/hidden/scrubbers{dir = 8},/turf/simulated/floor/plating,/area/space)
"v" = (/obj/effect/floor_decal/industrial/warning{dir = 4},/obj/effect/floor_decal/borderfloorblack{dir = 8},/obj/effect/decal/cleanable/dirt,/obj/item/clothing/glasses/welding{pixel_x = -7; pixel_y = 15},/turf/simulated/floor/tiled/techfloor,/area/space)
"w" = (/obj/effect/floor_decal/industrial/outline/yellow,/obj/structure/closet/crate/secure/gear,/obj/random/circuitboard/shuttle,/obj/random/circuitboard/shuttle,/obj/random/circuitboard/mining,/obj/random/circuitboard/telecomms,/obj/random/circuitboard/telecomms,/obj/random/circuitboard/telecomms,/obj/random/circuitboard/telecomms,/obj/random/circuitboard/telecomms,/obj/structure/cable/green{d1 = 4; d2 = 8; icon_state = "4-8"},/turf/simulated/floor/tiled/steel_ridged,/area/space)
"x" = (/obj/structure/catwalk,/obj/structure/railing/mapped,/obj/effect/decal/cleanable/dirt,/obj/machinery/light/small/red{dir = 1},/obj/machinery/atmospherics/pipe/simple/hidden/scrubbers{dir = 8},/turf/simulated/floor/plating,/area/space)
"y" = (/obj/effect/floor_decal/industrial/outline/yellow,/obj/structure/closet,/obj/effect/decal/cleanable/dirt,/obj/item/clothing/under/frontier/old,/obj/item/clothing/under/frontier/old,/obj/item/clothing/suit/storage/toggle/bomber,/turf/simulated/floor/tiled/steel_ridged,/area/space)
"z" = (/obj/effect/floor_decal/industrial/warning{dir = 8},/obj/effect/floor_decal/borderfloorblack{dir = 4},/turf/simulated/floor/tiled/techfloor,/area/space)
"A" = (/obj/effect/floor_decal/industrial/warning{dir = 8},/obj/effect/floor_decal/borderfloorblack{dir = 4},/obj/structure/closet/crate/medical,/obj/random/junkyard/medical/lite,/obj/random/junkyard/medical/lite,/obj/random/junkyard/medical/lite,/obj/random/junkyard/medical/lite,/obj/random/junkyard/medical/lite,/obj/random/junkyard/medical/lite,/obj/random/junkyard/medical/lite,/obj/random/junkyard/medical/lite,/obj/random/junkyard/medical/lite,/obj/random/junkyard/medical/lite,/obj/random/junkyard/medical/lite,/turf/simulated/floor/tiled/techfloor,/area/space)
"B" = (/obj/effect/floor_decal/industrial/outline/yellow,/obj/structure/table/rack,/obj/random/junkyard/advdevice,/obj/random/junkyard/advdevice,/obj/random/junkyard/bomb_supply,/obj/random/junkyard/bomb_supply,/obj/random/junkyard/bomb_supply,/obj/random/junkyard/bomb_supply,/obj/random/junkyard/bomb_supply,/obj/random/junkyard/tool,/obj/random/junkyard/tool,/obj/random/junkyard/bomb_supply,/turf/simulated/floor/tiled/steel_ridged,/area/space)
"C" = (/obj/effect/floor_decal/industrial/warning{dir = 8},/obj/effect/floor_decal/borderfloor{dir = 4},/obj/machinery/atmospherics/pipe/simple/hidden/scrubbers,/turf/simulated/floor/tiled/techfloor,/area/space)
"D" = (/obj/effect/floor_decal/industrial/outline/yellow,/turf/simulated/floor/tiled/steel_ridged,/area/space)
"E" = (/obj/effect/floor_decal/industrial/outline/yellow,/obj/structure/table/rack,/obj/effect/decal/cleanable/dirt,/obj/structure/cable/green{d1 = 4; d2 = 8; icon_state = "4-8"},/turf/simulated/floor/tiled/steel_ridged,/area/space)
"F" = (/obj/structure/catwalk,/obj/machinery/light/small/red,/obj/machinery/atmospherics/pipe/simple/hidden/supply{dir = 4},/turf/simulated/floor/plating,/area/space)
"G" = (/obj/effect/floor_decal/industrial/warning{dir = 4},/obj/effect/floor_decal/borderfloor{dir = 8},/obj/effect/decal/cleanable/generic,/obj/machinery/atmospherics/pipe/simple/hidden/scrubbers,/turf/simulated/floor/tiled/techfloor,/area/space)
"H" = (/obj/structure/catwalk,/obj/machinery/atmospherics/pipe/simple/hidden/supply{dir = 4},/turf/simulated/floor/plating,/area/space)
"I" = (/obj/structure/catwalk,/obj/random/trash,/obj/machinery/atmospherics/pipe/simple/hidden/scrubbers{dir = 10},/turf/simulated/floor/plating,/area/space)
"J" = (/obj/effect/floor_decal/industrial/outline/yellow,/obj/structure/closet,/obj/effect/decal/cleanable/dirt,/obj/structure/cable/green{d1 = 4; d2 = 8; icon_state = "4-8"},/obj/random/clothing{spawn_nothing_percentage = 50},/obj/random/clothing{spawn_nothing_percentage = 50},/obj/random/clothing{spawn_nothing_percentage = 50},/obj/random/clothing{spawn_nothing_percentage = 50},/obj/random/clothing{spawn_nothing_percentage = 50},/obj/random/clothing{spawn_nothing_percentage = 50},/obj/random/clothing{spawn_nothing_percentage = 50},/turf/simulated/floor/tiled/steel_ridged,/area/space)
"K" = (/obj/machinery/alarm{pixel_y = 24; req_access = newlist()},/obj/machinery/atmospherics/pipe/simple/hidden/scrubbers{dir = 8},/obj/structure/catwalk,/turf/simulated/floor/plating,/area/space)
"M" = (/obj/structure/catwalk,/obj/structure/closet,/obj/machinery/atmospherics/pipe/simple/hidden/supply{dir = 4},/turf/simulated/floor/plating,/area/space)
"N" = (/obj/effect/floor_decal/industrial/outline/yellow,/obj/structure/closet,/obj/random/relic,/obj/structure/cable/green{d1 = 4; d2 = 8; icon_state = "4-8"},/turf/simulated/floor/tiled/steel_ridged,/area/space)
"O" = (/obj/effect/floor_decal/industrial/warning{dir = 4},/obj/effect/floor_decal/borderfloorblack{dir = 8},/obj/effect/decal/cleanable/dirt,/turf/simulated/floor/tiled/techfloor,/area/space)
"P" = (/obj/effect/floor_decal/industrial/warning{dir = 8},/obj/effect/floor_decal/borderfloorblack{dir = 4},/obj/structure/cable/green{d1 = 4; d2 = 8; icon_state = "4-8"},/turf/simulated/floor/tiled/techfloor,/area/space)
"Q" = (/obj/effect/floor_decal/industrial/outline/yellow,/obj/structure/railing/mapped,/obj/structure/closet/toolcloset,/obj/random/junkyard/powercell,/obj/random/junkyard/powercell,/turf/simulated/floor/tiled/steel_ridged,/area/space)
"R" = (/obj/effect/floor_decal/industrial/outline/yellow,/obj/structure/railing/mapped,/turf/simulated/floor/tiled/steel_ridged,/area/space)
"S" = (/obj/structure/catwalk,/obj/structure/railing/mapped,/obj/machinery/light/small/red{dir = 1},/obj/machinery/atmospherics/pipe/simple/hidden/scrubbers{dir = 8},/turf/simulated/floor/plating,/area/space)
"T" = (/obj/structure/catwalk,/obj/structure/closet/crate/trashcart,/obj/effect/decal/cleanable/dirt,/obj/random/trash,/obj/random/trash,/obj/random/trash,/obj/random/trash,/obj/random/trash,/obj/random/trash,/obj/random/trash,/obj/machinery/atmospherics/pipe/simple/hidden/scrubbers{dir = 6},/turf/simulated/floor/plating,/area/space)
"U" = (/obj/structure/catwalk,/obj/structure/railing/mapped,/obj/structure/closet/crate/plastic,/obj/random/mre,/obj/random/mre,/obj/random/mre,/obj/random/mre,/obj/random/mre,/obj/machinery/atmospherics/pipe/simple/hidden/scrubbers{dir = 8},/turf/simulated/floor/plating,/area/space)
"V" = (/obj/machinery/atmospherics/pipe/simple/hidden/scrubbers{dir = 8},/obj/structure/catwalk,/turf/simulated/floor/plating,/area/space)
"W" = (/obj/structure/catwalk,/obj/structure/railing/mapped,/obj/machinery/atmospherics/pipe/simple/hidden/scrubbers{dir = 8},/obj/machinery/firealarm{pixel_y = 13},/turf/simulated/floor/plating,/area/space)
"X" = (/obj/effect/floor_decal/industrial/warning{dir = 4},/obj/effect/floor_decal/borderfloor{dir = 8},/obj/effect/decal/cleanable/dirt,/obj/effect/decal/cleanable/dirt,/obj/machinery/atmospherics/pipe/simple/hidden/scrubbers{dir = 9},/obj/machinery/atmospherics/pipe/simple/hidden/supply{dir = 10},/obj/structure/cable/green{d1 = 4; d2 = 8; icon_state = "4-8"},/turf/simulated/floor/tiled/techfloor,/area/space)
"Y" = (/obj/effect/floor_decal/industrial/outline/yellow,/obj/structure/railing/mapped,/obj/structure/closet/crate/large,/obj/effect/decal/cleanable/dirt,/obj/random/junkyard/material,/obj/random/junkyard/material,/obj/random/junkyard/material,/obj/random/junkyard/material,/obj/random/junkyard/material,/obj/random/junkyard/material,/turf/simulated/floor/tiled/steel_ridged,/area/space)
"Z" = (/obj/machinery/atmospherics/pipe/simple/hidden/supply{dir = 4},/obj/structure/catwalk,/turf/simulated/floor/plating,/area/space)

(1,1,1) = {"
TSWKVsuuUxI
GDqzjBzvydC
XJwPeEPmNtr
kYRAOfzOpQn
ahgHHMZZoFi
"}
