"ay" = (/obj/effect/fluid_mapped,/obj/effect/floor_decal/industrial/warning/corner{dir = 4},/obj/structure/transit_tube{alpha = 150; density = 0; icon_state = "D-SE"},/turf/simulated/floor/tiled/skrell/blue,/area/space)
"ba" = (/obj/structure/catwalk,/obj/structure/transit_tube{alpha = 150; density = 0; icon_state = "N-SE"},/obj/machinery/atmospherics/pipe/simple/hidden/scrubbers{dir = 5},/obj/structure/cable/green{d1 = 1; d2 = 4; icon_state = "1-4"},/turf/simulated/floor/plating,/area/space)
"bE" = (/obj/structure/window/reinforced{dir = 8},/obj/structure/reagent_dispensers/watertank,/obj/effect/floor_decal/industrial/outline/blue,/obj/effect/decal/cleanable/dirt,/turf/simulated/floor/tiled/techfloor/grid,/area/space)
"es" = (/obj/structure/catwalk,/obj/structure/transit_tube/station{alpha = 150; density = 0; dir = 4},/obj/machinery/atmospherics/pipe/simple/hidden/supply{dir = 9},/obj/machinery/atmospherics/pipe/simple/hidden/scrubbers{dir = 10},/obj/structure/cable/green{d1 = 1; d2 = 8; icon_state = "1-8"},/obj/structure/cable/green{d1 = 2; d2 = 8; icon_state = "2-8"},/turf/simulated/floor/plating,/area/space)
"gr" = (/obj/effect/floor_decal/borderfloor/corner{dir = 1},/obj/machinery/light/blue,/turf/simulated/floor/tiled/steel_grid,/area/space)
"hG" = (/obj/structure/catwalk,/obj/structure/transit_tube{alpha = 150; density = 0; icon_state = "S-NW"},/obj/machinery/atmospherics/pipe/simple/hidden/supply{dir = 10},/obj/structure/cable/green{d1 = 2; d2 = 8; icon_state = "2-8"},/turf/simulated/floor/plating,/area/space)
"hY" = (/obj/structure/catwalk,/obj/structure/transit_tube{alpha = 150; density = 0; icon_state = "W-NE"},/obj/machinery/atmospherics/pipe/simple/hidden/scrubbers{dir = 9},/obj/structure/cable/green{d1 = 1; d2 = 8; icon_state = "1-8"},/turf/simulated/floor/plating,/area/space)
"iK" = (/obj/structure/transit_tube{alpha = 150; density = 0; icon_state = "D-NW"},/obj/effect/floor_decal/borderfloor{dir = 9},/obj/effect/decal/cleanable/dirt,/obj/effect/decal/cleanable/generic,/turf/simulated/floor/tiled/steel_grid,/area/space)
"jc" = (/obj/structure/catwalk,/obj/structure/window/reinforced{dir = 1},/obj/structure/transit_tube{alpha = 150; density = 0; icon_state = "W-NE"},/obj/machinery/atmospherics/pipe/simple/hidden/scrubbers{dir = 8},/obj/structure/cable/green{d1 = 4; d2 = 8; icon_state = "4-8"},/obj/effect/decal/cleanable/dirt,/turf/simulated/floor/plating,/area/space)
"jQ" = (/obj/structure/catwalk,/obj/structure/window/reinforced{dir = 4},/obj/structure/transit_tube{alpha = 150; density = 0; icon_state = "D-NW"},/obj/machinery/atmospherics/pipe/simple/hidden/supply{dir = 9},/obj/structure/cable/green{d1 = 1; d2 = 8; icon_state = "1-8"},/turf/simulated/floor/plating,/area/space)
"kU" = (/obj/structure/catwalk,/obj/structure/window/reinforced,/obj/structure/transit_tube{alpha = 150; density = 0; icon_state = "W-SE"},/obj/machinery/atmospherics/pipe/simple/hidden/supply{dir = 4},/obj/structure/cable/green{d1 = 4; d2 = 8; icon_state = "4-8"},/turf/simulated/floor/plating,/area/space)
"li" = (/obj/effect/floor_decal/industrial/warning{dir = 8},/obj/effect/decal/cleanable/dirt,/turf/simulated/floor/tiled/steel_ridged,/area/space)
"lA" = (/obj/structure/catwalk,/obj/structure/window/reinforced{dir = 1},/obj/structure/transit_tube{alpha = 150; density = 0; icon_state = "E-NW"},/obj/machinery/atmospherics/pipe/simple/hidden/scrubbers{dir = 8},/obj/structure/cable/green{d1 = 4; d2 = 8; icon_state = "4-8"},/obj/effect/decal/cleanable/dirt,/turf/simulated/floor/plating,/area/space)
"mc" = (/obj/effect/floor_decal/industrial/warning{dir = 4},/obj/structure/flora/pottedplant/unusual{pixel_y = 10},/obj/effect/decal/cleanable/generic,/turf/simulated/floor/tiled/steel_ridged,/area/space)
"md" = (/obj/structure/catwalk,/obj/structure/transit_tube{alpha = 150; density = 0; icon_state = "E-NW"},/obj/machinery/atmospherics/pipe/simple/hidden/scrubbers{dir = 5},/obj/structure/cable/green{d1 = 1; d2 = 4; icon_state = "1-4"},/turf/simulated/floor/plating,/area/space)
"oO" = (/obj/effect/floor_decal/borderfloor{dir = 10},/obj/effect/decal/cleanable/dirt,/obj/effect/decal/cleanable/generic,/turf/simulated/floor/tiled/steel_grid,/area/space)
"pX" = (/obj/effect/fluid_mapped,/obj/effect/floor_decal/industrial/warning{dir = 4},/turf/simulated/floor/tiled/skrell/blue,/area/space)
"rZ" = (/obj/structure/transit_tube{alpha = 150; density = 0; icon_state = "D-SW"},/obj/effect/floor_decal/borderfloor{dir = 10},/obj/effect/decal/cleanable/dirt,/turf/simulated/floor/tiled/steel_grid,/area/space)
"sd" = (/obj/structure/catwalk,/obj/structure/window/reinforced{dir = 1},/obj/structure/transit_tube{alpha = 150; density = 0; icon_state = "D-NE"},/obj/structure/transit_tube{alpha = 150; density = 0; icon_state = "D-NW"},/obj/machinery/atmospherics/pipe/simple/hidden/scrubbers{dir = 8},/obj/structure/cable/green{d1 = 4; d2 = 8; icon_state = "4-8"},/turf/simulated/floor/plating,/area/space)
"uT" = (/obj/structure/catwalk,/obj/machinery/atmospherics/pipe/simple/hidden/supply{dir = 4},/obj/machinery/atmospherics/pipe/simple/hidden/scrubbers{dir = 8},/obj/structure/cable/green{d1 = 4; d2 = 8; icon_state = "4-8"},/obj/effect/decal/cleanable/dirt,/obj/effect/decal/cleanable/dirt,/turf/simulated/floor/plating,/area/space)
"Ct" = (/obj/effect/floor_decal/industrial/warning{dir = 4},/obj/structure/flora/pottedplant/unusual{pixel_y = 10},/turf/simulated/floor/tiled/steel_ridged,/area/space)
"CT" = (/obj/structure/catwalk,/obj/structure/transit_tube{alpha = 150; density = 0; icon_state = "N-SW"},/obj/machinery/atmospherics/pipe/simple/hidden/scrubbers{dir = 9},/obj/structure/cable/green{d1 = 1; d2 = 8; icon_state = "1-8"},/obj/effect/decal/cleanable/dirt,/turf/simulated/floor/plating,/area/space)
"Eb" = (/obj/structure/catwalk,/obj/structure/transit_tube{alpha = 150; density = 0; icon_state = "W-SE"},/obj/machinery/atmospherics/pipe/simple/hidden/supply{dir = 10},/obj/structure/cable/green{d1 = 2; d2 = 8; icon_state = "2-8"},/obj/effect/decal/cleanable/dirt,/turf/simulated/floor/plating,/area/space)
"EJ" = (/obj/structure/catwalk,/obj/structure/window/reinforced{dir = 8},/obj/structure/transit_tube{alpha = 150; density = 0; icon_state = "D-NE"},/obj/machinery/atmospherics/pipe/simple/hidden/supply{dir = 5},/obj/structure/cable/green{d1 = 1; d2 = 4; icon_state = "1-4"},/turf/simulated/floor/plating,/area/space)
"Fj" = (/obj/effect/fluid_mapped,/obj/effect/floor_decal/industrial/warning/corner{dir = 1},/obj/structure/transit_tube{alpha = 150; density = 0; icon_state = "D-SW"},/turf/simulated/floor/tiled/skrell/blue,/area/space)
"Fn" = (/obj/effect/floor_decal/borderfloor{dir = 6},/turf/simulated/floor/tiled/steel_grid,/area/space)
"Fx" = (/obj/structure/catwalk,/obj/structure/window/reinforced{dir = 4},/obj/structure/transit_tube{alpha = 150; density = 0; icon_state = "D-SW"},/obj/machinery/atmospherics/pipe/simple/hidden/scrubbers{dir = 10},/obj/structure/cable/green{d1 = 2; d2 = 8; icon_state = "2-8"},/turf/simulated/floor/plating,/area/space)
"FC" = (/obj/effect/floor_decal/borderfloor/corner{dir = 8},/obj/machinery/light/blue{dir = 1},/obj/effect/decal/cleanable/dirt,/obj/structure/hygiene/drain,/turf/simulated/floor/tiled/steel_grid,/area/space)
"Ha" = (/obj/effect/fluid_mapped,/obj/effect/floor_decal/industrial/warning{dir = 1},/obj/structure/transit_tube{alpha = 150; density = 0; icon_state = "N-SE-SW"},/turf/simulated/floor/tiled/skrell/blue,/area/space)
"HR" = (/obj/effect/fluid_mapped,/obj/effect/floor_decal/industrial/warning/fulltile,/obj/structure/transit_tube/station{alpha = 150; density = 0; dir = 4},/turf/simulated/floor/tiled/skrell/blue,/area/space)
"Id" = (/obj/structure/window/reinforced{dir = 4},/obj/structure/reagent_dispensers/watertank,/obj/effect/floor_decal/industrial/outline/blue,/turf/simulated/floor/tiled/techfloor/grid,/area/space)
"In" = (/obj/effect/floor_decal/borderfloor{dir = 5},/turf/simulated/floor/tiled/steel_grid,/area/space)
"Iq" = (/obj/effect/floor_decal/industrial/warning{dir = 8},/obj/structure/flora/pottedplant/unusual{pixel_y = 10},/obj/effect/decal/cleanable/dirt,/turf/simulated/floor/tiled/steel_ridged,/area/space)
"IV" = (/obj/structure/catwalk,/obj/machinery/atmospherics/pipe/simple/hidden/supply{dir = 4},/obj/machinery/atmospherics/pipe/simple/hidden/scrubbers{dir = 8},/obj/structure/cable/green{d1 = 4; d2 = 8; icon_state = "4-8"},/obj/effect/decal/cleanable/dirt,/turf/simulated/floor/plating,/area/space)
"Kn" = (/obj/effect/floor_decal/borderfloor/corner{dir = 4},/obj/machinery/light/blue,/obj/structure/hygiene/drain,/turf/simulated/floor/tiled/steel_grid,/area/space)
"Kx" = (/obj/effect/floor_decal/industrial/warning{dir = 8},/turf/simulated/floor/tiled/steel_ridged,/area/space)
"Lh" = (/obj/effect/fluid_mapped,/obj/effect/floor_decal/industrial/warning{dir = 8},/turf/simulated/floor/tiled/skrell/blue,/area/space)
"Mw" = (/obj/effect/fluid_mapped,/obj/effect/floor_decal/industrial/warning/corner{dir = 8},/obj/structure/transit_tube{alpha = 150; density = 0; icon_state = "D-NW"},/turf/simulated/floor/tiled/skrell/blue,/area/space)
"PT" = (/obj/effect/floor_decal/industrial/warning{dir = 8},/obj/structure/flora/pottedplant/unusual{pixel_y = 10},/turf/simulated/floor/tiled/steel_ridged,/area/space)
"PW" = (/obj/structure/catwalk,/obj/structure/window/reinforced{dir = 8},/obj/structure/transit_tube{alpha = 150; density = 0; icon_state = "D-SE"},/obj/machinery/atmospherics/pipe/simple/hidden/scrubbers{dir = 6},/obj/structure/cable/green{d1 = 2; d2 = 4; icon_state = "2-4"},/turf/simulated/floor/plating,/area/space)
"QL" = (/obj/effect/floor_decal/borderfloor/corner,/obj/machinery/light/blue{dir = 1},/turf/simulated/floor/tiled/steel_grid,/area/space)
"Tt" = (/obj/effect/fluid_mapped,/obj/effect/floor_decal/industrial/warning,/obj/structure/transit_tube{alpha = 150; density = 0; icon_state = "S-NE-NW"},/turf/simulated/floor/tiled/skrell/blue,/area/space)
"TP" = (/obj/structure/transit_tube{alpha = 150; density = 0; icon_state = "D-NE"},/obj/effect/floor_decal/borderfloor{dir = 5},/obj/effect/decal/cleanable/dirt,/turf/simulated/floor/tiled/steel_grid,/area/space)
"TU" = (/obj/structure/transit_tube{alpha = 150; density = 0; icon_state = "D-SE"},/obj/effect/floor_decal/borderfloor{dir = 6},/obj/effect/decal/cleanable/dirt,/turf/simulated/floor/tiled/steel_grid,/area/space)
"Uv" = (/obj/effect/floor_decal/industrial/warning{dir = 4},/obj/effect/decal/cleanable/dirt,/turf/simulated/floor/tiled/steel_ridged,/area/space)
"Vm" = (/obj/structure/catwalk,/obj/structure/transit_tube{alpha = 150; density = 0; icon_state = "E-SW"},/obj/machinery/atmospherics/pipe/simple/hidden/supply{dir = 6},/obj/structure/cable/green{d1 = 2; d2 = 4; icon_state = "2-4"},/turf/simulated/floor/plating,/area/space)
"Vx" = (/obj/structure/catwalk,/obj/structure/transit_tube/station{alpha = 150; density = 0; dir = 4},/obj/machinery/atmospherics/pipe/simple/hidden/supply{dir = 5},/obj/machinery/atmospherics/pipe/simple/hidden/scrubbers{dir = 6},/obj/structure/cable/green{d1 = 2; d2 = 4; icon_state = "2-4"},/obj/structure/cable/green{d1 = 1; d2 = 4; icon_state = "1-4"},/obj/effect/decal/cleanable/dirt,/turf/simulated/floor/plating,/area/space)
"Xa" = (/obj/structure/catwalk,/obj/structure/transit_tube{alpha = 150; density = 0; icon_state = "S-NE"},/obj/machinery/atmospherics/pipe/simple/hidden/supply{dir = 6},/obj/structure/cable/green{d1 = 2; d2 = 4; icon_state = "2-4"},/turf/simulated/floor/plating,/area/space)
"Xe" = (/obj/structure/catwalk,/obj/machinery/atmospherics/pipe/simple/hidden/supply{dir = 4},/obj/machinery/atmospherics/pipe/simple/hidden/scrubbers{dir = 8},/obj/structure/cable/green{d1 = 4; d2 = 8; icon_state = "4-8"},/turf/simulated/floor/plating,/area/space)
"Xm" = (/obj/effect/fluid_mapped,/obj/effect/floor_decal/industrial/warning/corner,/obj/structure/transit_tube{alpha = 150; density = 0; icon_state = "D-NE"},/turf/simulated/floor/tiled/skrell/blue,/area/space)
"Xu" = (/obj/effect/floor_decal/borderfloor{dir = 9},/obj/effect/decal/cleanable/dirt,/obj/effect/decal/cleanable/dirt,/obj/effect/decal/cleanable/dirt,/turf/simulated/floor/tiled/steel_grid,/area/space)
"XB" = (/obj/structure/catwalk,/obj/structure/window/reinforced,/obj/structure/transit_tube{alpha = 150; density = 0; icon_state = "D-SE"},/obj/structure/transit_tube{alpha = 150; density = 0; icon_state = "D-SW"},/obj/machinery/atmospherics/pipe/simple/hidden/supply{dir = 4},/obj/structure/cable/green{d1 = 4; d2 = 8; icon_state = "4-8"},/turf/simulated/floor/plating,/area/space)
"XP" = (/obj/structure/catwalk,/obj/structure/window/reinforced,/obj/structure/transit_tube{alpha = 150; density = 0; icon_state = "E-SW"},/obj/machinery/atmospherics/pipe/simple/hidden/supply{dir = 4},/obj/structure/cable/green{d1 = 4; d2 = 8; icon_state = "4-8"},/turf/simulated/floor/plating,/area/space)

(1,1,1) = {"
mcQLTUVmkUXBXPEbrZFCIq
UvFnXajQXmTtMwEJhGoOli
XeIVesIdpXHRLhbEVxuTIV
UvInbaFxayHaFjPWCTXuKx
CtKnTPmdjcsdlAhYiKgrPT
"}
