"a" = (/obj/structure/catwalk,/obj/machinery/firealarm{dir = 8; pixel_x = -24; pixel_y = 6},/obj/effect/decal/cleanable/dirt,/turf/simulated/floor/plating,/area/space)
"b" = (/obj/effect/paint/black,/turf/simulated/wall/r_wall,/area/space)
"c" = (/obj/machinery/atmospherics/pipe/simple/hidden/scrubbers,/obj/structure/cable/green{d1 = 1; d2 = 2; icon_state = "1-2"},/obj/effect/decal/cleanable/dirt,/turf/simulated/floor/bluegrid,/area/space)
"d" = (/obj/effect/decal/cleanable/dirt,/turf/simulated/floor/bluegrid,/area/space)
"g" = (/obj/machinery/atmospherics/pipe/simple/hidden/scrubbers{dir = 9},/obj/structure/cable/green{d1 = 1; d2 = 8; icon_state = "1-8"},/obj/effect/floor_decal/industrial/warning{dir = 1},/turf/simulated/floor/tiled/techmaint,/area/space)
"h" = (/obj/machinery/atmospherics/pipe/simple/hidden/scrubbers{dir = 4},/obj/structure/cable/green{d1 = 4; d2 = 8; icon_state = "4-8"},/obj/effect/floor_decal/industrial/warning{dir = 9},/obj/machinery/light/blue{dir = 1},/obj/effect/decal/cleanable/dirt,/turf/simulated/floor/tiled/techmaint,/area/space)
"k" = (/obj/machinery/atmospherics/pipe/simple/hidden/scrubbers{dir = 4},/obj/structure/cable/green{d1 = 4; d2 = 8; icon_state = "4-8"},/obj/effect/floor_decal/industrial/warning{dir = 10},/obj/machinery/light/blue,/turf/simulated/floor/tiled/techmaint,/area/space)
"n" = (/obj/structure/catwalk,/obj/effect/decal/cleanable/dirt,/turf/simulated/floor/plating,/area/space)
"q" = (/obj/machinery/atmospherics/pipe/simple/hidden/supply{dir = 4},/obj/structure/cable/green{d1 = 4; d2 = 8; icon_state = "4-8"},/obj/effect/floor_decal/industrial/warning{dir = 5},/obj/machinery/light/blue{dir = 1},/turf/simulated/floor/tiled/techmaint,/area/space)
"s" = (/obj/machinery/atmospherics/pipe/simple/hidden/supply,/obj/machinery/atmospherics/pipe/simple/hidden/scrubbers,/obj/structure/cable/green{d1 = 1; d2 = 2; icon_state = "1-2"},/obj/structure/catwalk,/turf/simulated/floor/plating,/area/space)
"t" = (/obj/machinery/atmospherics/pipe/simple/hidden/supply,/obj/machinery/atmospherics/pipe/simple/hidden/scrubbers,/obj/structure/cable/green{d1 = 1; d2 = 2; icon_state = "1-2"},/obj/structure/catwalk,/obj/effect/decal/cleanable/dirt,/obj/effect/decal/cleanable/dirt,/turf/simulated/floor/plating,/area/space)
"w" = (/obj/structure/backup_server,/obj/effect/decal/cleanable/dirt,/turf/simulated/floor/bluegrid,/area/space)
"x" = (/obj/machinery/atmospherics/pipe/simple/hidden/supply,/obj/machinery/atmospherics/pipe/simple/hidden/scrubbers,/obj/structure/cable/green{d1 = 1; d2 = 2; icon_state = "1-2"},/obj/structure/catwalk,/obj/effect/decal/cleanable/dirt,/turf/simulated/floor/plating,/area/space)
"A" = (/turf/simulated/floor/bluegrid,/area/space)
"B" = (/obj/machinery/atmospherics/pipe/simple/hidden/scrubbers{dir = 10},/obj/structure/cable/green{d1 = 2; d2 = 8; icon_state = "2-8"},/obj/effect/floor_decal/industrial/warning,/turf/simulated/floor/tiled/techmaint,/area/space)
"C" = (/obj/structure/catwalk,/turf/simulated/floor/plating,/area/space)
"D" = (/obj/structure/catwalk,/obj/effect/decal/cleanable/dirt,/obj/effect/decal/cleanable/dirt,/turf/simulated/floor/plating,/area/space)
"E" = (/obj/machinery/atmospherics/pipe/simple/hidden/supply{dir = 9},/obj/machinery/atmospherics/pipe/simple/hidden/scrubbers{dir = 5},/obj/structure/cable/green{d1 = 1; d2 = 8; icon_state = "1-8"},/obj/structure/cable/green{d1 = 1; d2 = 4; icon_state = "1-4"},/obj/structure/catwalk,/turf/simulated/floor/plating,/area/space)
"F" = (/obj/machinery/atmospherics/pipe/simple/hidden/supply{dir = 6},/obj/structure/cable/green{d1 = 2; d2 = 4; icon_state = "2-4"},/obj/effect/floor_decal/industrial/warning,/obj/effect/decal/cleanable/dirt,/obj/effect/decal/cleanable/dirt,/turf/simulated/floor/tiled/techmaint,/area/space)
"G" = (/obj/structure/fd/intel_console{pixel_y = 5},/obj/effect/floor_decal/industrial/outline/blue,/turf/simulated/floor/tiled/steel_ridged,/area/space)
"J" = (/obj/machinery/atmospherics/pipe/simple/hidden/supply{dir = 4},/obj/structure/cable/green{d1 = 4; d2 = 8; icon_state = "4-8"},/obj/effect/floor_decal/industrial/warning{dir = 6},/obj/machinery/light/blue,/obj/effect/decal/cleanable/dirt,/turf/simulated/floor/tiled/techmaint,/area/space)
"L" = (/obj/machinery/atmospherics/pipe/simple/hidden/supply{dir = 5},/obj/structure/cable/green{d1 = 1; d2 = 4; icon_state = "1-4"},/obj/effect/floor_decal/industrial/warning{dir = 1},/obj/machinery/alarm{dir = 4; pixel_x = -22; req_access = newlist()},/turf/simulated/floor/tiled/techmaint,/area/space)
"M" = (/obj/effect/decal/cleanable/dirt,/obj/effect/decal/cleanable/dirt,/obj/effect/decal/cleanable/dirt,/turf/simulated/floor/bluegrid,/area/space)
"O" = (/obj/effect/paint/black,/obj/effect/decal/cleanable/dirt,/obj/effect/decal/cleanable/dirt,/turf/simulated/wall/r_wall,/area/space)
"P" = (/obj/machinery/atmospherics/pipe/simple/hidden/scrubbers,/obj/structure/cable/green{d1 = 1; d2 = 2; icon_state = "1-2"},/turf/simulated/floor/bluegrid,/area/space)
"Q" = (/obj/structure/fd/intel_console,/obj/effect/floor_decal/industrial/outline/blue,/turf/simulated/floor/tiled/steel_ridged,/area/space)
"S" = (/obj/structure/backup_server,/obj/effect/decal/cleanable/dirt,/obj/effect/decal/cleanable/dirt,/turf/simulated/floor/bluegrid,/area/space)
"V" = (/obj/machinery/atmospherics/pipe/simple/hidden/supply,/obj/structure/cable/green{d1 = 1; d2 = 2; icon_state = "1-2"},/obj/effect/decal/cleanable/dirt,/turf/simulated/floor/bluegrid,/area/space)
"W" = (/obj/effect/paint/black,/obj/effect/decal/cleanable/dirt,/turf/simulated/wall/r_wall,/area/space)
"X" = (/obj/machinery/atmospherics/pipe/simple/hidden/supply,/obj/structure/cable/green{d1 = 1; d2 = 2; icon_state = "1-2"},/turf/simulated/floor/bluegrid,/area/space)
"Y" = (/obj/structure/backup_server,/turf/simulated/floor/bluegrid,/area/space)
"Z" = (/obj/machinery/atmospherics/pipe/simple/hidden/supply{dir = 10},/obj/machinery/atmospherics/pipe/simple/hidden/scrubbers{dir = 6},/obj/structure/cable/green{d1 = 2; d2 = 4; icon_state = "2-4"},/obj/structure/cable/green{d1 = 2; d2 = 8; icon_state = "2-8"},/obj/structure/catwalk,/obj/effect/decal/cleanable/dirt,/turf/simulated/floor/plating,/area/space)

(1,1,1) = {"
CCxCD
YdxAY
YAtMY
FJEkB
XWQbc
VOWbc
XbGWP
LqZhg
SAsAY
YdsAw
ansCn
"}
