"bY" = (/obj/structure/cable/green{d1 = 4; d2 = 8; icon_state = "4-8"},/obj/effect/floor_decal/industrial/warning{dir = 5},/turf/simulated/floor/tiled/steel_ridged,/area/space)
"cS" = (/obj/structure/cable/yellow{d1 = 1; d2 = 4; icon_state = "1-4"},/obj/effect/decal/cleanable/dirt,/obj/structure/table/rack,/obj/item/stack/material/uranium/ten{pixel_x = 4; pixel_y = 10},/obj/machinery/atmospherics/pipe/simple/hidden/scrubbers,/turf/simulated/floor/tiled/techfloor/grid,/area/space)
"df" = (/obj/machinery/power/terminal,/obj/structure/cable/yellow,/obj/effect/floor_decal/industrial/warning{dir = 4},/obj/effect/floor_decal/industrial/warning{dir = 4},/obj/effect/decal/cleanable/dirt,/obj/effect/decal/cleanable/dirt,/obj/machinery/light/small{dir = 8},/turf/simulated/floor/tiled/steel_ridged,/area/space)
"dv" = (/obj/machinery/power/smes/buildable,/obj/structure/cable/green{d2 = 8; icon_state = "0-8"},/obj/effect/floor_decal/industrial/warning/fulltile,/obj/effect/floor_decal/industrial/warning/corner{dir = 8},/obj/effect/decal/cleanable/cobweb2,/turf/simulated/floor/tiled/steel_grid,/area/space)
"dZ" = (/obj/structure/catwalk,/obj/random/trash,/obj/machinery/atmospherics/pipe/simple/hidden/supply{dir = 10},/turf/simulated/floor/plating,/area/space)
"hh" = (/obj/machinery/atmospherics/pipe/simple/hidden/supply{dir = 9},/obj/structure/catwalk,/turf/simulated/floor/plating,/area/space)
"hn" = (/obj/structure/cable/green{d1 = 1; d2 = 2; icon_state = "1-2"},/obj/structure/cable/green{d1 = 1; d2 = 8; icon_state = "1-8"},/obj/structure/cable/green{d1 = 1; d2 = 4; icon_state = "1-4"},/obj/effect/decal/cleanable/generic,/obj/random/trash,/obj/machinery/atmospherics/pipe/simple/hidden/scrubbers,/obj/machinery/atmospherics/pipe/simple/hidden/supply,/turf/simulated/floor/tiled/steel_grid,/area/space)
"ij" = (/obj/structure/cable/yellow{d1 = 1; d2 = 4; icon_state = "1-4"},/obj/effect/floor_decal/industrial/warning{dir = 4},/turf/simulated/floor/tiled/steel_ridged,/area/space)
"kK" = (/obj/structure/cable/yellow{d1 = 1; d2 = 2; icon_state = "1-2"},/obj/effect/floor_decal/industrial/warning{dir = 8},/turf/simulated/floor/tiled/steel_ridged,/area/space)
"lt" = (/obj/effect/floor_decal/industrial/warning/fulltile,/obj/effect/decal/cleanable/dirt,/obj/effect/decal/cleanable/dirt,/obj/random/trash,/obj/random/trash,/turf/simulated/floor/tiled/steel_grid,/area/space)
"lG" = (/obj/effect/floor_decal/industrial/warning/fulltile,/obj/random/trash,/obj/random/trash,/obj/random/trash,/turf/simulated/floor/tiled/steel_grid,/area/space)
"lO" = (/obj/structure/catwalk,/obj/structure/cable/yellow{d1 = 1; d2 = 8; icon_state = "1-8"},/obj/effect/decal/cleanable/dirt,/obj/effect/decal/cleanable/dirt,/obj/machinery/light/small{dir = 4},/turf/simulated/floor/plating,/area/space)
"lW" = (/obj/structure/catwalk,/obj/machinery/atmospherics/pipe/simple/hidden/supply,/turf/simulated/floor/plating,/area/space)
"mo" = (/obj/structure/cable/green{d1 = 1; d2 = 8; icon_state = "1-8"},/obj/effect/decal/cleanable/dirt,/obj/effect/decal/cleanable/dirt,/obj/effect/decal/cleanable/generic,/obj/random/trash,/obj/structure/table/rack,/obj/machinery/atmospherics/pipe/simple/hidden/supply,/turf/simulated/floor/tiled/techfloor/grid,/area/space)
"my" = (/obj/structure/cable/green{d1 = 1; d2 = 2; icon_state = "1-2"},/obj/effect/decal/cleanable/dirt,/obj/effect/decal/cleanable/dirt,/obj/machinery/atmospherics/pipe/simple/hidden/scrubbers{dir = 10},/obj/machinery/atmospherics/pipe/simple/hidden/supply{dir = 6},/turf/simulated/floor/tiled/steel_grid,/area/space)
"mX" = (/obj/structure/catwalk,/obj/structure/cable/yellow{d1 = 2; d2 = 4; icon_state = "2-4"},/obj/effect/decal/cleanable/dirt,/obj/machinery/light/small{dir = 8},/turf/simulated/floor/plating,/area/space)
"nA" = (/obj/structure/cable/yellow{d1 = 1; d2 = 2; icon_state = "1-2"},/obj/effect/floor_decal/industrial/warning{dir = 4},/obj/machinery/firealarm{dir = 8; pixel_x = -24; pixel_y = 6},/turf/simulated/floor/tiled/steel_ridged,/area/space)
"oN" = (/obj/structure/cable/yellow{d1 = 1; d2 = 2; icon_state = "1-2"},/obj/effect/floor_decal/industrial/warning{dir = 10},/obj/effect/decal/cleanable/dirt,/turf/simulated/floor/tiled/steel_ridged,/area/space)
"oP" = (/obj/machinery/power/smes/buildable,/obj/structure/cable/green{d2 = 4; icon_state = "0-4"},/obj/effect/floor_decal/industrial/warning/fulltile,/obj/effect/floor_decal/industrial/warning/corner{dir = 4},/turf/simulated/floor/tiled/steel_grid,/area/space)
"pd" = (/obj/structure/catwalk,/obj/effect/decal/cleanable/dirt,/obj/effect/decal/cleanable/dirt,/obj/machinery/atmospherics/pipe/simple/hidden/scrubbers,/turf/simulated/floor/plating,/area/space)
"pl" = (/obj/structure/cable/green{d1 = 2; d2 = 4; icon_state = "2-4"},/obj/effect/decal/cleanable/dirt,/obj/structure/table/rack,/obj/machinery/atmospherics/pipe/simple/hidden/scrubbers,/turf/simulated/floor/tiled/techfloor/grid,/area/space)
"qo" = (/obj/machinery/power/terminal,/obj/structure/cable/yellow,/obj/effect/floor_decal/industrial/warning{dir = 8},/obj/machinery/light/small{dir = 4},/turf/simulated/floor/tiled/steel_ridged,/area/space)
"rF" = (/obj/structure/catwalk,/obj/effect/decal/cleanable/dirt,/obj/effect/decal/cleanable/dirt,/obj/machinery/atmospherics/pipe/simple/hidden/scrubbers{dir = 5},/turf/simulated/floor/plating,/area/space)
"rN" = (/obj/structure/cable/yellow{d1 = 2; d2 = 8; icon_state = "2-8"},/obj/structure/table/rack,/obj/item/stack/material/uranium/ten{pixel_y = 10},/obj/item/stack/material/uranium/ten{pixel_y = 1},/obj/item/stack/material/uranium/ten{pixel_y = -8},/obj/machinery/atmospherics/pipe/simple/hidden/supply,/turf/simulated/floor/tiled/techfloor/grid,/area/space)
"th" = (/obj/structure/cable/green{d1 = 4; d2 = 8; icon_state = "4-8"},/obj/effect/floor_decal/industrial/warning{dir = 10},/turf/simulated/floor/tiled/steel_ridged,/area/space)
"tG" = (/obj/structure/cable/green{d1 = 4; d2 = 8; icon_state = "4-8"},/obj/effect/floor_decal/industrial/warning{dir = 9},/obj/effect/decal/cleanable/dirt,/turf/simulated/floor/tiled/steel_ridged,/area/space)
"tV" = (/obj/structure/cable/green{d1 = 2; d2 = 8; icon_state = "2-8"},/obj/effect/floor_decal/industrial/warning/fulltile,/turf/simulated/floor/tiled/steel_grid,/area/space)
"vy" = (/obj/machinery/power/terminal{dir = 1},/obj/structure/cable/yellow{dir = 1},/obj/effect/floor_decal/industrial/warning{dir = 8},/obj/effect/decal/cleanable/dirt,/obj/machinery/light/small{dir = 4},/turf/simulated/floor/tiled/steel_ridged,/area/space)
"vN" = (/obj/structure/catwalk,/obj/structure/cable/yellow{d1 = 1; d2 = 2; icon_state = "1-2"},/obj/machinery/atmospherics/pipe/simple/hidden/supply,/turf/simulated/floor/plating,/area/space)
"xd" = (/obj/structure/catwalk,/obj/structure/cable/green{d1 = 2; d2 = 8; icon_state = "2-8"},/obj/effect/decal/cleanable/dirt,/obj/machinery/atmospherics/pipe/simple/hidden/supply,/turf/simulated/floor/plating,/area/space)
"xA" = (/obj/structure/cable/yellow{d1 = 1; d2 = 2; icon_state = "1-2"},/obj/effect/floor_decal/industrial/warning{dir = 5},/obj/machinery/alarm{dir = 4; pixel_x = -22; req_access = newlist()},/turf/simulated/floor/tiled/steel_ridged,/area/space)
"yG" = (/obj/machinery/power/terminal{dir = 1},/obj/structure/cable/yellow{dir = 1},/obj/effect/floor_decal/industrial/warning{dir = 4},/obj/effect/decal/cleanable/dirt,/obj/effect/decal/cleanable/dirt,/obj/effect/decal/cleanable/dirt,/obj/machinery/light/small{dir = 8},/obj/item/reagent_containers/food/drinks/bottle/vodka{pixel_x = 11; pixel_y = -7},/turf/simulated/floor/tiled/steel_ridged,/area/space)
"zY" = (/obj/structure/catwalk,/obj/structure/cable/yellow{d1 = 1; d2 = 4; icon_state = "1-4"},/obj/machinery/atmospherics/pipe/simple/hidden/supply,/turf/simulated/floor/plating,/area/space)
"BL" = (/obj/machinery/power/port_gen/pacman/super/potato/reactor,/obj/structure/cable/yellow{d2 = 8; icon_state = "0-8"},/obj/effect/floor_decal/industrial/outline/yellow,/obj/machinery/atmospherics/pipe/simple/hidden/scrubbers,/turf/simulated/floor/tiled/techfloor/grid,/area/space)
"Ce" = (/obj/machinery/power/port_gen/pacman/super/potato/reactor,/obj/structure/cable/yellow{d2 = 8; icon_state = "0-8"},/obj/structure/cable/green{d1 = 2; d2 = 4; icon_state = "2-4"},/obj/effect/floor_decal/industrial/outline/yellow,/turf/simulated/floor/tiled/techfloor/grid,/area/space)
"Ch" = (/obj/structure/catwalk,/obj/structure/cable/green{d1 = 1; d2 = 4; icon_state = "1-4"},/obj/machinery/atmospherics/pipe/simple/hidden/scrubbers,/turf/simulated/floor/plating,/area/space)
"Ds" = (/obj/machinery/power/smes/buildable,/obj/structure/cable/green{d2 = 8; icon_state = "0-8"},/obj/effect/floor_decal/industrial/warning/fulltile,/obj/effect/floor_decal/industrial/warning/corner{dir = 1},/turf/simulated/floor/tiled/steel_grid,/area/space)
"DK" = (/obj/structure/catwalk,/obj/item/reagent_containers/glass/bucket{pixel_x = -6; pixel_y = 15},/obj/machinery/atmospherics/pipe/simple/hidden/scrubbers{dir = 6},/turf/simulated/floor/plating,/area/space)
"DM" = (/obj/effect/floor_decal/industrial/warning{dir = 6},/obj/effect/decal/cleanable/generic,/turf/simulated/floor/tiled/steel_ridged,/area/space)
"Gi" = (/obj/machinery/power/smes/buildable,/obj/structure/cable/green{d2 = 4; icon_state = "0-4"},/obj/effect/floor_decal/industrial/warning/fulltile,/obj/effect/floor_decal/industrial/warning/corner,/turf/simulated/floor/tiled/steel_grid,/area/space)
"HF" = (/obj/machinery/power/port_gen/pacman/super/potato/reactor,/obj/structure/cable/yellow{d2 = 4; icon_state = "0-4"},/obj/effect/floor_decal/industrial/outline/yellow,/obj/machinery/atmospherics/pipe/simple/hidden/supply,/turf/simulated/floor/tiled/techfloor/grid,/area/space)
"Ia" = (/obj/structure/cable/green{d1 = 1; d2 = 2; icon_state = "1-2"},/obj/machinery/atmospherics/pipe/simple/hidden/scrubbers{dir = 9},/obj/machinery/atmospherics/pipe/simple/hidden/supply{dir = 5},/turf/simulated/floor/tiled/steel_grid,/area/space)
"IO" = (/obj/effect/floor_decal/industrial/warning{dir = 9},/obj/effect/decal/cleanable/dirt,/turf/simulated/floor/tiled/steel_ridged,/area/space)
"Jh" = (/obj/structure/cable/green{d1 = 4; d2 = 8; icon_state = "4-8"},/obj/effect/floor_decal/industrial/warning{dir = 6},/turf/simulated/floor/tiled/steel_ridged,/area/space)
"Kj" = (/obj/structure/cable/green{d1 = 1; d2 = 2; icon_state = "1-2"},/obj/effect/paint/black,/turf/simulated/wall/r_wall,/area/space)
"Ku" = (/obj/machinery/power/port_gen/pacman/super/potato/reactor,/obj/structure/cable/yellow{d2 = 4; icon_state = "0-4"},/obj/structure/cable/green{d1 = 1; d2 = 8; icon_state = "1-8"},/obj/effect/floor_decal/industrial/outline/yellow,/turf/simulated/floor/tiled/techfloor/grid,/area/space)
"Ls" = (/obj/structure/cable/green{d1 = 1; d2 = 4; icon_state = "1-4"},/obj/effect/floor_decal/industrial/warning/fulltile,/turf/simulated/floor/tiled/steel_grid,/area/space)
"Pj" = (/obj/structure/catwalk,/obj/structure/cable/yellow{d1 = 1; d2 = 2; icon_state = "1-2"},/obj/effect/decal/cleanable/dirt,/obj/effect/decal/cleanable/dirt,/obj/machinery/atmospherics/pipe/simple/hidden/scrubbers,/turf/simulated/floor/plating,/area/space)
"RY" = (/obj/structure/cable/yellow{d1 = 1; d2 = 2; icon_state = "1-2"},/obj/effect/floor_decal/industrial/warning/fulltile,/turf/simulated/floor/tiled/steel_grid,/area/space)
"Sv" = (/obj/structure/catwalk,/obj/structure/cable/yellow{d1 = 2; d2 = 8; icon_state = "2-8"},/obj/effect/decal/cleanable/dirt,/obj/machinery/atmospherics/pipe/simple/hidden/scrubbers,/turf/simulated/floor/plating,/area/space)
"SK" = (/obj/structure/cable/yellow{d1 = 2; d2 = 8; icon_state = "2-8"},/obj/effect/floor_decal/industrial/warning{dir = 8},/obj/effect/decal/cleanable/dirt,/obj/effect/decal/cleanable/dirt,/obj/effect/decal/cleanable/dirt,/turf/simulated/floor/tiled/steel_ridged,/area/space)
"SM" = (/obj/structure/cable/green{d1 = 1; d2 = 2; icon_state = "1-2"},/obj/structure/cable/green{d1 = 2; d2 = 8; icon_state = "2-8"},/obj/structure/cable/green{d1 = 2; d2 = 4; icon_state = "2-4"},/obj/effect/decal/cleanable/dirt,/obj/machinery/atmospherics/pipe/simple/hidden/scrubbers,/obj/machinery/atmospherics/pipe/simple/hidden/supply,/turf/simulated/floor/tiled/steel_grid,/area/space)
"TB" = (/obj/structure/cable/green{d1 = 1; d2 = 2; icon_state = "1-2"},/obj/effect/floor_decal/industrial/loading,/turf/simulated/floor/tiled/steel_grid,/area/space)
"UX" = (/obj/structure/cable/yellow{d1 = 1; d2 = 2; icon_state = "1-2"},/obj/effect/floor_decal/industrial/warning/fulltile,/obj/effect/decal/cleanable/dirt,/turf/simulated/floor/tiled/steel_grid,/area/space)
"Xr" = (/obj/structure/cable/green{d1 = 1; d2 = 2; icon_state = "1-2"},/obj/effect/floor_decal/industrial/loading{dir = 1},/obj/effect/decal/cleanable/dirt,/turf/simulated/floor/tiled/steel_grid,/area/space)

(1,1,1) = {"
GiJhSMthdv
yGDKIadZvy
ijSvTBlWkK
DMPjLsxdoN
lGcSCemoUX
mXBLKjHFlO
RYplKurNlt
xAChtVvNIO
nApdXrzYSK
dfrFmyhhqo
oPbYhntGDs
"}
