"a" = (/obj/effect/floor_decal/industrial/outline/yellow,/obj/machinery/portable_atmospherics/canister/oxygen,/turf/simulated/floor/tiled/steel_ridged,/area/template_noop)
"b" = (/obj/effect/floor_decal/industrial/warning{dir = 4},/turf/simulated/floor/tiled/techfloor,/area/template_noop)
"c" = (/obj/structure/catwalk,/obj/machinery/atmospherics/pipe/simple/hidden/scrubbers,/obj/machinery/atmospherics/pipe/simple/hidden/supply,/obj/structure/cable/green{d1 = 1; d2 = 2; icon_state = "1-2"},/obj/random/trash,/turf/simulated/floor/plating,/area/template_noop)
"d" = (/obj/effect/floor_decal/industrial/outline/yellow,/obj/machinery/portable_atmospherics/canister/nitrogen,/obj/effect/decal/cleanable/dirt,/obj/effect/decal/cleanable/dirt,/obj/effect/decal/cleanable/dirt,/turf/simulated/floor/tiled/steel_ridged,/area/template_noop)
"e" = (/obj/effect/floor_decal/industrial/outline/yellow,/obj/machinery/portable_atmospherics/canister/empty,/obj/effect/decal/cleanable/dirt,/turf/simulated/floor/tiled/steel_ridged,/area/template_noop)
"f" = (/obj/effect/floor_decal/industrial/warning{dir = 6},/turf/simulated/floor/tiled/techfloor,/area/template_noop)
"g" = (/obj/effect/floor_decal/industrial/warning{dir = 5},/obj/effect/decal/cleanable/generic,/turf/simulated/floor/tiled/techfloor,/area/template_noop)
"i" = (/obj/effect/floor_decal/industrial/outline/yellow,/obj/machinery/portable_atmospherics/canister/methyl_bromide,/obj/effect/decal/cleanable/dirt,/obj/effect/decal/cleanable/dirt,/obj/machinery/firealarm{dir = 8; pixel_x = -24; pixel_y = 6},/turf/simulated/floor/tiled/steel_ridged,/area/template_noop)
"j" = (/obj/effect/floor_decal/industrial/warning{dir = 9},/obj/effect/decal/cleanable/dirt,/turf/simulated/floor/tiled/techfloor,/area/template_noop)
"k" = (/obj/machinery/door/firedoor,/obj/effect/decal/cleanable/dirt,/obj/machinery/atmospherics/pipe/simple/hidden/scrubbers,/obj/machinery/atmospherics/pipe/simple/hidden/supply,/obj/structure/cable/green{d1 = 1; d2 = 2; icon_state = "1-2"},/obj/machinery/portable_atmospherics/powered/scrubber/huge/stationary,/obj/effect/floor_decal/borderfloor{dir = 1},/obj/effect/floor_decal/borderfloor,/turf/simulated/floor/tiled/steel_grid,/area/template_noop)
"l" = (/obj/effect/floor_decal/industrial/warning{dir = 10},/obj/effect/decal/cleanable/dirt,/turf/simulated/floor/tiled/techfloor,/area/template_noop)
"m" = (/obj/effect/floor_decal/borderfloor,/obj/effect/floor_decal/borderfloor{dir = 1},/obj/machinery/door/firedoor,/obj/effect/decal/cleanable/dirt,/obj/effect/decal/cleanable/dirt,/turf/simulated/floor/tiled/steel_grid,/area/template_noop)
"n" = (/obj/effect/floor_decal/industrial/warning{dir = 10},/obj/effect/decal/cleanable/dirt,/obj/random/trash,/obj/random/trash,/obj/random/trash,/turf/simulated/floor/tiled/techfloor,/area/template_noop)
"p" = (/obj/effect/floor_decal/industrial/outline/yellow,/obj/machinery/portable_atmospherics/canister/oxygen,/obj/effect/decal/cleanable/dirt,/obj/machinery/light/small/red{dir = 8},/turf/simulated/floor/tiled/steel_ridged,/area/template_noop)
"q" = (/obj/effect/floor_decal/industrial/outline/yellow,/obj/machinery/portable_atmospherics/canister/empty/carbon_dioxide,/obj/machinery/light/small/red{dir = 4},/turf/simulated/floor/tiled/steel_ridged,/area/template_noop)
"r" = (/obj/effect/floor_decal/industrial/outline/yellow,/obj/machinery/portable_atmospherics/canister/nitrogen,/obj/effect/decal/cleanable/dirt,/turf/simulated/floor/tiled/steel_ridged,/area/template_noop)
"s" = (/obj/effect/floor_decal/industrial/outline/yellow,/obj/machinery/portable_atmospherics/canister/empty/oxygen,/obj/machinery/light/small/red{dir = 8},/turf/simulated/floor/tiled/steel_ridged,/area/template_noop)
"t" = (/obj/effect/floor_decal/industrial/warning{dir = 5},/obj/random/trash,/obj/random/trash,/turf/simulated/floor/tiled/techfloor,/area/template_noop)
"u" = (/obj/effect/floor_decal/industrial/warning{dir = 4},/obj/effect/decal/cleanable/dirt,/obj/machinery/portable_atmospherics/powered/scrubber,/turf/simulated/floor/tiled/techfloor,/area/template_noop)
"w" = (/obj/effect/floor_decal/industrial/outline/yellow,/obj/machinery/portable_atmospherics/canister/carbon_dioxide,/obj/effect/decal/cleanable/dirt,/turf/simulated/floor/tiled/steel_ridged,/area/template_noop)
"x" = (/obj/effect/floor_decal/borderfloor,/obj/effect/floor_decal/borderfloor{dir = 1},/obj/structure/railing/mapped,/obj/structure/railing/mapped{dir = 1; icon_state = "railing0-1"},/obj/machinery/door/firedoor,/turf/simulated/floor/tiled/steel_grid,/area/template_noop)
"y" = (/obj/structure/catwalk,/obj/machinery/atmospherics/pipe/simple/hidden/scrubbers,/obj/machinery/atmospherics/pipe/simple/hidden/supply,/obj/structure/cable/green{d1 = 1; d2 = 2; icon_state = "1-2"},/turf/simulated/floor/plating,/area/template_noop)
"z" = (/obj/effect/floor_decal/industrial/warning{dir = 9},/obj/effect/decal/cleanable/dirt,/obj/effect/decal/cleanable/dirt,/turf/simulated/floor/tiled/techfloor,/area/template_noop)
"A" = (/obj/effect/floor_decal/industrial/outline/yellow,/obj/machinery/portable_atmospherics/canister/air,/turf/simulated/floor/tiled/steel_ridged,/area/template_noop)
"B" = (/obj/effect/floor_decal/industrial/warning{dir = 10},/turf/simulated/floor/tiled/techfloor,/area/template_noop)
"C" = (/obj/structure/catwalk,/obj/effect/decal/cleanable/dirt,/obj/machinery/atmospherics/pipe/simple/hidden/scrubbers,/obj/machinery/atmospherics/pipe/simple/hidden/supply,/obj/structure/cable/green{d1 = 1; d2 = 2; icon_state = "1-2"},/turf/simulated/floor/plating,/area/template_noop)
"D" = (/obj/effect/floor_decal/industrial/warning{dir = 5},/obj/effect/decal/cleanable/generic,/obj/machinery/portable_atmospherics/powered/pump/filled,/turf/simulated/floor/tiled/techfloor,/area/template_noop)
"E" = (/obj/effect/floor_decal/borderfloor,/obj/effect/floor_decal/borderfloor{dir = 1},/obj/structure/railing/mapped,/obj/structure/railing/mapped{dir = 1; icon_state = "railing0-1"},/obj/machinery/door/firedoor,/obj/effect/decal/cleanable/generic,/turf/simulated/floor/tiled/steel_grid,/area/template_noop)
"F" = (/obj/effect/floor_decal/borderfloor,/obj/effect/floor_decal/borderfloor{dir = 1},/obj/structure/railing/mapped,/obj/structure/railing/mapped{dir = 1; icon_state = "railing0-1"},/obj/machinery/door/firedoor,/obj/random/trash,/obj/machinery/portable_atmospherics/powered/scrubber,/turf/simulated/floor/tiled/steel_grid,/area/template_noop)
"G" = (/obj/effect/floor_decal/industrial/outline/yellow,/obj/machinery/portable_atmospherics/canister/carbon_dioxide,/turf/simulated/floor/tiled/steel_ridged,/area/template_noop)
"H" = (/obj/effect/floor_decal/industrial/outline/yellow,/obj/machinery/portable_atmospherics/canister/hydrogen,/obj/effect/decal/cleanable/dirt,/turf/simulated/floor/tiled/steel_ridged,/area/template_noop)
"I" = (/obj/effect/floor_decal/industrial/warning{dir = 4},/obj/effect/decal/cleanable/dirt,/turf/simulated/floor/tiled/techfloor,/area/template_noop)
"L" = (/obj/effect/floor_decal/borderfloor,/obj/effect/floor_decal/borderfloor{dir = 1},/obj/machinery/door/firedoor,/turf/simulated/floor/tiled/steel_grid,/area/template_noop)
"N" = (/obj/effect/floor_decal/industrial/outline/yellow,/obj/machinery/portable_atmospherics/canister/carbon_dioxide,/obj/random/trash,/turf/simulated/floor/tiled/steel_ridged,/area/template_noop)
"O" = (/obj/effect/floor_decal/industrial/warning{dir = 6},/obj/effect/decal/cleanable/dirt,/turf/simulated/floor/tiled/techfloor,/area/template_noop)
"Q" = (/obj/effect/floor_decal/industrial/warning{dir = 8},/turf/simulated/floor/tiled/techfloor,/area/template_noop)
"R" = (/obj/effect/floor_decal/borderfloor,/obj/machinery/door/firedoor,/obj/effect/floor_decal/borderfloor{dir = 1},/turf/simulated/floor/tiled/steel_grid,/area/template_noop)
"S" = (/obj/effect/floor_decal/industrial/warning{dir = 6},/obj/effect/decal/cleanable/dirt,/obj/effect/decal/cleanable/dirt,/obj/random/trash,/obj/random/trash,/turf/simulated/floor/tiled/techfloor,/area/template_noop)
"T" = (/obj/effect/floor_decal/industrial/outline/yellow,/obj/machinery/portable_atmospherics/canister/air,/obj/machinery/alarm{dir = 4; pixel_x = -22; req_access = newlist()},/turf/simulated/floor/tiled/steel_ridged,/area/template_noop)
"U" = (/obj/effect/floor_decal/industrial/outline/yellow,/obj/machinery/portable_atmospherics/canister/empty,/turf/simulated/floor/tiled/steel_ridged,/area/template_noop)
"V" = (/obj/machinery/door/firedoor,/obj/machinery/atmospherics/pipe/simple/hidden/scrubbers,/obj/machinery/atmospherics/pipe/simple/hidden/supply,/obj/structure/cable/green{d1 = 1; d2 = 2; icon_state = "1-2"},/obj/machinery/portable_atmospherics/powered/scrubber/huge/stationary,/obj/effect/floor_decal/borderfloor{dir = 1},/obj/effect/floor_decal/borderfloor,/turf/simulated/floor/tiled/steel_grid,/area/template_noop)
"X" = (/obj/effect/floor_decal/industrial/outline/yellow,/obj/machinery/portable_atmospherics/canister/empty/oxygen,/obj/random/trash,/turf/simulated/floor/tiled/steel_ridged,/area/template_noop)
"Y" = (/obj/effect/floor_decal/industrial/warning{dir = 8},/obj/effect/decal/cleanable/dirt,/turf/simulated/floor/tiled/techfloor,/area/template_noop)
"Z" = (/obj/effect/floor_decal/industrial/outline/yellow,/obj/machinery/portable_atmospherics/canister/carbon_dioxide,/obj/machinery/light/small/red{dir = 4},/turf/simulated/floor/tiled/steel_ridged,/area/template_noop)

(1,1,1) = {"
XjyDH
sQcIZ
enyfG
EmVLx
wjCta
AQybd
TlyOr
FLkRx
izygN
pYCuq
aBySU
"}
