"a" = (/obj/effect/floor_decal/industrial/hatch/yellow,/obj/structure/reagent_dispensers/watertank,/turf/simulated/floor/tiled/steel_ridged,/area/space)
"b" = (/obj/structure/window/reinforced{dir = 4},/obj/effect/floor_decal/industrial/warning{dir = 8},/obj/effect/floor_decal/borderfloor{dir = 4},/turf/simulated/floor/tiled/techfloor/grid,/area/space)
"d" = (/obj/effect/floor_decal/industrial/warning{dir = 10},/obj/effect/floor_decal/borderfloor/corner{dir = 4},/turf/simulated/floor/tiled/techfloor/grid,/area/space)
"e" = (/obj/structure/transit_tube{alpha = 150; density = 0; icon_state = "NW-SE"},/obj/effect/floor_decal/industrial/hatch/yellow,/obj/structure/reagent_dispensers/watertank,/turf/simulated/floor/tiled/steel_ridged,/area/space)
"f" = (/obj/structure/transit_tube{alpha = 150; density = 0; icon_state = "NW-SE"},/obj/effect/floor_decal/industrial/hatch/yellow,/obj/structure/reagent_dispensers/watertank,/obj/effect/decal/cleanable/dirt,/turf/simulated/floor/tiled/steel_ridged,/area/space)
"g" = (/obj/structure/hygiene/drain,/obj/effect/floor_decal/industrial/outline/yellow,/turf/simulated/floor/tiled/steel_ridged,/area/space)
"h" = (/obj/structure/window/reinforced{dir = 8},/obj/structure/transit_tube{alpha = 150; density = 0; icon_state = "D-SW"},/obj/effect/floor_decal/industrial/warning{dir = 4},/obj/effect/floor_decal/borderfloor{dir = 8},/turf/simulated/floor/tiled/techfloor/grid,/area/space)
"i" = (/obj/structure/catwalk,/obj/structure/transit_tube{alpha = 150; density = 0; icon_state = "S-NW"},/obj/machinery/atmospherics/pipe/simple/hidden/scrubbers{dir = 4},/obj/machinery/atmospherics/pipe/simple/hidden/supply{dir = 4},/obj/structure/cable/green{d1 = 4; d2 = 8; icon_state = "4-8"},/turf/simulated/floor/plating,/area/space)
"k" = (/obj/structure/catwalk,/obj/machinery/atmospherics/pipe/manifold/hidden/supply{dir = 1},/obj/machinery/atmospherics/pipe/manifold/hidden/scrubbers{dir = 1},/obj/structure/cable/green{d1 = 2; d2 = 4; icon_state = "2-4"},/obj/structure/cable/green{d1 = 2; d2 = 8; icon_state = "2-8"},/turf/simulated/floor/plating,/area/space)
"l" = (/obj/structure/catwalk,/obj/machinery/atmospherics/pipe/manifold/hidden/supply{dir = 4},/obj/machinery/atmospherics/pipe/manifold/hidden/scrubbers{dir = 4},/obj/structure/cable/green{d1 = 1; d2 = 8; icon_state = "1-8"},/obj/structure/cable/green{d1 = 2; d2 = 8; icon_state = "2-8"},/obj/effect/decal/cleanable/dirt,/turf/simulated/floor/plating,/area/space)
"n" = (/obj/structure/window/reinforced,/obj/structure/transit_tube{alpha = 150; density = 0; icon_state = "D-SW"},/obj/effect/floor_decal/industrial/warning{dir = 1},/obj/effect/floor_decal/borderfloor,/turf/simulated/floor/tiled/techfloor/grid,/area/space)
"o" = (/obj/effect/fluid_mapped,/obj/structure/transit_tube{alpha = 150; density = 0; icon_state = "N-S"},/turf/simulated/floor/tiled/skrell/blue,/area/space)
"q" = (/obj/structure/catwalk,/obj/machinery/atmospherics/pipe/simple/hidden/scrubbers,/obj/machinery/atmospherics/pipe/simple/hidden/supply,/obj/structure/cable/green{d1 = 1; d2 = 2; icon_state = "1-2"},/obj/machinery/alarm{dir = 4; pixel_x = -22; req_access = newlist()},/turf/simulated/floor/plating,/area/space)
"s" = (/obj/structure/window/reinforced{dir = 8},/obj/effect/floor_decal/industrial/warning{dir = 4},/obj/effect/floor_decal/borderfloor{dir = 8},/obj/effect/decal/cleanable/dirt,/turf/simulated/floor/tiled/techfloor/grid,/area/space)
"t" = (/obj/effect/fluid_mapped,/obj/structure/transit_tube/station{alpha = 150; density = 0; dir = 4},/turf/simulated/floor/tiled/skrell/blue,/area/space)
"u" = (/obj/structure/catwalk,/obj/machinery/light/blue{dir = 4},/obj/machinery/atmospherics/pipe/simple/hidden/scrubbers{dir = 10},/obj/machinery/atmospherics/pipe/simple/hidden/supply{dir = 10},/obj/structure/cable/green{d1 = 2; d2 = 8; icon_state = "2-8"},/obj/effect/decal/cleanable/dirt,/turf/simulated/floor/plating,/area/space)
"v" = (/obj/structure/transit_tube{alpha = 150; density = 0; icon_state = "S-NW"},/obj/structure/transit_tube{alpha = 150; density = 0; icon_state = "S-NW"},/obj/effect/floor_decal/industrial/warning{dir = 6},/obj/effect/floor_decal/borderfloor/corner{dir = 1},/obj/effect/decal/cleanable/dirt,/turf/simulated/floor/tiled/techfloor/grid,/area/space)
"w" = (/obj/structure/transit_tube{alpha = 150; density = 0; icon_state = "D-NE"},/obj/structure/hygiene/drain,/obj/effect/floor_decal/industrial/outline/yellow,/obj/effect/decal/cleanable/dirt,/turf/simulated/floor/tiled/steel_ridged,/area/space)
"x" = (/obj/structure/catwalk,/obj/structure/transit_tube{alpha = 150; density = 0; icon_state = "D-NE"},/obj/machinery/light/blue{dir = 8},/obj/machinery/atmospherics/pipe/simple/hidden/scrubbers{dir = 6},/obj/machinery/atmospherics/pipe/simple/hidden/supply{dir = 6},/obj/structure/cable/green{d1 = 2; d2 = 4; icon_state = "2-4"},/turf/simulated/floor/plating,/area/space)
"z" = (/obj/structure/window/reinforced{dir = 8},/obj/effect/floor_decal/industrial/warning{dir = 4},/obj/effect/floor_decal/borderfloor{dir = 8},/obj/effect/decal/cleanable/dirt,/obj/effect/decal/cleanable/dirt,/obj/effect/decal/cleanable/dirt,/turf/simulated/floor/tiled/techfloor/grid,/area/space)
"A" = (/obj/structure/transit_tube{alpha = 150; density = 0; icon_state = "D-SW"},/obj/structure/hygiene/drain,/obj/effect/floor_decal/industrial/outline/yellow,/obj/effect/decal/cleanable/dirt,/turf/simulated/floor/tiled/steel_ridged,/area/space)
"B" = (/obj/structure/catwalk,/obj/machinery/atmospherics/pipe/manifold/hidden/supply,/obj/machinery/atmospherics/pipe/manifold/hidden/scrubbers,/obj/structure/cable/green{d1 = 1; d2 = 8; icon_state = "1-8"},/obj/structure/cable/green{d1 = 1; d2 = 4; icon_state = "1-4"},/turf/simulated/floor/plating,/area/space)
"C" = (/obj/structure/catwalk,/obj/machinery/atmospherics/pipe/simple/hidden/scrubbers,/obj/machinery/atmospherics/pipe/simple/hidden/supply,/obj/structure/cable/green{d1 = 1; d2 = 2; icon_state = "1-2"},/turf/simulated/floor/plating,/area/space)
"D" = (/obj/structure/hygiene/drain,/obj/effect/floor_decal/industrial/outline/yellow,/obj/effect/decal/cleanable/dirt,/turf/simulated/floor/tiled/steel_ridged,/area/space)
"E" = (/obj/structure/catwalk,/obj/machinery/light/blue{dir = 8},/obj/machinery/atmospherics/pipe/simple/hidden/scrubbers{dir = 5},/obj/machinery/atmospherics/pipe/simple/hidden/supply{dir = 5},/obj/structure/cable/green{d1 = 1; d2 = 4; icon_state = "1-4"},/obj/effect/decal/cleanable/dirt,/turf/simulated/floor/plating,/area/space)
"G" = (/obj/structure/catwalk,/obj/machinery/atmospherics/pipe/simple/hidden/scrubbers{dir = 4},/obj/machinery/atmospherics/pipe/simple/hidden/supply{dir = 4},/obj/structure/cable/green{d1 = 4; d2 = 8; icon_state = "4-8"},/turf/simulated/floor/plating,/area/space)
"H" = (/obj/effect/fluid_mapped,/obj/structure/transit_tube{alpha = 150; density = 0; icon_state = "N-SE"},/obj/effect/decal/cleanable/dirt,/turf/simulated/floor/tiled/skrell/blue,/area/space)
"J" = (/obj/structure/catwalk,/obj/structure/transit_tube{alpha = 150; density = 0; icon_state = "D-SW"},/obj/machinery/light/blue{dir = 4},/obj/machinery/atmospherics/pipe/simple/hidden/scrubbers{dir = 9},/obj/machinery/atmospherics/pipe/simple/hidden/supply{dir = 9},/obj/structure/cable/green{d1 = 1; d2 = 8; icon_state = "1-8"},/turf/simulated/floor/plating,/area/space)
"M" = (/obj/structure/window/reinforced{dir = 1},/obj/structure/transit_tube{alpha = 150; density = 0; icon_state = "D-NE"},/obj/effect/floor_decal/industrial/warning,/obj/effect/floor_decal/borderfloor{dir = 1},/turf/simulated/floor/tiled/techfloor/grid,/area/space)
"N" = (/obj/effect/fluid_mapped,/obj/structure/transit_tube{alpha = 150; density = 0; icon_state = "S-NW"},/turf/simulated/floor/tiled/skrell/blue,/area/space)
"O" = (/obj/structure/transit_tube{alpha = 150; density = 0; icon_state = "N-SE"},/obj/effect/floor_decal/industrial/warning{dir = 9},/obj/effect/floor_decal/borderfloor/corner,/turf/simulated/floor/tiled/techfloor/grid,/area/space)
"Q" = (/obj/structure/catwalk,/obj/machinery/atmospherics/pipe/simple/hidden/scrubbers,/obj/machinery/atmospherics/pipe/simple/hidden/supply,/obj/structure/cable/green{d1 = 1; d2 = 2; icon_state = "1-2"},/obj/effect/decal/cleanable/dirt,/turf/simulated/floor/plating,/area/space)
"S" = (/obj/effect/floor_decal/industrial/warning{dir = 5},/obj/effect/floor_decal/borderfloor/corner{dir = 8},/turf/simulated/floor/tiled/techfloor/grid,/area/space)
"T" = (/obj/structure/catwalk,/obj/machinery/atmospherics/pipe/simple/hidden/scrubbers,/obj/machinery/atmospherics/pipe/simple/hidden/supply,/obj/structure/cable/green{d1 = 1; d2 = 2; icon_state = "1-2"},/obj/machinery/firealarm{dir = 8; pixel_x = -24; pixel_y = 6},/turf/simulated/floor/plating,/area/space)
"U" = (/obj/structure/catwalk,/obj/machinery/atmospherics/pipe/manifold/hidden/scrubbers{dir = 8},/obj/machinery/atmospherics/pipe/manifold/hidden/supply{dir = 8},/obj/structure/cable/green{d1 = 2; d2 = 4; icon_state = "2-4"},/obj/structure/cable/green{d1 = 1; d2 = 4; icon_state = "1-4"},/turf/simulated/floor/plating,/area/space)
"V" = (/obj/structure/catwalk,/obj/structure/transit_tube{alpha = 150; density = 0; icon_state = "N-SE"},/obj/machinery/atmospherics/pipe/simple/hidden/scrubbers{dir = 4},/obj/machinery/atmospherics/pipe/simple/hidden/supply{dir = 4},/obj/structure/cable/green{d1 = 4; d2 = 8; icon_state = "4-8"},/turf/simulated/floor/plating,/area/space)
"W" = (/obj/structure/window/reinforced{dir = 8},/obj/effect/floor_decal/industrial/warning{dir = 4},/obj/effect/floor_decal/borderfloor{dir = 8},/turf/simulated/floor/tiled/techfloor/grid,/area/space)
"X" = (/obj/structure/window/reinforced{dir = 4},/obj/structure/transit_tube{alpha = 150; density = 0; icon_state = "D-NE"},/obj/effect/floor_decal/industrial/warning{dir = 8},/obj/effect/floor_decal/borderfloor{dir = 4},/turf/simulated/floor/tiled/techfloor/grid,/area/space)

(1,1,1) = {"
eACDa
xiBGu
QOnSC
QXNWQ
QbtsQ
lboWU
CbtzC
qbHhC
TdMvC
EGkVJ
agQwf
"}
