"a" = (/obj/effect/floor_decal/borderfloorblack{dir = 4},/obj/effect/floor_decal/industrial/warning{dir = 8},/turf/simulated/floor/tiled/steel_ridged,/area/space)
"b" = (/turf/simulated/floor/grass,/area/space)
"d" = (/obj/effect/floor_decal/borderfloorblack{dir = 10},/obj/effect/floor_decal/industrial/warning/corner{dir = 4},/obj/effect/decal/cleanable/dirt,/turf/simulated/floor/tiled/steel_ridged,/area/space)
"f" = (/obj/machinery/atmospherics/pipe/simple/hidden/scrubbers{dir = 8},/obj/machinery/atmospherics/pipe/simple/hidden/supply{dir = 4},/obj/structure/cable/green{d1 = 4; d2 = 8; icon_state = "4-8"},/turf/simulated/floor/grass,/area/space)
"g" = (/obj/structure/flora/ausbushes/sparsegrass,/turf/simulated/floor/grass,/area/space)
"i" = (/obj/machinery/light/small{dir = 1},/turf/simulated/floor/grass,/area/space)
"k" = (/obj/structure/catwalk,/obj/structure/railing/mapped{dir = 8; icon_state = "railing0-1"},/obj/machinery/light/small,/turf/simulated/floor/plating,/area/space)
"l" = (/obj/effect/floor_decal/spline/plain/black{dir = 8},/obj/machinery/firealarm{pixel_y = 13},/turf/simulated/floor/grass,/area/space)
"o" = (/obj/structure/flora/ausbushes/brflowers,/obj/item/stool/wood,/turf/simulated/floor/grass,/area/space)
"p" = (/obj/structure/catwalk,/obj/machinery/atmospherics/pipe/simple/hidden/scrubbers{dir = 8},/obj/machinery/atmospherics/pipe/simple/hidden/supply{dir = 4},/obj/structure/cable/green{d1 = 4; d2 = 8; icon_state = "4-8"},/obj/effect/decal/cleanable/dirt,/turf/simulated/floor/plating,/area/space)
"t" = (/obj/item/stack/cable_coil/single{pixel_x = -16; pixel_y = 11},/turf/simulated/floor/grass,/area/space)
"v" = (/obj/effect/floor_decal/spline/plain/black{dir = 8},/obj/machinery/atmospherics/pipe/simple/hidden/scrubbers{dir = 8},/obj/machinery/atmospherics/pipe/simple/hidden/supply{dir = 4},/obj/structure/cable/green{d1 = 4; d2 = 8; icon_state = "4-8"},/turf/simulated/floor/grass,/area/space)
"w" = (/obj/structure/catwalk,/turf/simulated/floor/plating,/area/space)
"x" = (/obj/structure/flora/tree/jungle,/obj/machinery/atmospherics/pipe/simple/hidden/scrubbers{dir = 8},/obj/machinery/atmospherics/pipe/simple/hidden/supply{dir = 4},/obj/structure/cable/green{d1 = 4; d2 = 8; icon_state = "4-8"},/turf/simulated/floor/grass,/area/space)
"y" = (/obj/structure/flora/ausbushes/brflowers,/obj/machinery/alarm{pixel_y = 24; req_access = newlist()},/turf/simulated/floor/grass,/area/space)
"z" = (/obj/effect/floor_decal/spline/plain/black{dir = 4},/obj/machinery/atmospherics/pipe/simple/hidden/scrubbers{dir = 8},/obj/machinery/atmospherics/pipe/simple/hidden/supply{dir = 4},/obj/structure/cable/green{d1 = 4; d2 = 8; icon_state = "4-8"},/turf/simulated/floor/grass,/area/space)
"A" = (/obj/effect/floor_decal/borderfloorblack{dir = 5},/obj/effect/floor_decal/industrial/warning/corner{dir = 8},/turf/simulated/floor/tiled/steel_ridged,/area/space)
"D" = (/obj/effect/floor_decal/borderfloorblack{dir = 6},/obj/effect/floor_decal/industrial/warning/corner{dir = 1},/turf/simulated/floor/tiled/steel_ridged,/area/space)
"F" = (/obj/machinery/light/small,/turf/simulated/floor/grass,/area/space)
"G" = (/obj/structure/flora/ausbushes/sparsegrass,/obj/effect/floor_decal/spline/plain/black{dir = 8},/turf/simulated/floor/grass,/area/space)
"H" = (/obj/structure/catwalk,/obj/structure/railing/mapped{dir = 4; icon_state = "railing0-1"},/obj/machinery/light/small,/obj/effect/decal/cleanable/dirt,/turf/simulated/floor/plating,/area/space)
"I" = (/obj/structure/catwalk,/obj/machinery/atmospherics/pipe/simple/hidden/scrubbers{dir = 8},/obj/machinery/atmospherics/pipe/simple/hidden/supply{dir = 4},/obj/structure/cable/green{d1 = 4; d2 = 8; icon_state = "4-8"},/turf/simulated/floor/plating,/area/space)
"J" = (/obj/item/soap{pixel_x = 14; pixel_y = -20},/turf/simulated/floor/grass,/area/space)
"L" = (/obj/effect/floor_decal/borderfloorblack{dir = 8},/obj/effect/floor_decal/industrial/warning{dir = 4},/obj/effect/decal/cleanable/dirt,/obj/effect/decal/cleanable/dirt,/turf/simulated/floor/tiled/steel_ridged,/area/space)
"M" = (/obj/structure/catwalk,/obj/structure/railing/mapped{dir = 8; icon_state = "railing0-1"},/obj/machinery/light/small{dir = 1},/obj/effect/decal/cleanable/dirt,/turf/simulated/floor/plating,/area/space)
"P" = (/obj/effect/floor_decal/spline/plain/black{dir = 4},/turf/simulated/floor/grass,/area/space)
"Q" = (/obj/structure/catwalk,/obj/effect/decal/cleanable/dirt,/turf/simulated/floor/plating,/area/space)
"R" = (/obj/effect/floor_decal/borderfloorblack{dir = 8},/obj/effect/floor_decal/industrial/warning{dir = 4},/turf/simulated/floor/tiled/steel_ridged,/area/space)
"S" = (/obj/structure/flora/ausbushes/sparsegrass,/obj/effect/floor_decal/spline/plain/black{dir = 4},/turf/simulated/floor/grass,/area/space)
"U" = (/obj/effect/floor_decal/borderfloorblack{dir = 4},/obj/effect/floor_decal/industrial/warning{dir = 8},/obj/effect/decal/cleanable/generic,/turf/simulated/floor/tiled/steel_ridged,/area/space)
"V" = (/obj/structure/catwalk,/obj/structure/railing/mapped{dir = 4; icon_state = "railing0-1"},/obj/machinery/light/small{dir = 1},/turf/simulated/floor/plating,/area/space)
"W" = (/obj/effect/floor_decal/spline/plain/black{dir = 8},/turf/simulated/floor/grass,/area/space)
"Y" = (/obj/effect/floor_decal/borderfloorblack{dir = 9},/obj/effect/floor_decal/industrial/warning/corner,/obj/effect/decal/cleanable/dirt,/obj/effect/decal/cleanable/dirt,/turf/simulated/floor/tiled/steel_ridged,/area/space)
"Z" = (/obj/structure/flora/ausbushes/ywflowers,/obj/machinery/atmospherics/pipe/simple/hidden/scrubbers{dir = 8},/obj/machinery/atmospherics/pipe/simple/hidden/supply{dir = 4},/obj/structure/cable/green{d1 = 4; d2 = 8; icon_state = "4-8"},/turf/simulated/floor/grass,/area/space)

(1,1,1) = {"
UVlyibbbSMR
DQWbbbbbPwd
pIvffxZfzIp
AQGgJotgPwY
aHWgbbFbPkL
"}
