"a" = (/obj/structure/bed/chair/padded/blue{dir = 4},/turf/simulated/floor/tiled/techfloor,/area/space)
"b" = (/obj/structure/reagent_dispensers/water_cooler,/obj/effect/floor_decal/industrial/outline/yellow,/obj/effect/decal/cleanable/dirt,/turf/simulated/floor/tiled/techfloor,/area/space)
"c" = (/obj/structure/bed/chair/padded/blue{dir = 1},/turf/simulated/floor/tiled/techfloor,/area/space)
"d" = (/obj/effect/floor_decal/industrial/warning{dir = 4},/obj/structure/railing/mapped{dir = 4; icon_state = "railing0-1"},/obj/effect/floor_decal/borderfloor{dir = 8},/obj/machinery/atmospherics/pipe/simple/hidden/scrubbers{dir = 8},/obj/machinery/atmospherics/pipe/simple/hidden/supply{dir = 4},/obj/structure/cable/green{d1 = 4; d2 = 8; icon_state = "4-8"},/turf/simulated/floor/tiled/steel_ridged,/area/space)
"e" = (/obj/effect/floor_decal/industrial/warning/corner{dir = 4},/obj/effect/floor_decal/borderfloor{dir = 8},/turf/simulated/floor/tiled/steel_ridged,/area/space)
"f" = (/obj/machinery/atmospherics/pipe/simple/hidden/scrubbers{dir = 8},/obj/machinery/atmospherics/pipe/simple/hidden/supply{dir = 4},/obj/structure/cable/green{d1 = 4; d2 = 8; icon_state = "4-8"},/turf/simulated/floor/tiled/steel_grid,/area/space)
"g" = (/obj/effect/floor_decal/industrial/warning{dir = 4},/obj/structure/railing/mapped{dir = 4; icon_state = "railing0-1"},/obj/effect/floor_decal/borderfloor/corner{dir = 1},/obj/effect/floor_decal/industrial/warning/corner{dir = 8},/obj/effect/decal/cleanable/blood,/turf/simulated/floor/tiled/steel_ridged,/area/space)
"h" = (/obj/effect/floor_decal/industrial/outline/red/iccg,/obj/item/clothing/gloves/boxing{pixel_x = -7; pixel_y = 8},/turf/simulated/floor/tiled/steel_grid,/area/space)
"i" = (/obj/effect/decal/cleanable/cobweb,/turf/simulated/floor/tiled/techfloor,/area/space)
"j" = (/obj/effect/floor_decal/industrial/warning{dir = 1},/obj/structure/railing/mapped{dir = 1; icon_state = "railing0-1"},/obj/effect/decal/cleanable/dirt,/turf/simulated/floor/tiled/techfloor,/area/space)
"k" = (/obj/effect/decal/cleanable/dirt,/turf/simulated/floor/tiled/techfloor,/area/space)
"l" = (/obj/effect/floor_decal/industrial/warning{dir = 1},/obj/structure/railing/mapped{dir = 1; icon_state = "railing0-1"},/obj/effect/decal/cleanable/generic,/turf/simulated/floor/tiled/techfloor,/area/space)
"m" = (/obj/effect/floor_decal/industrial/warning{dir = 1},/obj/structure/railing/mapped{dir = 1; icon_state = "railing0-1"},/obj/effect/decal/cleanable/dirt,/obj/machinery/light/small,/turf/simulated/floor/tiled/techfloor,/area/space)
"n" = (/obj/structure/fitness/punchingbag,/obj/effect/floor_decal/industrial/outline/yellow,/obj/effect/decal/cleanable/dirt,/obj/machinery/light/small{dir = 1},/turf/simulated/floor/tiled/techfloor,/area/space)
"o" = (/obj/effect/floor_decal/industrial/warning/corner,/obj/effect/floor_decal/borderfloor{dir = 8},/turf/simulated/floor/tiled/steel_ridged,/area/space)
"p" = (/obj/effect/decal/cleanable/dirt,/obj/machinery/atmospherics/pipe/simple/hidden/scrubbers{dir = 8},/obj/machinery/atmospherics/pipe/simple/hidden/supply{dir = 4},/obj/structure/cable/green{d1 = 4; d2 = 8; icon_state = "4-8"},/turf/simulated/floor/tiled/techfloor,/area/space)
"q" = (/obj/structure/bed/chair/padded/blue{dir = 8},/obj/effect/decal/cleanable/dirt,/turf/simulated/floor/tiled/techfloor,/area/space)
"r" = (/obj/structure/fitness/weightlifter,/obj/effect/floor_decal/industrial/hatch/yellow,/obj/machinery/atmospherics/pipe/simple/hidden/scrubbers{dir = 8},/obj/machinery/atmospherics/pipe/simple/hidden/supply{dir = 4},/obj/structure/cable/green{d1 = 4; d2 = 8; icon_state = "4-8"},/turf/simulated/floor/tiled/techfloor,/area/space)
"s" = (/obj/machinery/vending/fitness{dir = 1},/obj/effect/floor_decal/industrial/hatch/yellow,/turf/simulated/floor/tiled/techfloor,/area/space)
"t" = (/obj/effect/floor_decal/borderfloor{dir = 1},/obj/effect/floor_decal/industrial/warning,/obj/effect/decal/cleanable/dirt,/turf/simulated/floor/tiled/steel_ridged,/area/space)
"u" = (/obj/effect/floor_decal/industrial/warning{dir = 8},/obj/structure/railing/mapped{dir = 8; icon_state = "railing0-1"},/obj/effect/floor_decal/borderfloor{dir = 4},/obj/effect/decal/cleanable/generic,/obj/machinery/atmospherics/pipe/simple/hidden/scrubbers{dir = 8},/obj/machinery/atmospherics/pipe/simple/hidden/supply{dir = 4},/obj/structure/cable/green{d1 = 4; d2 = 8; icon_state = "4-8"},/turf/simulated/floor/tiled/steel_ridged,/area/space)
"v" = (/obj/effect/decal/cleanable/generic,/turf/simulated/floor/tiled/techfloor,/area/space)
"w" = (/obj/structure/table/standard,/obj/machinery/light/small,/turf/simulated/floor/tiled/techfloor,/area/space)
"x" = (/obj/structure/fitness/weightlifter,/obj/effect/floor_decal/industrial/hatch/yellow,/obj/effect/decal/cleanable/dirt,/obj/machinery/atmospherics/pipe/simple/hidden/scrubbers{dir = 8},/obj/machinery/atmospherics/pipe/simple/hidden/supply{dir = 4},/obj/structure/cable/green{d1 = 4; d2 = 8; icon_state = "4-8"},/turf/simulated/floor/tiled/techfloor,/area/space)
"y" = (/obj/effect/floor_decal/industrial/warning,/obj/structure/railing/mapped,/turf/simulated/floor/tiled/techfloor,/area/space)
"z" = (/obj/effect/decal/cleanable/blood,/turf/simulated/floor/tiled/steel_grid,/area/space)
"B" = (/obj/effect/floor_decal/industrial/warning/corner{dir = 1},/obj/effect/floor_decal/borderfloor{dir = 4},/turf/simulated/floor/tiled/steel_ridged,/area/space)
"C" = (/obj/effect/floor_decal/industrial/warning{dir = 8},/obj/structure/railing/mapped{dir = 8; icon_state = "railing0-1"},/obj/effect/floor_decal/borderfloor/corner{dir = 4},/obj/effect/floor_decal/industrial/warning/corner,/turf/simulated/floor/tiled/steel_ridged,/area/space)
"D" = (/obj/effect/floor_decal/industrial/warning{dir = 4},/obj/structure/railing/mapped{dir = 4; icon_state = "railing0-1"},/obj/effect/floor_decal/borderfloor/corner{dir = 8},/obj/effect/floor_decal/industrial/warning/corner{dir = 1},/turf/simulated/floor/tiled/steel_ridged,/area/space)
"E" = (/obj/structure/table/standard,/obj/effect/decal/cleanable/dirt,/obj/machinery/light/small{dir = 1},/turf/simulated/floor/tiled/techfloor,/area/space)
"J" = (/obj/effect/floor_decal/borderfloor{dir = 1},/obj/effect/floor_decal/industrial/warning,/obj/effect/decal/cleanable/dirt,/obj/effect/decal/cleanable/dirt,/turf/simulated/floor/tiled/steel_ridged,/area/space)
"L" = (/obj/effect/floor_decal/borderfloor{dir = 1},/obj/effect/floor_decal/industrial/warning,/turf/simulated/floor/tiled/steel_ridged,/area/space)
"N" = (/obj/effect/floor_decal/industrial/warning/corner{dir = 8},/obj/effect/floor_decal/borderfloor{dir = 4},/turf/simulated/floor/tiled/steel_ridged,/area/space)
"O" = (/obj/effect/floor_decal/borderfloor,/obj/effect/floor_decal/industrial/warning{dir = 1},/turf/simulated/floor/tiled/steel_ridged,/area/space)
"S" = (/obj/machinery/vending/coffee{dir = 1},/obj/effect/floor_decal/industrial/hatch/yellow,/obj/machinery/light/small,/turf/simulated/floor/tiled/techfloor,/area/space)
"U" = (/obj/effect/floor_decal/industrial/outline/blue,/obj/item/clothing/gloves/boxing/blue{pixel_x = 4; pixel_y = 18},/obj/effect/decal/cleanable/dirt,/turf/simulated/floor/tiled/steel_grid,/area/space)
"V" = (/turf/simulated/floor/tiled/steel_grid,/area/space)
"W" = (/obj/effect/decal/cleanable/dirt,/obj/machinery/atmospherics/pipe/simple/hidden/scrubbers{dir = 8},/obj/machinery/atmospherics/pipe/simple/hidden/supply{dir = 4},/obj/structure/cable/green{d1 = 4; d2 = 8; icon_state = "4-8"},/turf/simulated/floor/tiled/steel_grid,/area/space)
"X" = (/obj/effect/floor_decal/borderfloor,/obj/effect/floor_decal/industrial/warning{dir = 1},/obj/effect/decal/cleanable/dirt,/turf/simulated/floor/tiled/steel_ridged,/area/space)
"Y" = (/obj/effect/floor_decal/industrial/warning{dir = 8},/obj/structure/railing/mapped{dir = 8; icon_state = "railing0-1"},/obj/effect/floor_decal/borderfloor/corner,/obj/effect/floor_decal/industrial/warning/corner{dir = 4},/turf/simulated/floor/tiled/steel_ridged,/area/space)
"Z" = (/obj/effect/floor_decal/industrial/warning,/obj/structure/railing/mapped,/obj/machinery/light/small{dir = 1},/turf/simulated/floor/tiled/techfloor,/area/space)

(1,1,1) = {"
invoyZyNqEb
tLLghVVCLJJ
rprdfWWuxpx
OOODVzUYOOX
awcejmlBkSs
"}
