"a" = (/obj/structure/closet/secure_closet/personal/empty,/obj/effect/floor_decal/industrial/hatch/blue,/obj/item/clothing/under/bathrobe,/obj/item/clothing/under/bathrobe,/turf/simulated/floor/tiled/old_cargo,/area/space)
"b" = (/obj/structure/table/standard,/obj/item/lipstick/random{pixel_x = 5; pixel_y = 7},/obj/item/storage/box/detergent{pixel_x = -5; pixel_y = 5},/turf/simulated/floor/tiled/old_cargo,/area/space)
"c" = (/obj/effect/decal/cleanable/dirt,/obj/machinery/atmospherics/pipe/simple/hidden/scrubbers{dir = 4},/obj/machinery/atmospherics/pipe/simple/hidden/supply{dir = 4},/obj/structure/cable/green{d1 = 4; d2 = 8; icon_state = "4-8"},/turf/simulated/floor/tiled/old_tile,/area/space)
"d" = (/obj/effect/floor_decal/spline/plain/green{dir = 4},/obj/structure/closet/secure_closet/personal/empty,/obj/effect/floor_decal/industrial/hatch/blue,/obj/item/clothing/under/bathrobe,/obj/item/clothing/under/bathrobe,/obj/effect/decal/cleanable/dirt,/turf/simulated/floor/tiled/old_cargo,/area/space)
"f" = (/obj/structure/hygiene/faucet,/turf/simulated/floor/pool,/area/space)
"g" = (/obj/effect/catwalk_plated/white,/obj/machinery/atmospherics/pipe/simple/hidden/scrubbers,/obj/structure/cable/green{d1 = 1; d2 = 2; icon_state = "1-2"},/turf/simulated/floor/plating,/area/space)
"k" = (/obj/effect/floor_decal/borderfloorwhite,/turf/simulated/floor/tiled/old_tile,/area/space)
"l" = (/obj/effect/floor_decal/spline/plain/green{dir = 4},/obj/structure/table/standard,/obj/item/towel/random{pixel_y = 12},/obj/item/towel/random{pixel_y = 6},/obj/item/towel/random,/obj/item/towel/random,/turf/simulated/floor/tiled/old_cargo,/area/space)
"m" = (/obj/effect/catwalk_plated/white,/obj/machinery/atmospherics/pipe/simple/hidden/supply{dir = 5},/obj/structure/cable/green{d1 = 1; d2 = 4; icon_state = "1-4"},/turf/simulated/floor/plating,/area/space)
"o" = (/obj/effect/floor_decal/borderfloorwhite{dir = 10},/obj/structure/bed/roller/ironingboard,/obj/item/ironingiron{pixel_x = 5; pixel_y = -3},/turf/simulated/floor/tiled/old_tile,/area/space)
"p" = (/obj/effect/floor_decal/borderfloorwhite{dir = 1},/obj/effect/decal/cleanable/dirt,/turf/simulated/floor/tiled/old_tile,/area/space)
"q" = (/obj/effect/floor_decal/spline/plain/green{dir = 8},/obj/machinery/washing_machine,/obj/machinery/washing_machine{layer = 4.08; pixel_y = 19},/turf/simulated/floor/tiled/old_cargo,/area/space)
"r" = (/obj/effect/catwalk_plated/white,/obj/machinery/atmospherics/pipe/simple/hidden/scrubbers{dir = 6},/obj/structure/cable/green{d1 = 2; d2 = 4; icon_state = "2-4"},/turf/simulated/floor/plating,/area/space)
"u" = (/obj/effect/floor_decal/borderfloorwhite,/obj/effect/decal/cleanable/dirt,/turf/simulated/floor/tiled/old_tile,/area/space)
"v" = (/obj/effect/floor_decal/spline/plain/green{dir = 8},/obj/effect/decal/cleanable/dirt,/turf/simulated/floor/tiled/old_cargo,/area/space)
"w" = (/obj/effect/floor_decal/spline/plain/green{dir = 8},/obj/structure/hygiene/sink{dir = 1; pixel_y = 16},/obj/effect/floor_decal/industrial/outline/blue{color = "#50a0d3"},/turf/simulated/floor/tiled/old_cargo,/area/space)
"x" = (/obj/effect/floor_decal/borderfloorwhite{dir = 8},/obj/effect/decal/cleanable/dirt,/obj/effect/decal/cleanable/dirt,/obj/machinery/atmospherics/pipe/simple/hidden/scrubbers{dir = 4},/obj/machinery/atmospherics/pipe/simple/hidden/supply{dir = 4},/obj/structure/cable/green{d1 = 4; d2 = 8; icon_state = "4-8"},/turf/simulated/floor/tiled/old_tile,/area/space)
"y" = (/turf/simulated/floor/pool,/area/space)
"z" = (/obj/effect/catwalk_plated/white,/obj/machinery/atmospherics/pipe/simple/hidden/scrubbers{dir = 9},/obj/machinery/atmospherics/pipe/simple/hidden/supply{dir = 10},/obj/structure/cable/green{d1 = 1; d2 = 8; icon_state = "1-8"},/obj/structure/cable/green{d1 = 2; d2 = 8; icon_state = "2-8"},/turf/simulated/floor/plating,/area/space)
"A" = (/obj/effect/floor_decal/spline/plain/green{dir = 4},/obj/effect/decal/cleanable/dirt,/turf/simulated/floor/tiled/old_cargo,/area/space)
"B" = (/obj/machinery/atmospherics/pipe/simple/hidden/scrubbers{dir = 8},/obj/machinery/atmospherics/pipe/simple/hidden/supply{dir = 4},/obj/structure/cable/green{d1 = 4; d2 = 8; icon_state = "4-8"},/turf/simulated/floor/tiled/old_tile,/area/space)
"C" = (/obj/effect/floor_decal/borderfloorwhite{dir = 6},/turf/simulated/floor/tiled/old_tile,/area/space)
"D" = (/obj/effect/catwalk_plated/white,/obj/machinery/atmospherics/pipe/simple/hidden/scrubbers{dir = 10},/obj/structure/cable/green{d1 = 2; d2 = 8; icon_state = "2-8"},/turf/simulated/floor/plating,/area/space)
"E" = (/obj/effect/floor_decal/borderfloorwhite{dir = 9},/turf/simulated/floor/tiled/old_tile,/area/space)
"G" = (/obj/effect/catwalk_plated/white,/obj/machinery/atmospherics/pipe/simple/hidden/scrubbers{dir = 8},/obj/structure/cable/green{d1 = 4; d2 = 8; icon_state = "4-8"},/turf/simulated/floor/plating,/area/space)
"H" = (/obj/effect/catwalk_plated/white,/obj/machinery/atmospherics/pipe/simple/hidden/supply{dir = 9},/obj/structure/cable/green{d1 = 1; d2 = 8; icon_state = "1-8"},/turf/simulated/floor/plating,/area/space)
"I" = (/obj/structure/table/standard,/obj/effect/decal/cleanable/dirt,/turf/simulated/floor/tiled/old_cargo,/area/space)
"J" = (/obj/effect/catwalk_plated/white,/obj/machinery/atmospherics/pipe/simple/hidden/supply{dir = 4},/obj/structure/cable/green{d1 = 4; d2 = 8; icon_state = "4-8"},/turf/simulated/floor/plating,/area/space)
"K" = (/obj/item/stool/wood{pixel_x = 1; pixel_y = 6},/obj/structure/window/reinforced/tinted{dir = 4},/obj/structure/window/reinforced/tinted{dir = 8},/obj/structure/hygiene/shower{pixel_y = 23},/obj/structure/curtain/open/shower,/obj/effect/floor_decal/industrial/outline/blue{color = "#50a0d3"},/obj/effect/decal/cleanable/dirt,/turf/simulated/floor/tiled/old_cargo,/area/space)
"L" = (/obj/effect/catwalk_plated/white,/obj/machinery/atmospherics/pipe/simple/hidden/scrubbers{dir = 5},/obj/machinery/atmospherics/pipe/simple/hidden/supply{dir = 6},/obj/structure/cable/green{d1 = 1; d2 = 4; icon_state = "1-4"},/obj/structure/cable/green{d1 = 2; d2 = 4; icon_state = "2-4"},/turf/simulated/floor/plating,/area/space)
"M" = (/obj/effect/floor_decal/borderfloorwhite{dir = 4},/obj/machinery/atmospherics/pipe/simple/hidden/scrubbers{dir = 8},/obj/machinery/atmospherics/pipe/simple/hidden/supply{dir = 4},/obj/structure/cable/green{d1 = 4; d2 = 8; icon_state = "4-8"},/turf/simulated/floor/tiled/old_tile,/area/space)
"N" = (/obj/structure/closet/secure_closet/personal/empty,/obj/effect/floor_decal/industrial/hatch/blue,/obj/item/clothing/under/bathrobe,/obj/item/clothing/under/bathrobe,/obj/machinery/light/spot{dir = 8},/turf/simulated/floor/tiled/old_cargo,/area/space)
"O" = (/obj/structure/window/reinforced/tinted{dir = 4},/obj/structure/window/reinforced/tinted{dir = 8},/obj/structure/hygiene/shower{pixel_y = 23},/obj/structure/curtain/open/shower,/obj/item/stool/wood{pixel_x = 1; pixel_y = 6},/obj/effect/floor_decal/industrial/outline/blue{color = "#50a0d3"},/turf/simulated/floor/tiled/old_cargo,/area/space)
"P" = (/obj/effect/floor_decal/spline/plain/green{dir = 8},/obj/machinery/atmospherics/pipe/simple/hidden/scrubbers{dir = 4},/obj/machinery/atmospherics/pipe/simple/hidden/supply{dir = 4},/obj/structure/cable/green{d1 = 4; d2 = 8; icon_state = "4-8"},/turf/simulated/floor/tiled/old_cargo,/area/space)
"Q" = (/obj/effect/catwalk_plated/white,/obj/item/reagent_containers/glass/bucket/wood{pixel_x = 9; pixel_y = 15},/obj/machinery/atmospherics/pipe/simple/hidden/scrubbers,/obj/structure/cable/green{d1 = 1; d2 = 2; icon_state = "1-2"},/turf/simulated/floor/plating,/area/space)
"R" = (/obj/structure/hygiene/drain,/turf/simulated/floor/pool,/area/space)
"T" = (/obj/item/soap,/turf/simulated/floor/pool,/area/space)
"U" = (/obj/structure/hygiene/sink{dir = 1; pixel_y = 16},/obj/effect/floor_decal/industrial/outline/blue{color = "#50a0d3"},/obj/machinery/light/spot{dir = 4},/turf/simulated/floor/tiled/old_cargo,/area/space)
"V" = (/obj/effect/catwalk_plated/white,/obj/machinery/atmospherics/pipe/simple/hidden/supply,/obj/structure/cable/green{d1 = 1; d2 = 2; icon_state = "1-2"},/turf/simulated/floor/plating,/area/space)
"W" = (/obj/effect/floor_decal/spline/plain/green{dir = 4},/obj/machinery/vending/lavatory,/obj/effect/decal/cleanable/dirt,/obj/machinery/atmospherics/pipe/simple/hidden/scrubbers{dir = 8},/obj/machinery/atmospherics/pipe/simple/hidden/supply{dir = 4},/obj/structure/cable/green{d1 = 4; d2 = 8; icon_state = "4-8"},/turf/simulated/floor/tiled/old_cargo,/area/space)
"X" = (/obj/effect/floor_decal/spline/plain/green{dir = 4},/turf/simulated/floor/tiled/old_cargo,/area/space)
"Y" = (/obj/item/bikehorn/rubberducky{pixel_x = -16; pixel_y = 12},/turf/simulated/floor/pool,/area/space)
"Z" = (/obj/effect/floor_decal/borderfloorwhite{dir = 5},/obj/effect/decal/cleanable/dirt,/turf/simulated/floor/tiled/old_tile,/area/space)

(1,1,1) = {"
KOlrGGGDwIU
pZXQyfTgvEp
BMWzyRYLPxc
kCAVyyyVvou
NadmJJJHqIb
"}
