"aa" = (/obj/effect/shuttle_landmark/nav_aaaa/nav1,/turf/simulated/floor/plating,/area/fd/aaaa_head/up)
"bL" = (/obj/effect/floor_decal/borderfloorblack{dir = 9},/turf/simulated/floor/tiled/techfloor/grid,/area/fd/aaaa_head/up)
"cS" = (/obj/effect/floor_decal/industrial/hatch/yellow,/turf/simulated/floor/tiled/techfloor/grid,/area/fd/aaaa_head/up)
"df" = (/obj/machinery/door/airlock/lift,/turf/simulated/floor/tiled/techfloor/grid,/area/fd/aaaa_head/up)
"ef" = (/obj/effect/floor_decal/borderfloor{dir = 6},/obj/structure/railing/mapped,/turf/simulated/floor/tiled/techfloor,/area/fd/aaaa_head/up)
"fe" = (/obj/effect/floor_decal/borderfloor{dir = 9},/obj/machinery/light/spot{dir = 1},/turf/simulated/floor/tiled/techfloor,/area/fd/aaaa_head/up)
"fq" = (/obj/effect/floor_decal/industrial/warning/corner{dir = 8},/turf/simulated/floor/tiled/techfloor/grid,/area/fd/aaaa_head/lift1)
"ha" = (/obj/effect/floor_decal/industrial/warning,/turf/simulated/floor/tiled/steel_grid,/area/fd/aaaa_head/up)
"he" = (/obj/machinery/light/spot{dir = 1},/obj/effect/floor_decal/borderfloorblack{dir = 8},/turf/simulated/floor/tiled/techfloor/grid,/area/fd/aaaa_head/up)
"hm" = (/obj/effect/floor_decal/industrial/hatch/yellow,/obj/effect/overmap/visitable/sector/aaaa_head,/obj/effect/submap_landmark/joinable_submap/aaaa_head,/turf/simulated/floor/tiled/techfloor/grid,/area/fd/aaaa_head/up)
"ho" = (/obj/effect/floor_decal/borderfloor{dir = 5},/obj/structure/railing/mapped{dir = 1; icon_state = "railing_preview"},/turf/simulated/floor/tiled/techfloor,/area/fd/aaaa_head/up)
"hy" = (/obj/effect/floor_decal/industrial/warning/corner,/turf/simulated/floor/tiled/steel_ridged,/area/fd/aaaa_head/up)
"hJ" = (/obj/effect/floor_decal/industrial/warning{dir = 8},/turf/simulated/floor/tiled/steel_grid,/area/fd/aaaa_head/up)
"ie" = (/turf/simulated/wall/r_wall/invincible,/area/fd/aaaa_head/lift1)
"iE" = (/obj/machinery/light/spot{dir = 8},/turf/simulated/floor/tiled/techfloor,/area/fd/aaaa_head/up)
"iJ" = (/obj/effect/floor_decal/industrial/outline/yellow,/obj/machinery/light/spot,/turf/simulated/floor/tiled/steel_ridged,/area/fd/aaaa_head/up)
"jb" = (/obj/effect/floor_decal/industrial/warning{dir = 1},/turf/simulated/floor/tiled/techfloor/grid,/area/fd/aaaa_head/lift1)
"je" = (/obj/effect/landmark/map_data{height = 2},/turf/unsimulated/wall{color = "black"},/area/space)
"kt" = (/obj/effect/floor_decal/borderfloor{dir = 9},/obj/structure/railing/mapped{dir = 8; icon_state = "railing0-1"},/turf/simulated/floor/tiled/techfloor,/area/fd/aaaa_head/up)
"ku" = (/obj/effect/floor_decal/industrial/warning{dir = 4},/turf/simulated/floor/tiled/steel_grid,/area/fd/aaaa_head/up)
"kB" = (/obj/effect/floor_decal/industrial/warning,/turf/simulated/floor/tiled/techfloor/grid,/area/fd/aaaa_head/lift1)
"lr" = (/obj/effect/floor_decal/borderfloor{dir = 4},/turf/simulated/floor/tiled/techfloor,/area/fd/aaaa_head/up)
"lB" = (/obj/structure/fd/placeholder/better{opacity = 0},/obj/effect/floor_decal{color = "grey"; dir = 1; icon_state = "stairs"},/obj/structure/railing/mapped{dir = 8; icon_state = "railing0-1"},/turf/simulated/floor/tiled/dark/monotile,/area/fd/aaaa_head/up)
"lE" = (/obj/machinery/light/spot{dir = 4},/turf/simulated/floor/tiled/techfloor,/area/fd/aaaa_head/up)
"lI" = (/obj/effect/floor_decal/industrial/outline/yellow,/obj/machinery/light/spot{dir = 1},/turf/simulated/floor/tiled/steel_ridged,/area/fd/aaaa_head/up)
"lU" = (/obj/effect/floor_decal/industrial/warning{dir = 4},/turf/simulated/floor/tiled/techfloor/grid,/area/fd/aaaa_head/lift1)
"ne" = (/obj/effect/floor_decal/industrial/warning{dir = 1},/turf/simulated/floor/tiled/steel_ridged,/area/fd/aaaa_head/up)
"nk" = (/obj/effect/floor_decal/industrial/warning{dir = 8; icon_state = "warning"},/turf/simulated/floor/tiled/techfloor/grid,/area/fd/aaaa_head/lift1)
"nU" = (/obj/effect/floor_decal/borderfloorblack{dir = 8},/turf/simulated/floor/tiled/techfloor/grid,/area/fd/aaaa_head/up)
"oQ" = (/obj/effect/floor_decal/industrial/outline/yellow,/turf/simulated/floor/tiled/steel_grid,/area/fd/aaaa_head/up)
"pc" = (/obj/structure/fd/placeholder/better{opacity = 0},/obj/effect/floor_decal{color = "grey"; dir = 1; icon_state = "stairs"},/turf/simulated/floor/tiled/dark/monotile,/area/fd/aaaa_head/up)
"pQ" = (/turf/simulated/wall/r_wall/invincible,/area/fd/aaaa_head/up)
"qj" = (/obj/effect/floor_decal/techfloor/orange{dir = 1},/turf/simulated/floor/tiled/techfloor/grid,/area/fd/aaaa_head/lift1)
"qr" = (/turf/simulated/floor/tiled/monotile,/area/fd/aaaa_head/up)
"qJ" = (/obj/effect/floor_decal/borderfloorblack{dir = 10},/turf/simulated/floor/tiled/techfloor/grid,/area/fd/aaaa_head/up)
"qX" = (/obj/effect/floor_decal/industrial/warning{dir = 1},/obj/machinery/light/spot{dir = 8},/turf/simulated/floor/tiled/steel_ridged,/area/fd/aaaa_head/up)
"rK" = (/obj/effect/floor_decal/borderfloor/corner{dir = 4},/turf/simulated/floor/tiled/techfloor,/area/fd/aaaa_head/up)
"tn" = (/obj/effect/floor_decal/borderfloor{dir = 9},/turf/simulated/floor/tiled/techfloor/grid,/area/fd/aaaa_head/up)
"tp" = (/obj/effect/floor_decal/techfloor/orange,/turf/simulated/floor/tiled/techfloor/grid,/area/fd/aaaa_head/lift1)
"tC" = (/obj/effect/floor_decal/borderfloorblack{dir = 1},/turf/simulated/floor/tiled/techfloor/grid,/area/fd/aaaa_head/up)
"tI" = (/obj/effect/floor_decal/industrial/warning,/obj/machinery/light/spot{dir = 4},/turf/simulated/floor/tiled/steel_ridged,/area/fd/aaaa_head/up)
"tX" = (/obj/effect/floor_decal/borderfloor{dir = 9},/turf/simulated/floor/tiled/techfloor,/area/fd/aaaa_head/up)
"uc" = (/obj/effect/floor_decal/industrial/warning,/turf/simulated/floor/tiled/dark/monotile,/area/fd/aaaa_head/up)
"vq" = (/obj/machinery/light/spot{dir = 1},/obj/effect/floor_decal/borderfloorblack{dir = 4},/turf/simulated/floor/tiled/techfloor/grid,/area/fd/aaaa_head/up)
"wb" = (/obj/effect/floor_decal/borderfloorblack,/turf/simulated/floor/tiled/techfloor/grid,/area/fd/aaaa_head/up)
"wz" = (/obj/effect/floor_decal/borderfloor{dir = 9},/obj/structure/railing/mapped{dir = 1; icon_state = "railing_preview"},/turf/simulated/floor/tiled/techfloor,/area/fd/aaaa_head/up)
"wJ" = (/obj/effect/floor_decal/industrial/warning/corner{dir = 8},/turf/simulated/floor/tiled/steel_ridged,/area/fd/aaaa_head/up)
"wZ" = (/obj/effect/floor_decal/industrial/warning/corner{dir = 1},/turf/simulated/floor/tiled/steel_ridged,/area/fd/aaaa_head/up)
"xE" = (/obj/effect/floor_decal/borderfloor{dir = 10},/obj/structure/railing/mapped,/turf/simulated/floor/tiled/techfloor,/area/fd/aaaa_head/up)
"xW" = (/obj/effect/floor_decal/borderfloor,/turf/simulated/floor/tiled/techfloor,/area/fd/aaaa_head/up)
"zF" = (/obj/machinery/door/airlock/multi_tile/glass/science,/turf/simulated/floor/tiled/monotile,/area/fd/aaaa_head/up)
"zX" = (/obj/effect/floor_decal/industrial/outline/yellow,/obj/machinery/light/spot{dir = 4},/turf/simulated/floor/tiled/steel_ridged,/area/fd/aaaa_head/up)
"Ap" = (/obj/effect/floor_decal/borderfloorblack{dir = 5},/turf/simulated/floor/tiled/techfloor/grid,/area/fd/aaaa_head/up)
"Ax" = (/obj/effect/floor_decal/industrial/warning/corner{dir = 4},/turf/simulated/floor/tiled/steel_ridged,/area/fd/aaaa_head/up)
"AK" = (/obj/effect/floor_decal/borderfloor{dir = 5},/obj/machinery/light/spot{dir = 1},/turf/simulated/floor/tiled/techfloor,/area/fd/aaaa_head/up)
"Bj" = (/obj/effect/floor_decal/borderfloor{dir = 4},/turf/simulated/floor/tiled/techfloor/grid,/area/fd/aaaa_head/up)
"Bt" = (/obj/effect/floor_decal/borderfloor{dir = 5},/turf/simulated/floor/tiled/techfloor,/area/fd/aaaa_head/up)
"Ct" = (/obj/effect/floor_decal/borderfloor{dir = 6},/obj/structure/railing/mapped{dir = 4; icon_state = "railing_preview"},/turf/simulated/floor/tiled/techfloor,/area/fd/aaaa_head/up)
"CJ" = (/obj/effect/floor_decal/borderfloor{dir = 8},/turf/simulated/floor/tiled/techfloor/grid,/area/fd/aaaa_head/up)
"CM" = (/obj/effect/floor_decal/borderfloorblack{dir = 8},/obj/machinery/light/spot,/turf/simulated/floor/tiled/techfloor/grid,/area/fd/aaaa_head/up)
"CO" = (/obj/machinery/light/spot,/turf/simulated/floor/tiled/techfloor/grid,/area/fd/aaaa_head/up)
"Dh" = (/obj/effect/floor_decal/borderfloor/corner,/turf/simulated/floor/tiled/techfloor,/area/fd/aaaa_head/up)
"Dw" = (/obj/effect/floor_decal/borderfloorblack{dir = 6},/turf/simulated/floor/tiled/techfloor/grid,/area/fd/aaaa_head/up)
"Ew" = (/obj/structure/fd/placeholder/better{opacity = 0},/obj/effect/floor_decal/industrial/warning{dir = 4},/turf/simulated/floor/tiled/steel_ridged,/area/fd/aaaa_head/up)
"Ez" = (/turf/simulated/floor/tiled/steel_ridged,/area/fd/aaaa_head/up)
"Fe" = (/obj/effect/floor_decal/industrial/warning{dir = 8},/turf/simulated/floor/tiled/steel_ridged,/area/fd/aaaa_head/up)
"FO" = (/obj/effect/floor_decal/industrial/outline/yellow,/obj/machinery/computer/shuttle_control/lift/aaaa_head,/turf/simulated/floor/tiled/steel_ridged,/area/fd/aaaa_head/lift1)
"Gg" = (/obj/effect/floor_decal/industrial/warning/corner,/turf/simulated/floor/tiled/techfloor/grid,/area/fd/aaaa_head/lift1)
"GG" = (/turf/simulated/floor/tiled/techfloor/grid,/area/fd/aaaa_head/up)
"GT" = (/turf/simulated/wall/elevator,/area/fd/aaaa_head/up)
"HN" = (/turf/simulated/floor/tiled/steel_grid,/area/fd/aaaa_head/up)
"IN" = (/obj/effect/floor_decal/industrial/warning{dir = 1},/turf/simulated/floor/tiled/steel_grid,/area/fd/aaaa_head/up)
"IP" = (/obj/effect/floor_decal/industrial/warning,/turf/simulated/floor/tiled/steel_ridged,/area/fd/aaaa_head/up)
"IR" = (/obj/machinery/door/airlock/hatch,/turf/simulated/floor/tiled/dark/monotile,/area/fd/aaaa_head/up)
"Jl" = (/obj/effect/floor_decal/industrial/warning/corner{dir = 4},/turf/simulated/floor/tiled/techfloor/grid,/area/fd/aaaa_head/lift1)
"JU" = (/obj/effect/wallframe_spawn/reinforced,/turf/simulated/floor/plating,/area/fd/aaaa_head/up)
"Ka" = (/obj/effect/floor_decal/borderfloorblack{dir = 4},/turf/simulated/floor/tiled/techfloor/grid,/area/fd/aaaa_head/up)
"KW" = (/obj/effect/floor_decal/borderfloor{dir = 5},/turf/simulated/floor/tiled/techfloor/grid,/area/fd/aaaa_head/up)
"Ld" = (/turf/simulated/floor/plating,/area/fd/aaaa_head/up)
"Ly" = (/obj/effect/floor_decal/industrial/warning{dir = 4},/turf/simulated/floor/tiled/steel_ridged,/area/fd/aaaa_head/up)
"LC" = (/obj/effect/floor_decal/borderfloor{dir = 10},/obj/structure/railing/mapped{dir = 8; icon_state = "railing0-1"},/turf/simulated/floor/tiled/techfloor,/area/fd/aaaa_head/up)
"Mw" = (/obj/effect/floor_decal/industrial/warning,/obj/machinery/light/spot{dir = 8},/turf/simulated/floor/tiled/steel_ridged,/area/fd/aaaa_head/up)
"ME" = (/obj/effect/floor_decal/borderfloor{dir = 6},/turf/simulated/floor/tiled/techfloor/grid,/area/fd/aaaa_head/up)
"MG" = (/obj/effect/floor_decal/borderfloor{dir = 10},/turf/simulated/floor/tiled/techfloor/grid,/area/fd/aaaa_head/up)
"Nl" = (/obj/effect/floor_decal/industrial/outline/yellow,/obj/machinery/light/spot{dir = 8},/turf/simulated/floor/tiled/steel_ridged,/area/fd/aaaa_head/up)
"NE" = (/obj/effect/floor_decal/industrial/shutoff,/turf/simulated/floor/tiled/techfloor/grid,/area/fd/aaaa_head/up)
"Ox" = (/obj/effect/floor_decal/borderfloorblack{dir = 4},/obj/machinery/light/spot,/turf/simulated/floor/tiled/techfloor/grid,/area/fd/aaaa_head/up)
"OJ" = (/obj/effect/shuttle_landmark/lift/aaaa_head/top1,/turf/simulated/wall/r_wall/invincible,/area/fd/aaaa_head/lift1)
"PI" = (/turf/simulated/floor/tiled/steel_ridged,/area/fd/aaaa_head/lift1)
"Qq" = (/turf/simulated/floor/tiled/techfloor,/area/fd/aaaa_head/up)
"QO" = (/obj/effect/floor_decal/corner/brown/border,/obj/machinery/light/spot{dir = 1},/turf/simulated/floor/tiled/dark,/area/fd/aaaa_head/up)
"RS" = (/obj/effect/floor_decal/borderfloor{dir = 5},/obj/structure/railing/mapped{dir = 4; icon_state = "railing_preview"},/turf/simulated/floor/tiled/techfloor,/area/fd/aaaa_head/up)
"Ti" = (/obj/effect/floor_decal/industrial/warning/corner{dir = 1},/turf/simulated/floor/tiled/techfloor/grid,/area/fd/aaaa_head/lift1)
"Tl" = (/obj/effect/floor_decal/borderfloor{dir = 4},/obj/machinery/light/spot{dir = 8},/turf/simulated/floor/tiled/techfloor/grid,/area/fd/aaaa_head/up)
"Ub" = (/obj/effect/floor_decal/borderfloor/corner{dir = 1},/turf/simulated/floor/tiled/techfloor,/area/fd/aaaa_head/up)
"US" = (/obj/effect/floor_decal/techfloor/orange{dir = 4},/turf/simulated/floor/tiled/techfloor/grid,/area/fd/aaaa_head/lift1)
"Wc" = (/turf/unsimulated/wall{color = "black"},/area/fd/aaaa_head/up)
"WA" = (/obj/effect/floor_decal/techfloor/orange{dir = 8},/turf/simulated/floor/tiled/techfloor/grid,/area/fd/aaaa_head/lift1)
"Xm" = (/turf/unsimulated/wall{color = "black"},/area/space)
"Xr" = (/obj/effect/floor_decal/borderfloor{dir = 1},/turf/simulated/floor/tiled/techfloor,/area/fd/aaaa_head/up)
"Yp" = (/obj/effect/floor_decal/borderfloor{dir = 8},/turf/simulated/floor/tiled/techfloor,/area/fd/aaaa_head/up)
"YM" = (/obj/effect/floor_decal/corner/brown/border,/turf/simulated/floor/tiled/dark,/area/fd/aaaa_head/up)
"Zi" = (/obj/effect/floor_decal/borderfloor{dir = 8},/obj/machinery/light/spot{dir = 4},/turf/simulated/floor/tiled/techfloor/grid,/area/fd/aaaa_head/up)
"Zk" = (/obj/effect/floor_decal/industrial/warning{dir = 1},/obj/machinery/light/spot{dir = 4},/turf/simulated/floor/tiled/steel_ridged,/area/fd/aaaa_head/up)
"ZU" = (/obj/effect/floor_decal/borderfloor/corner{dir = 8},/turf/simulated/floor/tiled/techfloor,/area/fd/aaaa_head/up)

(1,1,1) = {"
XmXmXmXmXmXmXmXmXmXmXmXmXmXmXmXmXmXmXmXmXmXmXmXmXmXmXmXmXmXmXmXmXmXmXmXmXmXmXmXmXmXmXmXmXmXmXmXmXmXmXmXmXmXmXmXmXmXmXmXmXmXmXmXmXmXmXmXmXmXmXmXmXmXmXmXmXmXmXmXm
XmXmXmXmXmXmXmXmXmXmXmXmXmXmXmXmXmXmXmXmXmXmXmXmXmXmXmXmXmXmXmXmXmXmXmXmXmXmXmXmXmXmXmXmXmXmXmXmXmXmXmXmXmXmXmXmXmXmXmXmXmXmXmXmXmXmXmXmXmXmXmXmXmXmXmXmXmXmXmXm
XmXmXmXmXmXmXmXmXmXmXmXmXmXmXmXmXmXmXmXmXmXmXmXmXmXmXmXmXmXmXmXmXmXmXmXmXmXmXmXmXmXmXmXmXmXmXmXmXmXmXmXmXmXmXmXmXmXmXmXmXmXmXmXmXmXmXmXmXmXmXmXmXmXmXmXmXmXmXmXm
XmXmXmXmXmXmXmXmXmXmXmXmXmXmXmXmXmXmXmXmXmXmXmXmXmXmXmXmXmXmXmXmXmXmXmXmXmXmXmXmXmXmXmXmXmXmXmXmXmXmXmXmXmXmXmXmXmXmXmXmXmXmXmXmXmXmXmXmXmXmXmXmXmXmXmXmXmXmXmXm
XmXmXmXmXmXmXmXmXmXmXmXmXmXmXmXmXmXmXmXmXmXmXmXmXmXmXmXmXmXmXmXmXmXmXmXmXmXmXmXmXmXmXmXmXmXmXmXmXmXmXmXmXmXmXmXmXmXmXmXmXmXmXmXmXmXmXmXmXmXmXmXmXmXmXmXmXmXmXmXm
XmXmXmXmXmXmXmXmXmXmXmXmXmXmXmXmXmXmXmXmXmXmXmXmXmXmXmXmXmXmXmXmXmXmXmXmXmXmXmXmXmXmXmXmXmXmXmXmXmXmXmXmXmXmXmXmXmXmXmXmXmXmXmXmXmXmXmXmXmXmXmXmXmXmXmXmXmXmXmXm
XmXmXmXmXmXmXmXmXmXmXmXmXmXmXmXmXmXmXmXmXmXmXmXmXmXmXmXmXmXmXmXmXmXmXmXmXmXmXmXmXmXmXmXmXmXmXmXmXmXmXmXmXmXmXmXmXmXmXmXmXmXmXmXmXmXmXmXmXmXmXmXmXmXmXmXmXmXmXmXm
XmXmXmXmXmXmXmXmXmXmXmXmXmXmXmXmXmXmXmXmXmXmXmXmXmXmXmXmXmXmXmXmXmXmXmXmXmXmXmXmXmXmXmXmXmXmXmXmXmXmXmXmXmXmXmXmXmXmXmXmXmXmXmXmXmXmXmXmXmXmXmXmXmXmXmXmXmXmXmXm
XmXmXmXmXmXmXmXmXmXmXmXmXmXmXmXmXmXmXmXmXmXmXmXmXmXmXmXmXmXmXmXmXmXmXmXmXmXmXmXmXmXmXmXmXmXmXmXmXmXmXmXmXmXmXmXmXmXmXmXmXmXmXmXmXmXmXmXmXmXmXmXmXmXmXmXmXmXmXmXm
XmXmXmXmXmXmXmXmXmXmXmXmXmXmXmXmXmXmXmXmXmXmXmXmXmXmXmXmXmXmXmXmXmXmXmXmXmXmXmXmXmXmXmXmXmXmXmXmXmXmXmXmXmXmXmXmXmXmXmXmXmXmXmXmXmXmXmXmXmXmXmXmXmXmXmXmXmXmXmXm
XmXmXmXmXmXmXmXmXmXmXmXmXmXmXmXmXmXmXmXmXmXmXmXmXmXmXmXmXmXmXmXmXmXmXmXmXmXmXmXmXmXmXmXmXmXmXmXmXmXmXmXmXmXmXmXmXmXmXmXmXmXmXmXmXmXmXmXmXmXmXmXmXmXmXmXmXmXmXmXm
XmXmXmXmXmXmXmXmXmXmXmXmXmXmXmXmXmXmXmXmXmXmXmXmXmXmXmXmXmXmXmXmXmXmXmXmXmXmXmXmXmXmXmXmXmXmXmXmXmXmXmXmXmXmXmXmXmXmXmXmXmXmXmXmXmXmXmXmXmXmXmXmXmXmXmXmXmXmXmXm
XmXmXmXmXmXmXmXmXmXmXmXmXmXmXmXmXmXmXmXmXmXmXmXmXmXmXmXmXmXmXmXmXmXmXmXmXmXmXmXmXmXmXmXmXmXmXmXmXmXmXmXmXmXmXmXmXmXmXmXmXmXmXmXmXmXmXmXmXmXmXmXmXmXmXmXmXmXmXmXm
XmXmXmXmXmXmXmXmXmXmXmXmXmXmXmXmXmXmXmXmXmXmXmXmXmXmXmXmXmXmXmXmXmXmXmXmXmXmXmXmXmXmXmXmXmXmXmXmXmXmXmXmXmXmXmXmXmXmXmXmXmXmXmXmXmXmXmXmXmXmXmXmXmXmXmXmXmXmXmXm
XmXmXmXmXmXmXmXmXmXmXmXmXmXmXmXmXmXmXmXmXmXmXmXmXmXmXmXmXmXmXmXmXmXmXmXmXmXmXmXmXmXmXmXmXmXmXmXmXmXmXmXmXmXmXmXmXmXmXmXmXmXmXmXmXmXmXmXmXmXmXmXmXmXmXmXmXmXmXmXm
XmXmXmXmXmXmXmXmXmXmXmXmXmXmXmXmXmXmXmXmXmXmXmXmXmXmXmXmXmXmXmXmXmXmXmXmXmXmXmXmXmXmXmXmXmXmXmXmXmXmXmXmXmXmXmXmXmXmXmXmXmXmXmXmXmXmXmXmXmXmXmXmXmXmXmXmXmXmXmXm
XmXmXmXmXmXmXmXmXmXmXmXmXmXmXmXmXmXmXmXmXmXmXmXmXmXmXmXmXmXmXmXmXmXmXmXmXmXmXmXmXmXmXmXmXmXmXmXmXmXmXmXmXmXmXmXmXmXmXmXmXmXmXmXmXmXmXmXmXmXmXmXmXmXmXmXmXmXmXmXm
XmXmXmXmXmXmXmXmXmXmXmXmXmXmXmXmXmXmXmXmXmXmXmXmXmXmXmXmXmXmXmXmXmXmXmXmXmXmXmXmXmXmXmXmXmXmXmXmXmXmXmXmXmXmXmXmXmXmXmXmXmXmXmXmXmXmXmXmXmXmXmXmXmXmXmXmXmXmXmXm
XmXmXmXmXmXmXmXmXmXmXmXmXmXmXmXmXmXmXmXmXmXmXmXmXmXmXmXmXmXmXmXmXmXmXmXmXmXmXmXmXmXmXmXmXmXmXmXmXmXmXmXmXmXmXmXmXmXmXmXmXmXmXmXmXmXmXmXmXmXmXmXmXmXmXmXmXmXmXmXm
XmXmXmXmXmXmXmXmXmXmXmXmXmXmXmXmXmXmXmXmXmXmXmXmXmXmXmXmXmXmXmXmXmXmXmXmXmXmXmXmXmXmXmXmXmXmXmXmXmXmXmXmXmXmXmXmXmXmXmXmXmXmXmXmXmXmXmXmXmXmXmXmXmXmXmXmXmXmXmXm
XmXmXmXmXmXmXmXmXmXmXmXmXmXmXmXmXmXmXmXmXmXmXmXmXmXmXmXmXmXmXmXmXmXmXmXmXmXmXmXmXmXmXmXmXmXmXmXmXmXmXmXmXmXmXmXmXmXmXmXmXmXmXmXmXmXmXmXmXmXmXmXmXmXmXmXmXmXmXmXm
XmXmXmXmXmXmXmXmXmXmXmXmXmXmXmXmXmXmXmXmXmXmXmXmXmXmXmXmXmXmXmXmXmXmXmXmXmXmXmXmXmXmXmXmXmXmXmXmXmXmXmXmXmXmXmXmXmXmXmXmXmXmXmXmXmXmXmXmXmXmXmXmXmXmXmXmXmXmXmXm
XmXmXmXmXmXmXmXmXmXmXmXmXmXmXmXmXmXmXmXmXmXmXmXmXmXmXmXmXmXmXmXmXmXmXmXmXmXmXmXmXmXmXmXmXmXmXmXmXmXmXmXmXmXmXmXmXmXmXmXmXmXmXmXmXmXmXmXmXmXmXmXmXmXmXmXmXmXmXmXm
XmXmXmXmXmXmXmXmXmXmXmXmXmXmXmXmXmXmXmXmXmXmXmXmXmXmXmXmXmXmXmXmXmXmXmXmXmXmXmXmXmXmXmXmXmXmXmXmXmXmXmXmXmXmXmXmXmXmXmXmXmXmXmXmXmXmXmXmXmXmXmXmXmXmXmXmXmXmXmXm
XmXmXmXmXmXmXmXmXmXmXmXmXmXmXmXmXmXmXmXmXmXmXmXmXmXmXmXmXmXmXmXmXmXmXmXmXmXmXmXmXmXmXmXmXmXmXmXmXmXmXmXmXmXmXmXmXmXmXmXmXmXmXmXmXmXmXmXmXmXmXmXmXmXmXmXmXmXmXmXm
XmXmXmXmXmXmXmXmXmXmXmXmXmXmXmXmXmXmXmXmXmXmXmXmXmXmXmXmXmXmXmXmXmXmXmXmXmXmXmXmXmXmXmXmXmXmXmXmXmXmXmXmXmXmXmXmXmXmXmXmXmXmXmXmXmXmXmXmXmXmXmXmXmXmXmXmXmXmXmXm
XmXmXmXmXmXmXmXmXmXmXmXmXmXmXmXmXmXmXmXmXmXmXmXmXmXmXmXmXmXmXmXmXmXmXmXmXmXmXmXmXmXmXmXmXmXmXmXmXmXmXmXmXmXmXmXmXmXmXmXmXmXmXmXmXmXmXmXmXmXmXmXmXmXmXmXmXmXmXmXm
XmXmXmXmXmXmXmXmXmXmXmXmXmXmXmXmXmXmXmXmXmXmXmXmXmXmXmXmXmXmXmXmXmXmXmXmXmXmXmXmXmXmXmXmXmXmXmXmXmXmXmXmXmXmXmXmXmXmXmXmXmXmXmXmXmXmXmXmXmXmXmXmXmXmXmXmXmXmXmXm
XmXmXmXmXmXmXmXmXmXmXmXmXmXmXmXmXmXmXmXmXmXmXmXmXmXmXmXmXmXmXmXmXmXmXmXmXmXmXmXmXmXmXmXmXmXmXmXmXmXmXmXmXmXmXmXmXmXmXmXmXmXmXmXmXmXmXmXmXmXmXmXmXmXmXmXmXmXmXmXm
XmXmXmXmXmXmXmXmXmXmXmXmXmXmXmXmXmXmXmXmXmXmXmXmXmXmXmXmXmXmXmXmXmXmXmXmXmXmXmXmXmXmXmXmXmXmXmXmXmXmXmXmXmXmXmXmXmXmXmXmXmXmXmXmXmXmXmXmXmXmXmXmXmXmXmXmXmXmXmXm
XmXmXmXmXmXmXmXmXmXmXmXmXmXmXmXmXmXmXmXmXmXmXmXmXmXmXmXmXmXmXmXmXmXmXmXmXmXmXmXmXmXmXmXmXmXmXmXmXmXmXmXmXmXmXmXmXmXmXmXmXmXmXmXmXmXmXmXmXmXmXmXmXmXmXmXmXmXmXmXm
XmXmXmXmXmXmXmXmXmXmXmXmXmXmXmXmXmXmXmXmXmXmXmXmXmXmXmXmXmXmXmXmXmXmXmXmXmXmXmXmXmXmXmXmXmXmXmXmXmXmXmXmXmXmXmXmXmXmXmXmXmXmXmXmXmXmXmXmXmXmXmXmXmXmXmXmXmXmXmXm
XmXmXmXmXmXmXmXmXmXmXmXmXmXmXmXmXmXmXmXmXmXmXmXmXmXmXmXmXmXmXmXmXmXmXmXmXmXmXmXmXmXmXmXmXmXmXmXmXmXmXmXmXmXmXmXmXmXmXmXmXmXmXmXmXmXmXmXmXmXmXmXmXmXmXmXmXmXmXmXm
XmXmXmXmXmXmXmXmXmXmXmXmXmXmXmXmXmXmXmXmXmXmXmXmXmXmXmXmpQpQpQpQpQpQpQpQpQpQpQpQpQpQpQpQpQXmXmXmXmXmXmXmXmXmXmXmXmXmXmXmXmXmXmXmXmXmXmXmXmXmXmXmXmXmXmXmXmXmXmXm
XmXmXmXmXmXmXmXmXmXmXmXmXmXmXmXmXmXmXmXmXmXmXmXmXmXmXmXmpQBjlInUGGGGvqcScScSheGGGGKalICJpQXmXmXmXmXmXmXmXmXmXmXmXmXmXmXmXmXmXmXmXmXmXmXmXmXmXmXmXmXmXmXmXmXmXmXm
XmXmXmXmXmXmXmXmXmXmXmXmXmXmXmXmXmXmXmXmXmXmXmXmXmXmXmXmpQMEHNqJwbwbDwcScScSqJwbwbDwHNMGpQXmXmXmXmXmXmXmXmXmXmXmXmXmXmXmXmXmXmXmXmXmXmXmXmXmXmXmXmXmXmXmXmXmXmXm
XmXmXmXmXmXmXmXmXmXmXmXmXmXmXmXmXmXmXmXmXmXmXmXmXmXmXmXmpQNlhyhaIPIPIPIPIPIPIPIPIPhawJzXpQXmXmXmXmXmXmXmXmXmXmXmXmXmXmXmXmXmXmXmXmXmXmXmXmXmXmXmXmXmXmXmXmXmXmXm
XmXmXmXmXmXmXmXmXmXmXmXmXmXmXmXmXmXmXmXmXmXmXmXmXmXmXmXmpQKWLyLdLdLdLdLdLdLdLdLdLdLdFetnpQXmXmXmXmXmXmXmXmXmXmXmXmXmXmXmXmXmXmXmXmXmXmXmXmXmXmXmXmXmXmXmXmXmXmXm
XmXmXmXmXmXmXmXmXmXmXmXmXmXmXmXmXmXmXmXmXmXmXmXmXmXmXmXmpQBjkuLdLdLdLdLdLdLdLdLdLdLdhJCJpQXmXmXmXmXmXmXmXmXmXmXmXmXmXmXmXmXmXmXmXmXmXmXmXmXmXmXmXmXmXmXmXmXmXmXm
XmXmXmXmXmXmXmXmXmXmXmXmXmXmXmXmXmXmXmXmXmXmXmXmXmXmXmXmpQBjkuLdLdLdLdLdLdLdLdLdLdLdhJCJpQXmXmXmXmXmXmXmXmXmXmXmXmXmXmXmXmXmXmXmXmXmXmXmXmXmXmXmXmXmXmXmXmXmXmXm
XmXmXmXmXmXmXmXmXmXmXmXmXmXmXmXmXmXmXmXmXmXmXmXmXmXmXmXmpQBjkuLdLdLdLdLdLdLdLdLdLdLdhJCJpQXmXmXmXmXmXmXmXmXmXmXmXmXmXmXmXmXmXmXmXmXmXmXmXmXmXmXmXmXmXmXmXmXmXmXm
XmXmXmXmXmXmXmXmXmXmXmXmXmXmXmXmXmXmXmXmXmXmXmXmXmXmXmXmpQBjkuLdLdLdLdLdLdLdLdLdLdLdhJCJpQXmXmXmXmXmXmXmXmXmXmXmXmXmXmXmXmXmXmXmXmXmXmXmXmXmXmXmXmXmXmXmXmXmXmXm
XmXmXmXmXmXmXmXmXmXmXmXmXmXmXmXmXmXmXmXmXmXmXmXmXmXmXmXmpQTlLyLdLdLdLdLdLdLdLdLdLdLdFeZipQXmXmXmXmXmXmXmXmXmXmXmXmXmXmXmXmXmXmXmXmXmXmXmXmXmXmXmXmXmXmXmXmXmXmXm
XmXmXmXmXmXmXmXmXmXmXmXmXmXmXmXmXmXmXmXmXmXmXmXmXmXmXmXmpQBjLyLdLdLdLdLdLdLdLdLdLdLdFeCJpQXmXmXmXmXmXmXmXmXmXmXmXmXmXmXmXmXmXmXmXmXmXmXmXmXmXmXmXmXmXmXmXmXmXmXm
XmXmXmXmXmXmXmXmXmXmXmXmXmXmXmXmXmXmXmXmXmXmXmXmXmXmXmXmpQBjLyLdLdLdLdLdLdLdLdLdLdLdFeCJpQXmXmXmXmXmXmXmXmXmXmXmXmXmXmXmXmXmXmXmXmXmXmXmXmXmXmXmXmXmXmXmXmXmXmXm
XmXmXmXmXmXmXmXmXmXmXmXmXmXmXmXmXmXmXmXmXmXmXmXmXmXmXmXmpQBjLyLdLdLdLdLdLdLdLdLdLdLdFeCJpQXmXmXmXmXmXmXmXmXmXmXmXmXmXmXmXmXmXmXmXmXmXmXmXmXmXmXmXmXmXmXmXmXmXmXm
XmXmXmXmXmXmXmXmXmXmXmXmXmXmXmXmXmXmXmXmXmXmXmXmXmXmXmXmpQBjLyLdLdLdLdLdLdLdLdLdLdLdFeCJpQXmXmXmXmXmXmXmXmXmXmXmXmXmXmXmXmXmXmXmXmXmXmXmXmXmXmXmXmXmXmXmXmXmXmXm
XmXmXmXmXmXmXmXmXmXmXmXmXmXmXmXmXmXmXmXmXmXmXmXmXmXmXmXmpQBjLyLdLdLdLdLdaaLdLdLdLdLdFeCJpQXmXmXmXmXmXmXmXmXmXmXmXmXmXmXmXmXmXmXmXmXmXmXmXmXmXmXmXmXmXmXmXmXmXmXm
XmXmXmXmXmXmXmXmXmXmXmXmXmXmXmXmXmXmXmXmXmXmXmXmXmXmXmXmpQBjLyLdLdLdLdLdLdLdLdLdLdLdFeCJpQXmXmXmXmXmXmXmXmXmXmXmXmXmXmXmXmXmXmXmXmXmXmXmXmXmXmXmXmXmXmXmXmXmXmXm
XmXmXmXmXmXmXmXmXmXmXmXmXmXmXmXmXmXmXmXmXmXmXmXmXmXmXmXmpQBjLyLdLdLdLdLdLdLdLdLdLdLdFeCJpQXmXmXmXmXmXmXmXmXmXmXmXmXmXmXmXmXmXmXmXmXmXmXmXmXmXmXmXmXmXmXmXmXmXmXm
XmXmXmXmXmXmXmXmXmXmXmXmXmXmXmXmXmXmXmXmXmXmXmXmXmXmXmXmpQBjLyLdLdLdLdLdLdLdLdLdLdLdFeCJpQXmXmXmXmXmXmXmXmXmXmXmXmXmXmXmXmXmXmXmXmXmXmXmXmXmXmXmXmXmXmXmXmXmXmXm
XmXmXmXmXmXmXmXmXmXmXmXmXmXmXmXmXmXmXmXmXmXmXmXmXmXmXmXmpQBjLyLdLdLdLdLdLdLdLdLdLdLdFeCJpQXmXmXmXmXmXmXmXmXmXmXmXmXmXmXmXmXmXmXmXmXmXmXmXmXmXmXmXmXmXmXmXmXmXmXm
XmXmXmXmXmXmXmXmXmXmXmXmXmXmXmXmXmXmXmXmXmXmXmXmXmXmXmXmpQTlLyLdLdLdLdLdLdLdLdLdLdLdFeZipQXmXmXmXmXmXmXmXmXmXmXmXmXmXmXmXmXmXmXmXmXmXmXmXmXmXmXmXmXmXmXmXmXmXmXm
XmXmXmXmXmXmXmXmXmXmXmXmXmXmXmXmXmXmXmXmXmXmXmXmXmXmXmXmpQBjkuLdLdLdLdLdLdLdLdLdLdLdhJCJpQXmXmXmXmXmXmXmXmXmXmXmXmXmXmXmXmXmXmXmXmXmXmXmXmXmXmXmXmXmXmXmXmXmXmXm
XmXmXmXmXmXmXmXmXmXmXmXmXmXmXmXmXmXmXmXmXmXmXmXmXmXmXmXmpQBjkuLdLdLdLdLdLdLdLdLdLdLdhJCJpQXmXmXmXmXmXmXmXmXmXmXmXmXmXmXmXmXmXmXmXmXmXmXmXmXmXmXmXmXmXmXmXmXmXmXm
XmXmXmXmXmXmXmXmXmXmXmXmXmXmXmXmXmXmXmXmXmXmXmXmXmXmXmXmpQBjkuLdLdLdLdLdLdLdLdLdLdLdhJCJpQXmXmXmXmXmXmXmXmXmXmXmXmXmXmXmXmXmXmXmXmXmXmXmXmXmXmXmXmXmXmXmXmXmXmXm
XmXmXmXmXmXmXmXmXmXmXmXmXmXmXmXmXmXmXmXmXmXmXmXmXmXmXmXmpQBjkuLdLdLdLdLdLdLdLdLdLdLdhJCJpQXmXmXmXmXmXmXmXmXmXmXmXmXmXmXmXmXmXmXmXmXmXmXmXmXmXmXmXmXmXmXmXmXmXmXm
XmXmXmXmXmXmXmXmXmXmXmXmXmXmXmXmXmXmXmXmXmXmXmXmXmXmXmXmpQMELyLdLdLdLdLdLdLdLdLdLdLdFeMGpQXmXmXmXmXmXmXmXmXmXmXmXmXmXmXmXmXmXmXmXmXmXmXmXmXmXmXmXmXmXmXmXmXmXmXm
XmXmXmXmXmXmXmXmXmXmXmXmXmXmXmXmXmXmXmXmXmXmXmXmXmXmXmXmpQNlAxINneneneneneneneneneINwZzXpQXmXmXmXmXmXmXmXmXmXmXmXmXmXmXmXmXmXmXmXmXmXmXmXmXmXmXmXmXmXmXmXmXmXmXm
XmXmXmXmXmXmXmXmXmXmXmXmXmXmXmXmXmXmXmXmXmXmXmXmXmXmXmXmpQKWHNbLtCtCApcShmcSbLtCtCApHNtnpQXmXmXmXmXmXmXmXmXmXmXmXmXmXmXmXmXmXmXmXmXmXmXmXmXmXmXmXmXmXmXmXmXmXmXm
XmXmXmXmXmXmXmXmXmXmXmXmXmXmXmXmXmXmXmXmXmXmXmXmXmXmXmXmpQBjiJnUGGGGOxcScScSCMGGGGKaiJCJpQXmXmXmXmXmXmXmXmXmXmXmXmXmXmXmXmXmXmXmXmXmXmXmXmXmXmXmXmXmXmXmXmXmXmXm
XmXmXmXmXmXmXmXmXmXmXmXmXmXmXmXmXmXmXmXmXmXmXmXmXmXmpQpQpQpQpQpQzFqrpQJUJUJUpQzFqrpQpQpQpQpQpQpQpQpQXmXmXmXmXmXmXmXmXmXmXmXmXmXmXmXmXmXmXmXmXmXmXmXmXmXmXmXmXmXm
XmXmXmXmXmXmXmXmXmXmXmXmXmXmXmXmXmXmXmXmXmXmXmXmXmXmpQQOYMpQfeXrXrBtNEGGGGGGNEtXXrXrAKpQGTGTGTGTGTpQXmXmXmXmXmXmXmXmXmXmXmXmXmXmXmXmXmXmXmXmXmXmXmXmXmXmXmXmXmXm
XmXmXmXmXmXmXmXmXmXmXmXmXmXmXmXmXmXmXmXmXmXmXmXmXmXmpQucucIRApHNEzEzHNHNEzHNHNEzEzHNbLEwdfWcWcWcGTpQXmXmXmXmXmXmXmXmXmXmXmXmXmXmXmXmXmXmXmXmXmXmXmXmXmXmXmXmXmXm
XmXmXmXmXmXmXmXmXmXmXmXmXmXmXmXmXmXmXmXmXmXmXmXmXmXmpQlBpcpQKaDhxWefNEGGGGGGNExExWZUnUEwdfWcWcWcGTpQXmXmXmXmXmXmXmXmXmXmXmXmXmXmXmXmXmXmXmXmXmXmXmXmXmXmXmXmXmXm
XmXmXmXmXmXmXmXmXmXmXmXmXmXmXmXmXmXmXmXmXmXmXmXmXmXmpQWcWcpQKalrpQqXneneneneneZkpQYpnUEwdfWcWcWcGTpQXmXmXmXmXmXmXmXmXmXmXmXmXmXmXmXmXmXmXmXmXmXmXmXmXmXmXmXmXmXm
XmXmXmXmXmXmXmXmXmXmXmXmXmXmXmXmXmXmXmXmXmXmXmXmXmXmpQpQpQpQKaCtFeieqjqjqjqjqjieLyLCnUpQGTGTGTGTGTpQXmXmXmXmXmXmXmXmXmXmXmXmXmXmXmXmXmXmXmXmXmXmXmXmXmXmXmXmXmXm
XmXmXmXmXmXmXmXmXmXmXmXmXmXmXmXmXmXmXmXmXmXmXmXmXmXmXmXmXmpQKaoQFeWAGgkBkBkBfqUSLyoQnUpQpQpQpQpQpQpQXmXmXmXmXmXmXmXmXmXmXmXmXmXmXmXmXmXmXmXmXmXmXmXmXmXmXmXmXmXm
XmXmXmXmXmXmXmXmXmXmXmXmXmXmXmXmXmXmXmXmXmXmXmXmXmXmXmXmXmpQDwoQFeWAlUPIPIPInkUSLyoQqJpQXmXmXmXmXmXmXmXmXmXmXmXmXmXmXmXmXmXmXmXmXmXmXmXmXmXmXmXmXmXmXmXmXmXmXmXm
XmXmXmXmXmXmXmXmXmXmXmXmXmXmXmXmXmXmXmXmXmXmXmXmXmXmXmXmXmpQiEQqFeWAlUPIFOPInkUSLyQqlEpQXmXmXmXmXmXmXmXmXmXmXmXmXmXmXmXmXmXmXmXmXmXmXmXmXmXmXmXmXmXmXmXmXmXmXmXm
XmXmXmXmXmXmXmXmXmXmXmXmXmXmXmXmXmXmXmXmXmXmXmXmXmXmXmXmXmpQApoQFeWAlUPIPIPInkUSLyoQbLpQXmXmXmXmXmXmXmXmXmXmXmXmXmXmXmXmXmXmXmXmXmXmXmXmXmXmXmXmXmXmXmXmXmXmXmXm
XmXmXmXmXmXmXmXmXmXmXmXmXmXmXmXmXmXmXmXmXmXmXmXmXmXmXmXmXmpQKaoQFeWAJljbjbjbTiUSLyoQnUpQXmXmXmXmXmXmXmXmXmXmXmXmXmXmXmXmXmXmXmXmXmXmXmXmXmXmXmXmXmXmXmXmXmXmXmXm
XmXmXmXmXmXmXmXmXmXmXmXmXmXmXmXmXmXmXmXmXmXmXmXmXmXmXmXmXmpQKaRSFeOJtptptptptpieLyktnUpQXmXmXmXmXmXmXmXmXmXmXmXmXmXmXmXmXmXmXmXmXmXmXmXmXmXmXmXmXmXmXmXmXmXmXmXm
XmXmXmXmXmXmXmXmXmXmXmXmXmXmXmXmXmXmXmXmXmXmXmXmXmXmXmXmXmpQpQlrpQMwIPIPIPIPIPtIpQYppQpQXmXmXmXmXmXmXmXmXmXmXmXmXmXmXmXmXmXmXmXmXmXmXmXmXmXmXmXmXmXmXmXmXmXmXmXm
XmXmXmXmXmXmXmXmXmXmXmXmXmXmXmXmXmXmXmXmXmXmXmXmXmXmXmXmXmXmpQrKXrhoGGGGCOGGGGwzXrUbpQXmXmXmXmXmXmXmXmXmXmXmXmXmXmXmXmXmXmXmXmXmXmXmXmXmXmXmXmXmXmXmXmXmXmXmXmXm
XmXmXmXmXmXmXmXmXmXmXmXmXmXmXmXmXmXmXmXmXmXmXmXmXmXmXmXmXmXmpQpQpQpQpQpQpQpQpQpQpQpQpQXmXmXmXmXmXmXmXmXmXmXmXmXmXmXmXmXmXmXmXmXmXmXmXmXmXmXmXmXmXmXmXmXmXmXmXmXm
XmXmXmXmXmXmXmXmXmXmXmXmXmXmXmXmXmXmXmXmXmXmXmXmXmXmXmXmXmXmXmXmXmXmXmXmXmXmXmXmXmXmXmXmXmXmXmXmXmXmXmXmXmXmXmXmXmXmXmXmXmXmXmXmXmXmXmXmXmXmXmXmXmXmXmXmXmXmXmXm
XmXmXmXmXmXmXmXmXmXmXmXmXmXmXmXmXmXmXmXmXmXmXmXmXmXmXmXmXmXmXmXmXmXmXmXmXmXmXmXmXmXmXmXmXmXmXmXmXmXmXmXmXmXmXmXmXmXmXmXmXmXmXmXmXmXmXmXmXmXmXmXmXmXmXmXmXmXmXmXm
XmXmXmXmXmXmXmXmXmXmXmXmXmXmXmXmXmXmXmXmXmXmXmXmXmXmXmXmXmXmXmXmXmXmXmXmXmXmXmXmXmXmXmXmXmXmXmXmXmXmXmXmXmXmXmXmXmXmXmXmXmXmXmXmXmXmXmXmXmXmXmXmXmXmXmXmXmXmXmXm
jeXmXmXmXmXmXmXmXmXmXmXmXmXmXmXmXmXmXmXmXmXmXmXmXmXmXmXmXmXmXmXmXmXmXmXmXmXmXmXmXmXmXmXmXmXmXmXmXmXmXmXmXmXmXmXmXmXmXmXmXmXmXmXmXmXmXmXmXmXmXmXmXmXmXmXmXmXmXmXm
"}
