"bc" = (/obj/structure/table/rack,/obj/random/material,/obj/effect/decal/cleanable/dirt,/obj/random/powercell,/turf/simulated/floor/tiled/techfloor,/area/map_template/build/build2)
"bt" = (/obj/machinery/door/airlock/hatch,/obj/machinery/atmospherics/pipe/simple/hidden/supply,/obj/machinery/atmospherics/pipe/simple/hidden/scrubbers,/turf/simulated/floor/tiled/steel_ridged,/area/map_template/build/build2)
"bx" = (/turf/simulated/wall/titanium,/area/map_template/build/build2)
"bA" = (/obj/machinery/atmospherics/portables_connector{dir = 1},/obj/machinery/portable_atmospherics/canister/air,/obj/effect/decal/cleanable/dirt,/turf/simulated/floor/plating,/area/map_template/build/build2)
"bG" = (/obj/machinery/light/small,/obj/effect/floor_decal/techfloor{dir = 8},/obj/effect/floor_decal/corner/green{dir = 6},/turf/simulated/floor/tiled/techfloor,/area/map_template/build/build2)
"bI" = (/obj/effect/floor_decal/techfloor{dir = 1},/obj/effect/floor_decal/corner/yellow{dir = 10},/obj/effect/decal/cleanable/dirt,/turf/simulated/floor/tiled/techfloor,/area/map_template/build/build2)
"bK" = (/obj/machinery/atmospherics/pipe/simple/hidden/supply,/obj/machinery/atmospherics/pipe/manifold/hidden/scrubbers{dir = 8},/obj/effect/decal/cleanable/dirt,/turf/simulated/floor/tiled/techfloor,/area/map_template/build/build2)
"ci" = (/obj/machinery/light/small,/obj/machinery/atmospherics/unary/vent_scrubber/on{dir = 8},/obj/effect/floor_decal/corner/green/half{dir = 8},/turf/simulated/floor/tiled/dark/monotile,/area/map_template/build/build2)
"df" = (/obj/effect/floor_decal/techfloor{dir = 4},/obj/effect/floor_decal/corner/yellow{dir = 9},/obj/effect/decal/cleanable/dirt,/obj/machinery/mech_recharger,/turf/simulated/floor/tiled/techfloor,/area/map_template/build/build2)
"dp" = (/obj/item/stock_parts/manipulator/femto,/turf/simulated/floor/tiled/techfloor,/area/map_template/build/build2)
"dH" = (/obj/machinery/button/blast_door{id_tag = "build2_gar1"; name = "Garage Shutter 1"; pixel_y = 28},/obj/effect/floor_decal/techfloor{dir = 1},/obj/effect/floor_decal/corner/yellow{dir = 10},/obj/random/contraband,/obj/random/contraband,/obj/random/contraband,/obj/structure/table/rack,/obj/effect/decal/cleanable/cobweb,/turf/simulated/floor/tiled/techfloor,/area/map_template/build/build2)
"em" = (/obj/effect/decal/cleanable/dirt,/obj/structure/reagent_dispensers/fueltank,/turf/simulated/floor/tiled/techfloor,/area/map_template/build/build2)
"eC" = (/obj/machinery/door/blast/shutters{dir = 8; name = "Garage Shutter"; id_tag = "build2_gar1"},/turf/simulated/floor/tiled/steel_ridged,/area/map_template/build/build2)
"fb" = (/obj/effect/decal/cleanable/dirt,/obj/random/tool,/turf/unsimulated/floor/exoplanet/concrete,/area/template_noop)
"fy" = (/obj/structure/bed/chair{dir = 1},/obj/effect/floor_decal/spline/fancy/wood/corner{dir = 1},/turf/simulated/floor/lino,/area/map_template/build/build2)
"fI" = (/obj/effect/decal/cleanable/dirt,/obj/effect/decal/cleanable/blood/oil,/turf/simulated/floor/tiled/techfloor,/area/map_template/build/build2)
"gx" = (/obj/effect/floor_decal/spline/fancy/wood{dir = 8},/obj/item/stool/wood,/turf/simulated/floor/lino,/area/map_template/build/build2)
"gK" = (/obj/machinery/atmospherics/pipe/simple/hidden/supply{dir = 6},/obj/effect/decal/cleanable/dirt,/turf/simulated/floor/lino,/area/map_template/build/build2)
"hB" = (/obj/machinery/atmospherics/pipe/simple/visible/universal,/obj/machinery/meter,/obj/structure/cable{d1 = 1; d2 = 2; icon_state = "1-2"},/obj/effect/decal/cleanable/dirt,/turf/simulated/floor/plating,/area/map_template/build/build2)
"hK" = (/obj/effect/decal/cleanable/dirt,/turf/simulated/floor/tiled/techfloor/grid,/area/map_template/build/build2)
"hQ" = (/obj/effect/decal/cleanable/dirt,/obj/item/caution/cone,/obj/effect/decal/cleanable/liquid_fuel,/turf/unsimulated/floor/exoplanet/concrete/reinforced/road,/area/template_noop)
"it" = (/obj/effect/floor_decal/techfloor{dir = 4},/obj/effect/floor_decal/corner/yellow{dir = 9},/obj/effect/decal/cleanable/dirt,/turf/simulated/floor/tiled/techfloor,/area/map_template/build/build2)
"iA" = (/obj/machinery/light/small{dir = 4},/obj/effect/floor_decal/techfloor{dir = 4},/obj/effect/floor_decal/corner/yellow{dir = 9},/turf/simulated/floor/tiled/techfloor,/area/map_template/build/build2)
"iK" = (/obj/item/stock_parts/manipulator/pico,/obj/effect/decal/cleanable/liquid_fuel,/turf/simulated/floor/tiled/techfloor,/area/map_template/build/build2)
"jb" = (/obj/machinery/atmospherics/pipe/manifold/hidden/supply{dir = 8},/obj/machinery/atmospherics/pipe/simple/hidden/scrubbers,/obj/effect/decal/cleanable/dirt,/turf/simulated/floor/tiled/techfloor,/area/map_template/build/build2)
"jv" = (/obj/random/toolbox,/obj/effect/decal/cleanable/dirt,/turf/simulated/floor/tiled/techfloor,/area/map_template/build/build2)
"jH" = (/turf/unsimulated/floor/exoplanet/concrete/reinforced/road,/area/template_noop)
"kE" = (/obj/random/tool,/obj/effect/decal/cleanable/dirt,/obj/effect/decal/cleanable/liquid_fuel,/turf/simulated/floor/tiled/techfloor,/area/map_template/build/build2)
"kF" = (/obj/machinery/atmospherics/unary/vent_pump/on{dir = 8},/obj/effect/floor_decal/corner/green/half{dir = 8},/obj/effect/decal/cleanable/dirt,/turf/simulated/floor/tiled/dark/monotile,/area/map_template/build/build2)
"me" = (/obj/structure/bed/sofa/brown,/obj/effect/floor_decal/spline/fancy/wood,/turf/simulated/floor/lino,/area/map_template/build/build2)
"mx" = (/obj/effect/decal/cleanable/liquid_fuel,/turf/unsimulated/floor/exoplanet/concrete,/area/template_noop)
"mW" = (/obj/effect/floor_decal/spline/fancy/wood{dir = 1},/obj/effect/decal/cleanable/dirt,/obj/effect/decal/cleanable/blood/oil,/turf/simulated/floor/lino,/area/map_template/build/build2)
"ng" = (/obj/effect/decal/cleanable/liquid_fuel,/turf/simulated/floor/tiled/techfloor,/area/map_template/build/build2)
"nx" = (/obj/effect/decal/cleanable/dirt,/obj/effect/decal/cleanable/liquid_fuel,/turf/unsimulated/floor/exoplanet/concrete,/area/template_noop)
"ny" = (/obj/effect/floor_decal/industrial/warning/dust/corner{dir = 4},/obj/effect/decal/cleanable/liquid_fuel,/obj/machinery/light/small{dir = 4},/turf/unsimulated/floor/exoplanet/concrete,/area/map_template/build/build2)
"nA" = (/obj/effect/decal/cleanable/liquid_fuel,/turf/unsimulated/floor/exoplanet/concrete/reinforced/road,/area/template_noop)
"nW" = (/obj/effect/floor_decal/techfloor{dir = 5},/obj/effect/floor_decal/corner/yellow{dir = 8},/obj/machinery/portable_atmospherics/powered/pump/filled,/obj/effect/floor_decal/techfloor/hole/right{dir = 1},/turf/simulated/floor/tiled/techfloor,/area/map_template/build/build2)
"ov" = (/obj/effect/floor_decal/techfloor{dir = 4},/obj/effect/floor_decal/corner/yellow{dir = 9},/obj/effect/floor_decal/techfloor/hole/right{dir = 4},/obj/item/clothing/accessory/solgov/skillbadge/mech,/obj/random/torchcloset,/turf/simulated/floor/tiled/techfloor,/area/map_template/build/build2)
"pl" = (/obj/machinery/power/smes/buildable/max_cap_in_out,/obj/machinery/atmospherics/pipe/simple/hidden/scrubbers{dir = 10},/obj/structure/cable{d2 = 2; icon_state = "0-2"},/obj/effect/decal/cleanable/dirt,/obj/effect/decal/cleanable/cobweb2,/turf/simulated/floor/plating,/area/map_template/build/build2)
"pp" = (/turf/unsimulated/floor/exoplanet/concrete,/area/template_noop)
"qh" = (/obj/machinery/light/small{dir = 8},/obj/effect/decal/cleanable/dirt,/turf/simulated/floor/tiled/techfloor,/area/map_template/build/build2)
"qJ" = (/obj/structure/bed/chair{dir = 1},/obj/effect/floor_decal/spline/fancy/wood{dir = 1},/obj/effect/decal/cleanable/dirt,/turf/simulated/floor/lino,/area/map_template/build/build2)
"qY" = (/obj/machinery/light/small{dir = 8},/obj/effect/floor_decal/spline/fancy/wood{dir = 4},/obj/item/airlock_electronics,/turf/simulated/floor/lino,/area/map_template/build/build2)
"qZ" = (/obj/structure/table/steel_reinforced,/obj/random/loot,/obj/structure/window/reinforced{dir = 8},/obj/effect/decal/cleanable/dirt,/turf/simulated/floor/tiled/dark/monotile,/area/map_template/build/build2)
"rc" = (/obj/machinery/atmospherics/unary/tank/air{dir = 1},/obj/effect/decal/cleanable/dirt,/turf/simulated/floor/plating,/area/map_template/build/build2)
"ru" = (/obj/effect/decal/cleanable/dirt,/obj/effect/decal/cleanable/blood/oil,/turf/unsimulated/floor/exoplanet/concrete/reinforced/road,/area/template_noop)
"sn" = (/obj/effect/decal/cleanable/dirt,/turf/simulated/floor/tiled/techfloor,/area/map_template/build/build2)
"sp" = (/obj/effect/decal/cleanable/dirt,/obj/item/caution/cone{pixel_x = -9},/obj/effect/decal/cleanable/liquid_fuel,/turf/unsimulated/floor/exoplanet/concrete,/area/template_noop)
"tp" = (/obj/effect/decal/cleanable/dirt,/obj/item/circuitboard/exosystem/utility,/turf/simulated/floor/tiled/techfloor,/area/map_template/build/build2)
"tv" = (/obj/effect/decal/cleanable/dirt,/turf/simulated/floor/carpet,/area/map_template/build/build2)
"uW" = (/obj/effect/decal/cleanable/dirt,/turf/template_noop,/area/template_noop)
"uY" = (/obj/effect/floor_decal/industrial/warning/dust{dir = 4},/obj/machinery/light/small{dir = 4},/turf/unsimulated/floor/exoplanet/concrete,/area/map_template/build/build2)
"vu" = (/obj/machinery/atmospherics/unary/vent_pump/on{dir = 8},/obj/effect/floor_decal/techfloor{dir = 4},/obj/effect/floor_decal/corner/green{dir = 9},/turf/simulated/floor/tiled/techfloor,/area/map_template/build/build2)
"vR" = (/obj/effect/floor_decal/techfloor{dir = 8},/obj/effect/floor_decal/corner/green{dir = 6},/obj/effect/decal/cleanable/dirt,/turf/simulated/floor/tiled/techfloor,/area/map_template/build/build2)
"wh" = (/obj/structure/table/rack,/obj/random/material,/turf/simulated/floor/tiled/techfloor/grid,/area/map_template/build/build2)
"wk" = (/obj/machinery/atmospherics/binary/pump/on{dir = 1},/obj/structure/cable{d1 = 1; d2 = 8; icon_state = "1-8"},/obj/random/loot,/obj/effect/decal/cleanable/dirt,/obj/effect/decal/cleanable/liquid_fuel,/turf/simulated/floor/plating,/area/map_template/build/build2)
"wu" = (/obj/effect/decal/cleanable/dirt,/obj/effect/decal/cleanable/liquid_fuel,/turf/simulated/floor/tiled/techfloor,/area/map_template/build/build2)
"xl" = (/obj/effect/decal/cleanable/dirt,/obj/effect/decal/cleanable/liquid_fuel,/obj/item/robot_parts/robot_component/armour/exosuit/combat/syndie,/turf/simulated/floor/tiled/techfloor,/area/map_template/build/build2)
"yc" = (/obj/effect/decal/cleanable/blood/oil,/turf/unsimulated/floor/exoplanet/concrete,/area/template_noop)
"yo" = (/obj/machinery/door/blast/shutters{dir = 8; name = "Garage Shutter"; id_tag = "build2_gar2"},/turf/simulated/floor/tiled/steel_ridged,/area/map_template/build/build2)
"yR" = (/obj/structure/table/steel_reinforced,/obj/machinery/door/window/westleft,/obj/item/reagent_containers/food/snacks/boiledspagetti,/turf/simulated/floor/tiled/dark/monotile,/area/map_template/build/build2)
"zS" = (/obj/machinery/light/small{dir = 1},/obj/effect/floor_decal/spline/fancy/wood,/turf/simulated/floor/lino,/area/map_template/build/build2)
"zX" = (/obj/effect/floor_decal/techfloor{dir = 4},/obj/effect/floor_decal/corner/yellow{dir = 9},/turf/simulated/floor/tiled/techfloor,/area/map_template/build/build2)
"Ab" = (/obj/machinery/atmospherics/pipe/simple/hidden/scrubbers,/obj/machinery/atmospherics/pipe/simple/hidden/supply,/obj/effect/decal/cleanable/dirt,/turf/simulated/floor/tiled/techfloor,/area/map_template/build/build2)
"Ao" = (/obj/effect/decal/cleanable/dirt,/obj/machinery/mech_recharger,/mob/living/exosuit/premade/combat,/turf/simulated/floor/tiled/techfloor,/area/map_template/build/build2)
"Bk" = (/obj/effect/decal/cleanable/dirt,/obj/effect/decal/cleanable/liquid_fuel,/turf/unsimulated/floor/exoplanet/concrete/reinforced/road,/area/template_noop)
"Bp" = (/obj/effect/decal/cleanable/dirt,/turf/unsimulated/floor/exoplanet/concrete,/area/template_noop)
"Ch" = (/obj/machinery/door/airlock/hatch,/obj/machinery/atmospherics/pipe/simple/hidden/scrubbers,/obj/machinery/atmospherics/pipe/simple/hidden/supply,/turf/simulated/floor/tiled/steel_ridged,/area/map_template/build/build2)
"Cu" = (/obj/machinery/atmospherics/pipe/simple/hidden/supply,/obj/machinery/atmospherics/pipe/simple/hidden/scrubbers{dir = 5},/obj/machinery/power/terminal{dir = 4},/obj/structure/cable{d2 = 2; icon_state = "0-2"},/turf/simulated/floor/plating,/area/map_template/build/build2)
"CS" = (/obj/random/obstruction,/turf/simulated/floor/tiled/techfloor,/area/map_template/build/build2)
"De" = (/obj/structure/table/standard,/obj/random/loot,/obj/effect/decal/cleanable/dirt,/turf/simulated/floor/carpet,/area/map_template/build/build2)
"Dj" = (/obj/effect/decal/cleanable/dirt,/obj/effect/floor_decal/industrial/warning/dust{dir = 4},/turf/unsimulated/floor/exoplanet/concrete,/area/template_noop)
"DA" = (/obj/machinery/libraryscanner{pixel_y = 6},/obj/machinery/alarm/noaccess{pixel_y = 20},/obj/effect/floor_decal/corner/green/half,/obj/effect/decal/cleanable/dirt,/turf/simulated/floor/tiled/dark/monotile,/area/map_template/build/build2)
"Ek" = (/obj/machinery/door/airlock/hatch,/turf/simulated/floor/tiled/steel_ridged,/area/map_template/build/build2)
"FT" = (/obj/structure/bed/sofa/brown/left,/obj/effect/floor_decal/spline/fancy/wood/corner,/turf/simulated/floor/lino,/area/map_template/build/build2)
"Go" = (/obj/effect/floor_decal/spline/fancy/wood{dir = 4},/turf/simulated/floor/lino,/area/map_template/build/build2)
"Gu" = (/obj/structure/table/steel,/obj/machinery/light/small{dir = 4},/obj/effect/floor_decal/corner/green/half{dir = 8},/obj/random/handgun,/obj/effect/decal/cleanable/dirt,/turf/simulated/floor/tiled/dark/monotile,/area/map_template/build/build2)
"GL" = (/obj/effect/floor_decal/corner/green/half,/obj/machinery/photocopier,/turf/simulated/floor/tiled/dark/monotile,/area/map_template/build/build2)
"Hd" = (/obj/machinery/atmospherics/unary/vent_scrubber/on{dir = 8},/obj/effect/floor_decal/techfloor{dir = 4},/obj/effect/floor_decal/corner/green{dir = 9},/turf/simulated/floor/tiled/techfloor,/area/map_template/build/build2)
"Hn" = (/obj/machinery/light/small,/obj/effect/decal/cleanable/blood/oil,/turf/simulated/floor/tiled/techfloor,/area/map_template/build/build2)
"Hs" = (/obj/effect/floor_decal/techfloor{dir = 8},/obj/effect/floor_decal/corner/green{dir = 6},/obj/effect/decal/cleanable/dirt,/obj/effect/decal/cleanable/blood/oil,/turf/simulated/floor/tiled/techfloor,/area/map_template/build/build2)
"Im" = (/obj/effect/decal/cleanable/dirt,/turf/unsimulated/floor/exoplanet/concrete/reinforced/road,/area/template_noop)
"IO" = (/turf/template_noop,/area/template_noop)
"Jk" = (/obj/effect/decal/cleanable/dirt,/obj/item/caution,/turf/simulated/floor/carpet,/area/map_template/build/build2)
"Kj" = (/obj/random/tool,/turf/simulated/floor/tiled/techfloor,/area/map_template/build/build2)
"KP" = (/obj/effect/decal/cleanable/dirt,/turf/simulated/floor/lino,/area/map_template/build/build2)
"LF" = (/obj/machinery/atmospherics/portables_connector,/obj/item/blueprints/outpost,/turf/simulated/floor/plating,/area/map_template/build/build2)
"Mc" = (/obj/effect/floor_decal/techfloor{dir = 4},/obj/effect/floor_decal/corner/yellow{dir = 9},/obj/random/tank,/turf/simulated/floor/tiled/techfloor,/area/map_template/build/build2)
"Mr" = (/obj/effect/floor_decal/industrial/warning/dust{dir = 4},/turf/unsimulated/floor/exoplanet/concrete,/area/template_noop)
"Oy" = (/obj/random/obstruction,/obj/effect/decal/cleanable/dirt,/turf/simulated/floor/tiled/techfloor,/area/map_template/build/build2)
"OB" = (/obj/effect/decal/cleanable/blood/oil,/turf/unsimulated/floor/exoplanet/concrete/reinforced/road,/area/template_noop)
"OG" = (/obj/structure/reagent_dispensers/watertank,/obj/effect/floor_decal/techfloor{dir = 4},/obj/effect/floor_decal/corner/green{dir = 9},/obj/effect/floor_decal/techfloor/hole/right{dir = 4},/turf/simulated/floor/tiled/techfloor,/area/map_template/build/build2)
"OR" = (/obj/effect/decal/cleanable/dirt,/obj/machinery/light/small{dir = 4},/turf/unsimulated/floor/exoplanet/concrete,/area/map_template/build/build2)
"OS" = (/turf/simulated/floor/carpet,/area/map_template/build/build2)
"Pv" = (/obj/machinery/atmospherics/binary/pump/on{target_pressure = 200},/obj/effect/decal/cleanable/dirt,/turf/simulated/floor/plating,/area/map_template/build/build2)
"PS" = (/obj/machinery/light/small{dir = 1},/obj/effect/floor_decal/techfloor{dir = 1},/obj/effect/floor_decal/corner/yellow{dir = 10},/obj/structure/table/rack,/obj/random/material,/obj/effect/decal/cleanable/dirt,/turf/simulated/floor/tiled/techfloor,/area/map_template/build/build2)
"Qf" = (/obj/structure/table/steel_reinforced,/obj/machinery/door/window/westright,/obj/effect/decal/cleanable/dirt,/obj/item/stock_parts/console_screen,/turf/simulated/floor/tiled/dark/monotile,/area/map_template/build/build2)
"Qx" = (/obj/structure/table/steel,/obj/machinery/photocopier/faxmachine{department = "Gas Pump"},/obj/effect/floor_decal/corner/green{dir = 8},/obj/effect/decal/cleanable/cobweb2,/turf/simulated/floor/tiled/dark/monotile,/area/map_template/build/build2)
"Rf" = (/obj/machinery/vending/coffee{name = "hacked Hot Drinks machine"; prices = list()},/obj/effect/floor_decal/spline/fancy/wood/corner{dir = 8},/turf/simulated/floor/lino,/area/map_template/build/build2)
"Rj" = (/obj/effect/decal/cleanable/dirt,/obj/effect/decal/cleanable/blood/oil,/turf/simulated/floor/tiled/techfloor/grid,/area/map_template/build/build2)
"Sn" = (/obj/random/material,/obj/effect/decal/cleanable/dirt,/turf/simulated/floor/tiled/techfloor,/area/map_template/build/build2)
"SC" = (/obj/effect/floor_decal/industrial/warning/dust/corner,/obj/machinery/light/small{dir = 4},/turf/unsimulated/floor/exoplanet/concrete,/area/map_template/build/build2)
"SP" = (/obj/effect/decal/cleanable/dirt,/obj/effect/decal/cleanable/blood/oil,/obj/effect/decal/cleanable/liquid_fuel,/turf/simulated/floor/tiled/techfloor,/area/map_template/build/build2)
"Ub" = (/obj/effect/floor_decal/spline/fancy/wood{dir = 4},/obj/effect/decal/cleanable/dirt,/turf/simulated/floor/lino,/area/map_template/build/build2)
"Uq" = (/obj/structure/table/standard,/obj/random/advdevice,/obj/effect/decal/cleanable/dirt,/turf/simulated/floor/carpet,/area/map_template/build/build2)
"Ur" = (/obj/effect/decal/cleanable/dirt,/obj/machinery/fabricator/hacked,/turf/simulated/floor/tiled/techfloor,/area/map_template/build/build2)
"Us" = (/obj/item/caution/cone{pixel_x = -9},/turf/unsimulated/floor/exoplanet/concrete/reinforced/road,/area/template_noop)
"UA" = (/obj/machinery/portable_atmospherics/canister/empty,/obj/machinery/atmospherics/portables_connector{dir = 1},/obj/effect/decal/cleanable/dirt,/turf/simulated/floor/plating,/area/map_template/build/build2)
"UX" = (/obj/structure/bed/sofa/brown/right,/obj/effect/floor_decal/spline/fancy/wood,/obj/effect/decal/cleanable/dirt,/turf/simulated/floor/lino,/area/map_template/build/build2)
"Vt" = (/obj/machinery/atmospherics/binary/pump{dir = 1},/obj/structure/cable{d2 = 4; icon_state = "0-4"},/obj/machinery/power/port_gen/pacman,/obj/item/stack/material/phoron/ten,/obj/machinery/light/small{dir = 8},/obj/effect/decal/cleanable/dirt,/turf/simulated/floor/plating,/area/map_template/build/build2)
"VR" = (/turf/simulated/floor/lino,/area/map_template/build/build2)
"VU" = (/obj/machinery/light/small,/obj/effect/floor_decal/spline/fancy/wood/corner{dir = 4},/turf/simulated/floor/lino,/area/map_template/build/build2)
"Ww" = (/obj/structure/table/steel,/obj/effect/floor_decal/corner/green/half{dir = 8},/obj/item/spacecash/bundle/c1000{pixel_y = 7},/obj/random/cash,/obj/effect/decal/cleanable/dirt,/turf/simulated/floor/tiled/dark/monotile,/area/map_template/build/build2)
"WC" = (/obj/effect/floor_decal/spline/fancy/wood{dir = 8},/obj/effect/decal/cleanable/dirt,/turf/simulated/floor/lino,/area/map_template/build/build2)
"WJ" = (/obj/machinery/atmospherics/pipe/simple/hidden/supply,/obj/machinery/atmospherics/pipe/simple/hidden/scrubbers{dir = 6},/turf/simulated/floor/lino,/area/map_template/build/build2)
"Xf" = (/turf/simulated/wall/r_titanium,/area/map_template/build/build2)
"Yx" = (/obj/machinery/alarm/noaccess{pixel_y = 20},/obj/machinery/portable_atmospherics/powered/scrubber,/turf/simulated/floor/tiled/techfloor/grid,/area/map_template/build/build2)
"YA" = (/obj/machinery/atmospherics/pipe/simple/visible/universal,/obj/machinery/meter,/obj/machinery/power/apc{locked = 0; name = "south bump"; req_access = null; dir = 4; pixel_x = 27},/obj/structure/cable,/obj/random/powercell,/obj/effect/decal/cleanable/dirt,/turf/simulated/floor/plating,/area/map_template/build/build2)
"YP" = (/obj/structure/table/steel_reinforced,/obj/structure/window/reinforced{dir = 8},/obj/effect/decal/cleanable/dirt,/turf/simulated/floor/tiled/dark/monotile,/area/map_template/build/build2)
"Zh" = (/obj/machinery/button/blast_door{id_tag = "build2_gar2"; name = "Garage Shutter 2"; pixel_y = 28},/obj/effect/floor_decal/techfloor{dir = 1},/obj/effect/floor_decal/corner/yellow{dir = 10},/obj/structure/table/rack,/obj/random/powercell,/obj/random/tool,/obj/random/tool,/obj/effect/floor_decal/techfloor/hole/right{dir = 1},/turf/simulated/floor/tiled/techfloor,/area/map_template/build/build2)
"Zy" = (/obj/effect/wallframe_spawn/reinforced/titanium,/turf/template_noop,/area/map_template/build/build2)

(1,1,1) = {"
IOppUsImImppBpBpBpBpppppBpBpBpBpBppp
IOppImuWImppXfXfXfXfXfXfXfXfXfXfXfBp
ppBpImjHImppZyFTmeUXzSRfbxGLDAQxXfBp
BpuWjHrujHppZyUbDeUqOSWCqZKPVRGuXfBp
ycfbImjHIOORXfqYOStvtvWCQfKPVRWwXfBp
ppBpjHIOjHBpEkGoJktvtvgxyRKPgKkFXfpp
IOnxuWuWBkBpXffyqJqJmWVUYPKPWJciXfpp
IOppjHImImycXfbxbxbxEkbxbxbxChbxXfpp
uWBpBkImjHSCXfdHZhPSbInWYxHsAbOGXfBp
uWIOjHjHImDjeCfIsnsnwuzXhKvRjbvuXfBp
uWBpjHImnADjeCngdpSnCSzXRjbGbKHdXfBp
ppycBkBkuWMreCKjxlfIngMcwhbxbtbxXfBp
mxBpImuWjHuYXfqhbcAoUriAbxbxCuplXfBp
uWBpIOIOruDjyosnemiKtpitbxLFhBYAXfBp
uWspuWImImDjyoSPSnjvkEovbxVtwkPvXfBp
ppBpjHnAjHDjyoOywuHnsndfbxrcbAUAXfBp
ppIOOBImuWnyXfXfXfXfXfXfXfXfXfXfXfpp
IOppjHuWhQppppppppBpBpBpBppppppppppp
"}
