"a" = (/turf/simulated/wall/sandstone,/area/template_noop)
"T" = (/obj/effect/decal/cleanable/dirt,/turf/simulated/floor/airless/stone{color = "#C2B49B"},/area/template_noop)
"Z" = (/obj/structure/girder,/turf/simulated/floor/airless/stone{color = "#C2B49B"},/area/template_noop)

(1,1,1) = {"
TaTaT
TaaaT
TaaaT
TaaaT
TaZaT
TaZaT
TaZaT
TaaaT
TaaaT
TaaaT
TaaaT
TaaaT
TaaaT
TaZaT
TaZaT
TaZaT
TaaaT
TaaaT
TaaaT
TaTaT
"}
