"ah" = (/obj/machinery/light/ascent/damaged{dir = 1},/turf/simulated/floor/ascent/tiled,/area/map_template/build/build6)
"bn" = (/obj/item/robot_parts/robot_component/actuator,/obj/effect/decal/cleanable/dirt,/turf/simulated/floor/ascent/airless,/area/map_template/build/build6)
"bo" = (/obj/effect/decal/cleanable/dirt,/obj/structure/table/rack/ascent,/obj/structure/window/phoronreinforced{dir = 8},/obj/machinery/door/window/northright{color = "PURPLE"},/obj/item/tank/mantid/reactor/oxygen{name = "unknown alien reactor"; desc = "An Alien gas processing plant that continuously synthesises 'breathable' atmosphere."},/obj/item/tank/mantid/reactor/oxygen{name = "unknown alien reactor"; desc = "An Alien gas processing plant that continuously synthesises 'breathable' atmosphere."},/turf/simulated/floor/ascent/tiled,/area/map_template/build/build6)
"bJ" = (/obj/machinery/bodyscanner/ascent{dir = 4},/turf/template_noop,/area/map_template/build/build6)
"ci" = (/obj/effect/decal/cleanable/dirt,/obj/machinery/computer/ship/navigation/ascent{dir = 1},/turf/simulated/floor/ascent/airless,/area/map_template/build/build6)
"eg" = (/obj/effect/decal/cleanable/dirt,/obj/item/light/tube/ascent,/turf/simulated/floor/ascent/airless,/area/map_template/build/build6)
"eM" = (/obj/structure/cable/cyan{d1 = 1; d2 = 8; icon_state = "1-8"},/obj/item/inflatable_dispenser/ascents,/obj/effect/decal/cleanable/dirt,/turf/simulated/floor/ascent/tiled,/area/map_template/build/build6)
"eR" = (/obj/machinery/power/apc/hyper/ascent/north,/obj/structure/cable/cyan{d2 = 2; icon_state = "0-2"},/turf/simulated/floor/ascent/tiled,/area/map_template/build/build6)
"eW" = (/obj/structure/cable/cyan{d1 = 1; d2 = 8; icon_state = "1-8"},/turf/simulated/floor/ascent/airless,/area/map_template/build/build6)
"fl" = (/obj/item/robot_parts/robot_component/diagnosis_unit,/turf/simulated/floor/ascent/tiled,/area/map_template/build/build6)
"fW" = (/obj/structure/table/steel_reinforced/ascent,/obj/item/reagent_containers/food/drinks/cans/waterbottle/ascent,/turf/simulated/floor/ascent/tiled,/area/map_template/build/build6)
"fZ" = (/obj/structure/table/steel_reinforced/ascent,/turf/simulated/floor/ascent,/area/map_template/build/build6)
"go" = (/obj/effect/decal/cleanable/dirt,/obj/effect/decal/cleanable/dirt,/turf/simulated/floor/ascent,/area/map_template/build/build6)
"gM" = (/obj/machinery/alarm/ascent{pixel_y = 24},/obj/effect/decal/cleanable/dirt,/turf/simulated/floor/ascent/tiled,/area/map_template/build/build6)
"hb" = (/obj/item/reagent_containers/glass/bucket/ascent,/obj/effect/decal/cleanable/dirt,/turf/simulated/floor/ascent/tiled,/area/map_template/build/build6)
"hu" = (/obj/random/loot,/turf/simulated/floor/ascent/tiled,/area/map_template/build/build6)
"hw" = (/obj/effect/wallframe_spawn/reinforced_phoron,/turf/simulated/floor/ascent,/area/map_template/build/build6)
"hR" = (/obj/effect/decal/cleanable/dirt,/turf/simulated/floor/ascent/airless,/area/map_template/build/build6)
"hX" = (/obj/machinery/door/airlock/ascent,/obj/structure/cable/cyan{d1 = 1; d2 = 2; icon_state = "1-2"},/turf/simulated/floor/ascent,/area/map_template/build/build6)
"iX" = (/obj/structure/cable/cyan{d1 = 1; d2 = 2; icon_state = "1-2"},/turf/template_noop,/area/map_template/build/build6)
"jg" = (/obj/effect/decal/cleanable/dirt,/turf/simulated/floor/ascent,/area/map_template/build/build6)
"jk" = (/obj/machinery/portable_atmospherics/canister/methyl_bromide,/obj/effect/decal/cleanable/dirt,/obj/machinery/light/ascent/damaged,/turf/simulated/floor/ascent/tiled,/area/map_template/build/build6)
"jL" = (/obj/structure/bed/chair/padded/purple/ascent,/obj/effect/decal/cleanable/dirt,/turf/simulated/floor/ascent,/area/map_template/build/build6)
"jO" = (/turf/simulated/floor/ascent/airless,/area/map_template/build/build6)
"lK" = (/obj/structure/girder,/turf/simulated/floor/ascent/airless,/area/map_template/build/build6)
"mc" = (/obj/machinery/ion_engine{dir = 8},/turf/simulated/floor/ascent/airless,/area/map_template/build/build6)
"mS" = (/obj/effect/decal/cleanable/dirt,/turf/template_noop,/area/map_template/build/build6)
"no" = (/obj/structure/hygiene/sink/ascent{dir = 1; pixel_y = 28},/obj/item/storage/box/water/ascent,/obj/structure/table/steel_reinforced/ascent,/obj/effect/decal/cleanable/dirt,/turf/simulated/floor/ascent/tiled,/area/map_template/build/build6)
"nv" = (/obj/structure/cable/cyan{d1 = 4; d2 = 8; icon_state = "4-8"},/obj/structure/cable/cyan{d1 = 1; d2 = 2; icon_state = "1-2"},/turf/simulated/floor/ascent/tiled,/area/map_template/build/build6)
"oE" = (/obj/structure/cable/cyan{d2 = 2; icon_state = "0-2"},/obj/effect/decal/cleanable/dirt,/turf/simulated/floor/ascent/tiled,/area/map_template/build/build6)
"oV" = (/obj/structure/table/steel_reinforced/ascent,/turf/template_noop,/area/map_template/build/build6)
"px" = (/obj/item/material/shard{icon_state = "shrapnellarge"; default_material = "steel"},/turf/template_noop,/area/template_noop)
"pR" = (/obj/structure/table/rack/ascent,/obj/machinery/alarm/ascent{dir = 4; pixel_x = -24},/obj/item/weldingtool/electric/mantid,/obj/effect/decal/cleanable/dirt,/turf/simulated/floor/ascent/tiled,/area/map_template/build/build6)
"qP" = (/obj/machinery/optable/ascent,/obj/effect/decal/cleanable/dirt,/turf/simulated/floor/ascent/tiled,/area/map_template/build/build6)
"ro" = (/obj/structure/cable/cyan{d2 = 2; icon_state = "0-2"},/obj/machinery/constructable_frame/machine_frame,/turf/simulated/floor/ascent/tiled,/area/map_template/build/build6)
"ry" = (/obj/structure/cable/cyan{d1 = 4; d2 = 8; icon_state = "4-8"},/obj/structure/cable/cyan{d1 = 1; d2 = 8; icon_state = "1-8"},/obj/effect/decal/cleanable/dirt,/turf/simulated/floor/ascent/airless,/area/map_template/build/build6)
"rA" = (/obj/structure/cable/cyan{d1 = 2; d2 = 4; icon_state = "2-4"},/obj/effect/decal/cleanable/dirt,/turf/simulated/floor/ascent/tiled,/area/map_template/build/build6)
"rB" = (/obj/item/material/shard{icon_state = "shrapnellarge"; default_material = "steel"},/obj/effect/decal/cleanable/dirt,/turf/simulated/floor/ascent/airless,/area/map_template/build/build6)
"sL" = (/obj/effect/landmark/damager,/turf/simulated/wall/ascent,/area/map_template/build/build6)
"tC" = (/obj/structure/table/steel_reinforced/ascent,/obj/effect/decal/cleanable/dirt,/turf/template_noop,/area/map_template/build/build6)
"tH" = (/obj/effect/decal/cleanable/dirt,/obj/item/stack/cable_coil/cyan{amount = 1},/turf/template_noop,/area/map_template/build/build6)
"tN" = (/obj/effect/decal/cleanable/dirt,/obj/item/material/shard/phoron,/turf/template_noop,/area/map_template/build/build6)
"tS" = (/obj/effect/wallframe_spawn/reinforced_phoron,/turf/simulated/floor/ascent/airless,/area/map_template/build/build6)
"vi" = (/obj/effect/decal/cleanable/dirt,/obj/effect/decal/cleanable/dirt,/obj/machinery/light/ascent/damaged{dir = 4},/turf/simulated/floor/ascent,/area/map_template/build/build6)
"vz" = (/obj/structure/cable/cyan{d1 = 4; d2 = 8; icon_state = "4-8"},/obj/item/material/shard{icon_state = "shrapnellarge"; default_material = "steel"},/obj/effect/decal/cleanable/dirt,/turf/simulated/floor/ascent/tiled,/area/map_template/build/build6)
"vK" = (/turf/simulated/floor/ascent/tiled,/area/map_template/build/build6)
"wk" = (/obj/structure/girder,/turf/template_noop,/area/map_template/build/build6)
"wz" = (/obj/machinery/door/airlock/ascent,/turf/simulated/floor/ascent,/area/map_template/build/build6)
"xK" = (/obj/machinery/constructable_frame/computerframe{dir = 4},/turf/template_noop,/area/map_template/build/build6)
"xS" = (/turf/simulated/wall/ascent,/area/map_template/build/build6)
"ys" = (/obj/effect/decal/cleanable/dirt,/obj/machinery/light/ascent/damaged,/turf/simulated/floor/ascent,/area/map_template/build/build6)
"yM" = (/obj/random/junk,/obj/effect/decal/cleanable/dirt,/turf/simulated/floor/ascent/tiled,/area/map_template/build/build6)
"za" = (/obj/item/reagent_containers/food/drinks/cans/waterbottle/ascent,/obj/structure/table/steel_reinforced/ascent,/obj/effect/decal/cleanable/dirt,/turf/simulated/floor/ascent/airless,/area/map_template/build/build6)
"zc" = (/obj/machinery/light/ascent/damaged,/turf/template_noop,/area/map_template/build/build6)
"zF" = (/obj/structure/table/steel_reinforced/ascent,/obj/random/loot,/obj/effect/decal/cleanable/dirt,/obj/machinery/light/ascent/damaged{dir = 1},/turf/simulated/floor/ascent/tiled,/area/map_template/build/build6)
"Ao" = (/obj/structure/table/steel_reinforced/ascent,/obj/item/stack/medical/resin,/obj/item/material/shard/phoron,/turf/simulated/floor/ascent/tiled,/area/map_template/build/build6)
"AH" = (/obj/machinery/body_scanconsole/ascent{dir = 4},/obj/effect/decal/cleanable/dirt,/turf/simulated/floor/ascent,/area/map_template/build/build6)
"AP" = (/obj/structure/table/steel_reinforced/ascent,/obj/item/device/robotanalyzer,/obj/effect/decal/cleanable/dirt,/obj/item/light/tube/ascent,/turf/simulated/floor/ascent,/area/map_template/build/build6)
"AW" = (/obj/machinery/power/terminal{dir = 4},/obj/structure/cable/cyan{d1 = 2; d2 = 4; icon_state = "2-4"},/obj/structure/cable/cyan{icon_state = "0-8"; name = "power cable (broken)"},/turf/simulated/floor/ascent/tiled,/area/map_template/build/build6)
"Bm" = (/obj/item/stack/nanopaste,/turf/template_noop,/area/map_template/build/build6)
"By" = (/obj/effect/decal/cleanable/dirt,/obj/machinery/light/ascent/damaged{dir = 8},/turf/simulated/floor/ascent,/area/map_template/build/build6)
"Cw" = (/obj/structure/table/rack/ascent,/obj/item/stack/cable_coil/cyan,/obj/effect/decal/cleanable/dirt,/turf/simulated/floor/ascent/tiled,/area/map_template/build/build6)
"Dj" = (/obj/effect/decal/cleanable/dirt,/obj/item/tank/mantid/methyl_bromide,/turf/simulated/floor/ascent/tiled,/area/map_template/build/build6)
"DA" = (/obj/item/material/shard/phoron,/turf/template_noop,/area/template_noop)
"DG" = (/obj/effect/decal/cleanable/dirt,/obj/machinery/light/ascent/damaged{dir = 4},/turf/simulated/floor/ascent/tiled,/area/map_template/build/build6)
"ER" = (/obj/item/material/shard/phoron,/turf/template_noop,/area/map_template/build/build6)
"FQ" = (/obj/structure/table/rack/ascent,/obj/item/stack/cable_coil/cyan,/turf/simulated/floor/ascent/tiled,/area/map_template/build/build6)
"GL" = (/obj/structure/cable/cyan{d1 = 1; d2 = 4; icon_state = "1-4"},/obj/effect/decal/cleanable/dirt,/turf/simulated/floor/ascent/tiled,/area/map_template/build/build6)
"Hy" = (/obj/structure/table/steel_reinforced/ascent,/obj/random/energy,/obj/item/light/tube/ascent,/turf/simulated/floor/ascent/tiled,/area/map_template/build/build6)
"HI" = (/obj/item/material/shard{icon_state = "shrapnellarge"; default_material = "steel"},/turf/template_noop,/area/map_template/build/build6)
"Iy" = (/obj/structure/girder,/turf/simulated/floor/ascent,/area/map_template/build/build6)
"Ja" = (/obj/machinery/alarm/ascent{pixel_y = 24},/turf/simulated/floor/ascent,/area/map_template/build/build6)
"Je" = (/obj/item/material/knife/hook,/obj/machinery/light/ascent/damaged,/turf/simulated/floor/ascent/tiled,/area/map_template/build/build6)
"Jl" = (/obj/item/material/shard{icon_state = "shrapnellarge"; default_material = "steel"},/turf/simulated/floor/ascent/airless,/area/map_template/build/build6)
"Kv" = (/obj/structure/table/steel_reinforced/ascent,/turf/simulated/floor/ascent/tiled,/area/map_template/build/build6)
"La" = (/turf/simulated/wall/r_wall/ascent,/area/map_template/build/build6)
"LZ" = (/obj/item/stack/material/rods,/turf/template_noop,/area/map_template/build/build6)
"Mu" = (/obj/effect/decal/cleanable/cobweb,/obj/structure/table/steel_reinforced/ascent,/turf/simulated/floor/ascent/tiled,/area/map_template/build/build6)
"MD" = (/obj/machinery/shipsensors/weak,/turf/simulated/floor/ascent/airless,/area/map_template/build/build6)
"MH" = (/obj/item/stack/material/rods,/turf/simulated/floor/ascent/airless,/area/map_template/build/build6)
"MO" = (/obj/structure/table/rack/ascent,/obj/random/loot,/obj/effect/decal/cleanable/dirt,/turf/simulated/floor/ascent/tiled,/area/map_template/build/build6)
"Nr" = (/obj/structure/cable/cyan{d1 = 1; d2 = 2; icon_state = "1-2"},/obj/effect/decal/cleanable/dirt,/turf/simulated/floor/ascent/tiled,/area/map_template/build/build6)
"OJ" = (/obj/item/stack/material/rods,/turf/template_noop,/area/template_noop)
"OY" = (/obj/structure/table/rack/ascent,/obj/item/stack/cable_coil/cyan,/turf/template_noop,/area/map_template/build/build6)
"Pc" = (/obj/item/stack/material/rods,/obj/effect/decal/cleanable/dirt,/turf/simulated/floor/ascent/airless,/area/map_template/build/build6)
"Pj" = (/turf/simulated/floor/ascent,/area/map_template/build/build6)
"Pv" = (/obj/machinery/power/smes/buildable/preset/ascent,/obj/structure/cable/cyan{d2 = 8; icon_state = "0-8"},/obj/effect/decal/cleanable/cobweb2,/turf/simulated/floor/ascent/tiled,/area/map_template/build/build6)
"Qv" = (/obj/effect/decal/cleanable/dirt,/obj/item/material/shard/phoron,/turf/simulated/floor/ascent,/area/map_template/build/build6)
"QK" = (/obj/item/stack/material/steel,/turf/simulated/floor/ascent/airless,/area/map_template/build/build6)
"Rl" = (/obj/machinery/alarm/ascent{pixel_y = 24},/obj/effect/decal/cleanable/dirt,/obj/machinery/constructable_frame/machine_frame,/turf/simulated/floor/ascent/tiled,/area/map_template/build/build6)
"RA" = (/turf/template_noop,/area/map_template/build/build6)
"RG" = (/obj/item/stack/material/rods,/obj/item/material/shard{icon_state = "shrapnellarge"; default_material = "steel"},/turf/template_noop,/area/template_noop)
"RQ" = (/obj/structure/table/steel_reinforced/ascent,/obj/item/device/multitool/mantid,/obj/effect/decal/cleanable/dirt,/turf/simulated/floor/ascent/tiled,/area/map_template/build/build6)
"Tc" = (/obj/effect/decal/cleanable/dirt,/obj/item/tank/mantid/methyl_bromide,/turf/template_noop,/area/map_template/build/build6)
"Ua" = (/obj/effect/landmark/damager{random_dam_max = 200; random_dam_min = 120},/turf/simulated/wall/ascent,/area/map_template/build/build6)
"UD" = (/obj/structure/table/rack/ascent,/obj/effect/decal/cleanable/dirt,/obj/item/light/alien,/turf/simulated/floor/ascent/tiled,/area/map_template/build/build6)
"UV" = (/obj/item/stack/cable_coil/cyan{amount = 1},/turf/template_noop,/area/map_template/build/build6)
"VH" = (/obj/effect/landmark/damager{random_dam_max = 200; random_dam_min = 120},/turf/simulated/wall/r_wall/ascent,/area/map_template/build/build6)
"VI" = (/obj/structure/table/steel_reinforced/ascent,/obj/item/material/knife/kitchen/cleaver/ascent,/obj/effect/decal/cleanable/dirt,/turf/simulated/floor/ascent/tiled,/area/map_template/build/build6)
"Wo" = (/obj/machinery/recharge_station/ascent,/obj/effect/decal/cleanable/dirt,/turf/simulated/floor/ascent/airless,/area/map_template/build/build6)
"XK" = (/obj/effect/decal/cleanable/dirt,/obj/effect/decal/cleanable/dirt,/turf/template_noop,/area/map_template/build/build6)
"XQ" = (/obj/structure/bed/chair/padded/purple/ascent,/turf/simulated/floor/ascent/tiled,/area/map_template/build/build6)
"Yy" = (/turf/template_noop,/area/template_noop)
"YE" = (/obj/effect/decal/cleanable/dirt,/turf/simulated/floor/ascent/tiled,/area/map_template/build/build6)
"Zl" = (/obj/machinery/portable_atmospherics/canister/methyl_bromide,/obj/machinery/light/ascent/damaged{dir = 8},/turf/simulated/floor/ascent/tiled,/area/map_template/build/build6)
"ZA" = (/obj/effect/decal/cleanable/dirt,/obj/item/stack/cable_coil/cyan{amount = 1},/turf/simulated/floor/ascent,/area/map_template/build/build6)
"ZT" = (/obj/item/robot_parts/robot_component/armour/light,/obj/effect/decal/cleanable/dirt,/turf/simulated/floor/ascent/tiled,/area/map_template/build/build6)

(1,1,1) = {"
YyYyYyYyYyYyLaYyYyYyYyYyYyYyYyYyYyYyYyYy
YyYyYyYyYyVHLaLaYyYyLaYyYyYyYyDAYyYyYyYy
YyYyYyRAtNLaJahwMDVHLaLaYyYyRAYyYyYyYyYy
YyYyPjmSvKIyviLaLaLaPjhwRALaPjLaYyYyYyYy
YyDAjgjgXQjgYExSKvzFYELaVHERRAIyYyYyYyYy
YylKmSxKjgYEvKwzvKYEDGxSAHbJRAjggoYyYyYy
jORAtNvKysHyxSxSDjyMvKxSByvKPjqPRAYyDAYy
YyRAhRLaxSxSxSmShRRACwxSfWjgRAoVQvYyYyYy
YyYyhRLaRARlRAhRmSYEUDxStCYERAAoIyYyYyYy
YyYyRARAhRbnmSXKjOWoxSUaYEjgYEZAjgYyYyYy
YyLaRAfZzcmSvKUVcixSsLMuYERARAMOLaYyYyYy
YyYyLahwLaxSwzxSxSUaahhbYEUawzxSVHVHRGYy
YypxOJlKRAhuYEnogMflYEYExSxSYEwzPjwzYypx
YyDAYyVHQKJlvKPjYEBmYExSxSeRZTxSxSLahwQK
YyYyjORAtHMHTcXQjLXQmSxSFQNrrAAWPvxSZlPc
YyYyYyLaPjVHJezaAPVIboxSpRGLnveMxSxSRAmc
YyYyYyDAYyLaLatStShwLaLaRQjkNrxSxSoEmSrB
YyYyYyYyOJpxYyYyYyYyYyLahwLahXxSroiXegRA
YyYyYyYyYyYyYyYypxYyYyYyYyhwGLvzryeWOYwk
YyYyYyYyYyYyYyYyYyYyYyOJYyVHLaERQKLZHILZ
"}
