"aa" = (/obj/random/junk,/obj/effect/decal/cleanable/dirt,/turf/simulated/floor/plating,/area/template_noop)
"ab" = (/obj/machinery/computer/modular/preset/cardslot/command{dir = 4; icon_state = "console"},/turf/simulated/floor/tiled/techfloor,/area/map_template/build/build8)
"ac" = (/obj/structure/cable{d1 = 4; d2 = 8; icon_state = "4-8"},/obj/structure/missile/he{active = 1; desc = "A relatively primitive high explosive missile. Mass manufactured and highly destructive, this one is very damaged and rusted. Primer indicator seems to be red."; health = 1; primed = 0},/obj/effect/decal/cleanable/dirt,/turf/simulated/floor/plating,/area/template_noop)
"aU" = (/obj/random/junk,/turf/simulated/floor/tiled/techfloor/grid,/area/map_template/build/build8)
"bk" = (/obj/random/cash,/obj/effect/decal/cleanable/dirt,/turf/simulated/floor/tiled/techfloor,/area/map_template/build/build8)
"bU" = (/turf/simulated/wall/prepainted,/area/map_template/build/build8)
"cf" = (/obj/machinery/shipsensors/weak,/turf/simulated/floor/reinforced,/area/map_template/build/build8)
"dd" = (/obj/effect/landmark/damager,/turf/simulated/wall/r_wall/hull,/area/template_noop)
"dv" = (/obj/random/trash,/obj/effect/decal/cleanable/dirt,/turf/simulated/floor/plating,/area/template_noop)
"ei" = (/obj/structure/cable{d1 = 4; d2 = 8; icon_state = "4-8"},/obj/effect/decal/cleanable/dirt,/turf/simulated/floor/tiled,/area/template_noop)
"ep" = (/obj/effect/landmark/clear,/obj/effect/decal/cleanable/dirt,/turf/template_noop,/area/template_noop)
"eV" = (/obj/structure/mopbucket,/obj/effect/decal/cleanable/dirt,/turf/simulated/floor/plating,/area/map_template/build/build8)
"fa" = (/turf/template_noop,/area/template_noop)
"fz" = (/obj/effect/decal/cleanable/dirt,/obj/random/junk,/turf/simulated/floor/tiled/techfloor,/area/map_template/build/build8)
"gs" = (/obj/effect/decal/cleanable/dirt,/turf/simulated/floor/tiled/techfloor/grid,/area/map_template/build/build8)
"gH" = (/obj/machinery/hologram/holopad/longrange,/obj/effect/decal/cleanable/dirt,/turf/simulated/floor/tiled/techfloor/grid,/area/map_template/build/build8)
"hs" = (/obj/structure/cable{d1 = 4; d2 = 8; icon_state = "4-8"},/obj/structure/railing/mapped{dir = 1; icon_state = "railing0-1"},/obj/structure/catwalk,/obj/machinery/light/small,/obj/effect/decal/cleanable/dirt,/turf/simulated/floor/plating,/area/map_template/build/build8)
"iy" = (/obj/structure/bed/chair{dir = 8},/obj/effect/decal/cleanable/dirt,/turf/simulated/floor/tiled/techfloor,/area/map_template/build/build8)
"ji" = (/obj/random/trash,/obj/effect/decal/cleanable/dirt,/turf/simulated/floor/tiled,/area/template_noop)
"jS" = (/obj/structure/railing/mapped{dir = 8; icon_state = "railing0-1"},/turf/simulated/floor/plating,/area/map_template/build/build8)
"ky" = (/obj/structure/cable{d1 = 4; d2 = 8; icon_state = "4-8"},/obj/effect/decal/cleanable/dirt,/turf/simulated/floor/plating,/area/template_noop)
"kD" = (/turf/simulated/floor/tiled/dark,/area/template_noop)
"kO" = (/obj/structure/railing/mapped,/obj/structure/table/rack,/obj/item/stack/cable_coil/random,/obj/item/stack/cable_coil/random,/turf/simulated/floor/plating,/area/map_template/build/build8)
"lt" = (/obj/machinery/light,/obj/machinery/papershredder,/turf/simulated/floor/tiled/techfloor,/area/map_template/build/build8)
"lG" = (/obj/effect/landmark/damager,/turf/simulated/wall/prepainted,/area/template_noop)
"lN" = (/obj/effect/decal/cleanable/dirt,/turf/simulated/floor/tiled,/area/template_noop)
"mv" = (/obj/random/trash,/obj/effect/decal/cleanable/dirt,/turf/simulated/floor/tiled/techfloor,/area/map_template/build/build8)
"mY" = (/obj/structure/railing/mapped{dir = 4; icon_state = "railing0-1"},/obj/structure/railing/mapped,/obj/effect/decal/cleanable/dirt,/turf/simulated/floor/plating,/area/map_template/build/build8)
"og" = (/obj/structure/cable{d1 = 1; d2 = 4; icon_state = "1-4"},/obj/structure/cable{d1 = 2; d2 = 8; icon_state = "1-8"},/obj/structure/inflatable/door,/turf/simulated/floor/plating,/area/template_noop)
"oC" = (/obj/structure/railing/mapped,/obj/effect/decal/cleanable/dirt,/turf/simulated/floor/plating,/area/map_template/build/build8)
"pf" = (/obj/structure/table/rack,/obj/item/tank/hydrogen,/turf/simulated/floor/plating,/area/map_template/build/build8)
"po" = (/obj/effect/decal/cleanable/dirt,/turf/simulated/floor/plating,/area/template_noop)
"pt" = (/obj/effect/landmark/carnage_mark,/turf/simulated/floor/tiled/techfloor,/area/map_template/build/build8)
"pw" = (/obj/structure/cable{d1 = 4; d2 = 8; icon_state = "4-8"},/obj/effect/decal/cleanable/dirt,/turf/simulated/floor/tiled/techfloor,/area/map_template/build/build8)
"pR" = (/obj/item/paper,/obj/structure/table/standard,/obj/item/paper,/obj/item/paper,/obj/item/paper,/obj/item/paper,/turf/simulated/floor/tiled/techfloor,/area/map_template/build/build8)
"qu" = (/obj/structure/bed/chair/comfy/black,/obj/effect/decal/cleanable/dirt,/turf/simulated/floor/tiled/techfloor,/area/map_template/build/build8)
"qQ" = (/obj/machinery/light/small,/turf/simulated/floor/tiled/techfloor,/area/map_template/build/build8)
"sk" = (/obj/random/loot,/obj/effect/decal/cleanable/dirt,/turf/simulated/floor/plating,/area/template_noop)
"tf" = (/obj/machinery/power/apc{locked = 0; name = "south bump"; pixel_y = -28; req_access = null},/obj/structure/cable{d2 = 4; icon_state = "0-4"},/obj/effect/decal/cleanable/dirt,/turf/simulated/floor/tiled/techfloor,/area/map_template/build/build8)
"tC" = (/obj/machinery/door/airlock/engineering{name = "Communication Module Maintenance"},/obj/structure/cable{d1 = 4; d2 = 8; icon_state = "4-8"},/turf/simulated/floor/tiled/steel_ridged,/area/map_template/build/build8)
"tJ" = (/obj/item/paper,/obj/effect/decal/cleanable/dirt,/turf/simulated/floor/tiled/techfloor,/area/map_template/build/build8)
"uW" = (/obj/structure/railing/mapped{dir = 8; icon_state = "railing0-1"},/obj/structure/noticeboard{pixel_y = 32},/turf/simulated/floor/plating,/area/map_template/build/build8)
"wI" = (/obj/structure/bed/chair,/obj/machinery/light/small{dir = 8; icon_state = "bulb1"},/obj/effect/decal/cleanable/dirt,/turf/simulated/floor/tiled/techfloor,/area/map_template/build/build8)
"xk" = (/obj/random/technology_scanner,/turf/simulated/floor/plating,/area/template_noop)
"xy" = (/obj/machinery/light{dir = 1; icon_state = "tube1"},/obj/effect/decal/cleanable/dirt,/turf/simulated/floor/plating,/area/template_noop)
"xz" = (/obj/structure/table/standard,/obj/item/paper_bin{amount = 5},/obj/effect/decal/cleanable/dirt,/turf/simulated/floor/tiled/techfloor,/area/map_template/build/build8)
"yv" = (/obj/effect/decal/cleanable/dirt,/turf/simulated/floor/plating,/area/map_template/build/build8)
"zd" = (/obj/structure/table/rack,/obj/item/stack/material/phoron/ten,/turf/simulated/floor/plating,/area/map_template/build/build8)
"zY" = (/obj/random/obstruction,/turf/simulated/floor/plating,/area/template_noop)
"Ay" = (/turf/simulated/floor/tiled,/area/template_noop)
"AJ" = (/turf/simulated/wall/r_wall/hull,/area/map_template/build/build8)
"BJ" = (/obj/item/paper,/obj/effect/decal/cleanable/dirt,/turf/simulated/floor/tiled/techfloor/grid,/area/map_template/build/build8)
"Cd" = (/obj/structure/railing/mapped{dir = 4; icon_state = "railing0-1"},/turf/simulated/floor/plating,/area/map_template/build/build8)
"CJ" = (/obj/structure/cable{d1 = 4; d2 = 8; icon_state = "4-8"},/obj/structure/catwalk,/obj/machinery/light{dir = 1; icon_state = "tube1"},/turf/simulated/floor/plating,/area/template_noop)
"Ec" = (/obj/structure/table/standard,/obj/random/mre/main,/turf/simulated/floor/tiled/techfloor,/area/map_template/build/build8)
"Eo" = (/obj/structure/cable{d1 = 4; d2 = 8; icon_state = "4-8"},/obj/structure/catwalk,/turf/simulated/floor/plating,/area/map_template/build/build8)
"Ex" = (/obj/structure/cable{d1 = 1; d2 = 2; icon_state = "1-2"},/obj/structure/railing/mapped{dir = 8; icon_state = "railing0-1"},/obj/structure/catwalk,/obj/effect/decal/cleanable/dirt,/turf/simulated/floor/plating,/area/map_template/build/build8)
"EQ" = (/obj/structure/cable{d1 = 4; d2 = 8; icon_state = "4-8"},/turf/simulated/floor/tiled,/area/template_noop)
"Fl" = (/obj/structure/table/standard,/obj/machinery/photocopier/faxmachine,/obj/effect/decal/cleanable/dirt,/turf/simulated/floor/tiled/techfloor,/area/map_template/build/build8)
"FU" = (/obj/structure/table/rack,/obj/machinery/light{dir = 1; icon_state = "tube1"},/obj/random/assembly,/obj/effect/decal/cleanable/dirt,/turf/simulated/floor/plating,/area/map_template/build/build8)
"Gl" = (/turf/simulated/wall/r_wall/hull,/area/template_noop)
"GX" = (/obj/effect/decal/cleanable/dirt,/turf/template_noop,/area/template_noop)
"HE" = (/obj/structure/railing/mapped,/obj/random/advdevice,/obj/effect/decal/cleanable/dirt,/turf/simulated/floor/plating,/area/map_template/build/build8)
"IL" = (/obj/random/tool,/obj/effect/decal/cleanable/dirt,/turf/simulated/floor/plating,/area/template_noop)
"Jf" = (/obj/structure/table/standard,/obj/item/stack/cable_coil/random,/turf/simulated/floor/tiled/techfloor,/area/map_template/build/build8)
"Jn" = (/obj/structure/cable{d1 = 4; d2 = 8; icon_state = "4-8"},/obj/structure/catwalk,/obj/effect/decal/cleanable/dirt,/turf/simulated/floor/plating,/area/template_noop)
"JL" = (/obj/machinery/photocopier,/turf/simulated/floor/tiled/techfloor,/area/map_template/build/build8)
"Ko" = (/obj/effect/decal/cleanable/dirt,/turf/simulated/floor/tiled/dark/monotile,/area/template_noop)
"Kw" = (/obj/machinery/computer/modular/preset/filemanager{dir = 4},/obj/effect/decal/cleanable/dirt,/turf/simulated/floor/tiled/techfloor,/area/map_template/build/build8)
"KI" = (/obj/structure/railing/mapped{dir = 4; icon_state = "railing0-1"},/obj/machinery/light{dir = 1; icon_state = "tube1"},/turf/simulated/floor/plating,/area/map_template/build/build8)
"Ll" = (/obj/structure/table/standard,/obj/random/clipboard,/turf/simulated/floor/tiled/techfloor,/area/map_template/build/build8)
"LB" = (/obj/structure/closet/toolcloset,/obj/item/stack/cable_coil/random,/turf/simulated/floor/plating,/area/map_template/build/build8)
"LT" = (/obj/structure/cable{d1 = 2; d2 = 8; desc = "A flexible superconducting cable for heavy-duty power transfer. It's been labeled 'ChemistryOneLove'."; icon_state = "2-8"},/obj/effect/decal/cleanable/dirt,/turf/simulated/floor/tiled/techfloor,/area/map_template/build/build8)
"Mi" = (/obj/structure/closet/emcloset,/obj/effect/floor_decal/industrial/outline/yellow,/obj/item/tank/oxygen,/turf/simulated/floor/tiled/techfloor,/area/map_template/build/build8)
"Ms" = (/obj/machinery/light,/obj/effect/decal/cleanable/dirt,/turf/simulated/floor/plating,/area/template_noop)
"Mx" = (/obj/structure/cable{d1 = 4; d2 = 8; icon_state = "4-8"},/turf/simulated/floor/plating,/area/template_noop)
"MT" = (/turf/simulated/wall/prepainted,/area/template_noop)
"NG" = (/obj/structure/cable{d1 = 4; d2 = 8; icon_state = "4-8"},/obj/structure/catwalk,/turf/simulated/floor/plating,/area/template_noop)
"NL" = (/turf/simulated/floor/tiled/techfloor,/area/map_template/build/build8)
"NO" = (/obj/structure/catwalk,/obj/effect/decal/cleanable/dirt,/turf/template_noop,/area/template_noop)
"Of" = (/obj/machinery/light{dir = 8},/obj/effect/decal/cleanable/dirt,/turf/simulated/floor/plating,/area/template_noop)
"Ok" = (/obj/structure/cable{d1 = 2; d2 = 8; icon_state = "1-8"},/obj/structure/catwalk,/obj/effect/decal/cleanable/dirt,/turf/simulated/floor/plating,/area/map_template/build/build8)
"Ox" = (/turf/simulated/floor/reinforced,/area/map_template/build/build8)
"OP" = (/obj/machinery/computer/modular/preset/civilian{dir = 4},/obj/machinery/light{dir = 8},/turf/simulated/floor/tiled/techfloor,/area/map_template/build/build8)
"Pc" = (/obj/structure/railing/mapped{dir = 8; icon_state = "railing0-1"},/obj/structure/railing/mapped,/obj/random/smokes,/obj/effect/decal/cleanable/dirt,/turf/simulated/floor/plating,/area/map_template/build/build8)
"Ps" = (/obj/effect/landmark/clear,/turf/template_noop,/area/template_noop)
"Qq" = (/obj/machinery/light{dir = 1; icon_state = "tube1"},/obj/effect/decal/cleanable/dirt,/turf/simulated/floor/tiled/dark,/area/template_noop)
"QO" = (/obj/effect/landmark/damager,/turf/simulated/wall/r_wall/hull,/area/map_template/build/build8)
"Rb" = (/obj/machinery/door/airlock/command{name = "Long-distance Communication Module"},/obj/structure/cable{d1 = 1; d2 = 2; icon_state = "1-2"},/turf/simulated/floor/tiled/steel_ridged,/area/map_template/build/build8)
"RR" = (/turf/simulated/floor/plating,/area/template_noop)
"Sj" = (/obj/effect/wallframe_spawn/no_grille,/turf/simulated/floor/plating,/area/map_template/build/build8)
"SL" = (/obj/effect/wallframe_spawn/reinforced/hull,/turf/simulated/floor/plating,/area/map_template/build/build8)
"TD" = (/obj/structure/table/rack,/obj/random/medical/lite,/turf/simulated/floor/plating,/area/map_template/build/build8)
"TP" = (/obj/effect/decal/cleanable/dirt,/turf/simulated/floor/tiled/techfloor,/area/map_template/build/build8)
"TS" = (/obj/effect/decal/cleanable/dirt,/turf/simulated/floor/tiled/dark,/area/template_noop)
"Ul" = (/obj/structure/bed/chair/comfy/black{dir = 8},/obj/effect/decal/cleanable/dirt,/turf/simulated/floor/tiled/techfloor,/area/map_template/build/build8)
"Uy" = (/obj/structure/cable{d1 = 1; d2 = 4; icon_state = "1-4"},/obj/structure/cable{d1 = 2; d2 = 4; icon_state = "2-4"},/obj/effect/decal/cleanable/dirt,/turf/simulated/floor/tiled/techfloor,/area/map_template/build/build8)
"UI" = (/turf/simulated/floor/tiled/dark/monotile,/area/template_noop)
"UK" = (/obj/structure/cable{d1 = 4; d2 = 8; icon_state = "4-8"},/obj/machinery/light{dir = 1; icon_state = "tube1"},/obj/effect/decal/cleanable/dirt,/turf/simulated/floor/tiled,/area/template_noop)
"Vb" = (/obj/structure/catwalk,/turf/simulated/floor/plating,/area/template_noop)
"VB" = (/obj/random/tool,/obj/effect/decal/cleanable/dirt,/turf/simulated/floor/tiled/techfloor,/area/map_template/build/build8)
"Wd" = (/obj/structure/cable{d1 = 2; d2 = 4; icon_state = "2-4"},/obj/effect/decal/cleanable/dirt,/turf/simulated/floor/plating,/area/template_noop)
"WB" = (/obj/structure/catwalk,/turf/template_noop,/area/template_noop)
"WV" = (/obj/structure/cable{d1 = 4; d2 = 8; icon_state = "4-8"},/turf/simulated/floor/tiled/techfloor,/area/map_template/build/build8)
"XF" = (/obj/structure/table/standard,/obj/machinery/cell_charger,/obj/random/powercell,/turf/simulated/floor/tiled/techfloor,/area/map_template/build/build8)
"XP" = (/obj/effect/landmark/damager,/turf/simulated/wall/prepainted,/area/map_template/build/build8)
"Zg" = (/obj/structure/cable{d1 = 1; d2 = 2; icon_state = "1-2"},/obj/structure/inflatable/door,/obj/effect/decal/cleanable/dirt,/turf/simulated/floor/tiled/techfloor,/area/map_template/build/build8)
"Zh" = (/obj/structure/cable{icon_state = "0-2"},/obj/machinery/power/port_gen/pacman,/obj/structure/railing/mapped{dir = 8; icon_state = "railing0-1"},/turf/simulated/floor/plating,/area/map_template/build/build8)
"Zt" = (/obj/structure/closet/hydrant{pixel_y = 32},/turf/simulated/floor/tiled/techfloor,/area/map_template/build/build8)
"Zy" = (/obj/structure/cable{d1 = 2; d2 = 8; icon_state = "1-8"},/obj/effect/decal/cleanable/dirt,/turf/simulated/floor/tiled,/area/template_noop)

(1,1,1) = {"
fafafafafafafafafafafafafafafafafafafafafafafafafa
fafafafafafafafafafafafafafafafafafafafafafafafafa
QOQOQOQOAJQOAJOxQOfafafafafafafafafafafafafafafafa
fafafaAJQOAJAJOxAJAJSLSLSLAJQOfafafafafafafafafafa
fafafafafaQOAJcfSLKIaUgsgsuWAJAJAJQOAJQOQOfafafafa
fafafafafafaAJAJAJCdgsgHgsjSTDFUyvbUJfXFAJQOAJfafa
fafafafafafafaAJkOmYgsBJgsPcoCHEoCbUwITPZhLBAJdddd
fafafafafafafaSLTPbkNLmvfztfWVLTMibUEciyExeVbURRfa
fafafafafafafaSLKwtJptTPpRbUbURbbUbUTPVBExpfbUpoGX
fafafafafafafaQOOPUltJquLlSjZtUypwtCEohsOkzdbUfadv
fafaGlddddGlddAJabxzFlJLltSjTPZgqQbUbUbUbUbUXPGXfa
fafaepxypolNRRbUbUbUbUbUbUbUbURbbUbUPslNepWdPspofa
GXaceiMxJnNOWBNGJnkyUKeiJnJnJnogWBCJNOJnEQZyMTlGfa
lGMTepeplNpolNpoepPsRRpoaaeppoRRRRlNpoPslNskRRMTIL
zYdvpoMTlGMTGXlGMTPsepMTPsMTlGMTepepzYVblNAyGXlGpo
RRpoGXlGAypoGXAylNlNlGMTTSGXTSQqRRTSpoGXGXMsAyfafa
faRRRRMTAypoAyjilNxkfaMTOfUIKoKokDILfaMTlGMTlGfafa
fafafafaRRRRfalNlNfafalGfaRRTSGXpoTSMTMTfafafafafa
"}
