"a" = (/obj/effect/landmark/exoplanet_spawn/plant,/turf/template_noop,/area/template_noop)
"b" = (/obj/effect/landmark/exoplanet_spawn/plant,/obj/effect/decal/cleanable/dirt,/obj/effect/decal/cleanable/dirt,/obj/effect/decal/cleanable/dirt,/turf/template_noop,/area/template_noop)
"e" = (/obj/effect/landmark/exoplanet_spawn/plant,/obj/effect/decal/cleanable/dirt,/turf/template_noop,/area/template_noop)
"f" = (/obj/effect/landmark/scorcher,/obj/effect/decal/cleanable/dirt,/obj/effect/decal/cleanable/dirt,/turf/unsimulated/floor/exoplanet/concrete/reinforced/road,/area/template_noop)
"j" = (/obj/effect/landmark/scorcher,/turf/unsimulated/floor/exoplanet/concrete/reinforced/road,/area/template_noop)
"k" = (/obj/effect/landmark/exoplanet_spawn/plant,/obj/effect/decal/cleanable/dirt,/obj/effect/decal/cleanable/dirt,/turf/template_noop,/area/template_noop)
"l" = (/obj/effect/decal/cleanable/dirt,/obj/random/loot{spawn_nothing_percentage = 90},/turf/unsimulated/floor/exoplanet/concrete/reinforced/road,/area/template_noop)
"m" = (/obj/effect/landmark/scorcher,/obj/item/stack/material/rods,/obj/effect/decal/cleanable/dirt,/obj/effect/decal/cleanable/dirt,/turf/unsimulated/floor/exoplanet/concrete/reinforced/road,/area/template_noop)
"n" = (/obj/item/stack/material/rods,/turf/template_noop,/area/template_noop)
"o" = (/obj/effect/decal/cleanable/dirt,/turf/unsimulated/floor/exoplanet/concrete,/area/template_noop)
"p" = (/obj/effect/decal/cleanable/dirt,/obj/effect/decal/cleanable/dirt,/turf/unsimulated/floor/exoplanet/concrete/reinforced/road,/area/template_noop)
"q" = (/obj/effect/landmark/scorcher,/obj/effect/decal/cleanable/dirt,/turf/unsimulated/floor/exoplanet/concrete/reinforced/road,/area/template_noop)
"t" = (/obj/effect/landmark/scorcher,/obj/effect/decal/cleanable/dirt,/obj/effect/decal/cleanable/dirt,/turf/unsimulated/floor/exoplanet/concrete,/area/template_noop)
"w" = (/turf/template_noop,/area/template_noop)
"x" = (/turf/unsimulated/floor/exoplanet/concrete,/area/template_noop)
"B" = (/turf/unsimulated/floor/exoplanet/concrete/reinforced/road,/area/template_noop)
"D" = (/obj/effect/decal/cleanable/dirt,/obj/effect/decal/cleanable/dirt,/turf/unsimulated/floor/exoplanet/concrete,/area/template_noop)
"I" = (/obj/effect/decal/cleanable/dirt,/turf/template_noop,/area/template_noop)
"J" = (/obj/effect/landmark/clear,/obj/effect/decal/cleanable/dirt,/turf/template_noop,/area/template_noop)
"K" = (/obj/effect/landmark/scorcher,/obj/effect/decal/cleanable/dirt,/turf/unsimulated/floor/exoplanet/concrete,/area/template_noop)
"M" = (/obj/effect/decal/cleanable/dirt,/turf/unsimulated/floor/exoplanet/concrete/reinforced/road,/area/template_noop)
"N" = (/obj/effect/landmark/clear,/turf/template_noop,/area/template_noop)
"R" = (/obj/effect/landmark/clear,/obj/effect/decal/cleanable/dirt,/obj/effect/decal/cleanable/dirt,/turf/template_noop,/area/template_noop)
"T" = (/obj/effect/landmark/scorcher,/turf/unsimulated/floor/exoplanet/concrete,/area/template_noop)
"U" = (/obj/item/stack/material/rods,/obj/effect/decal/cleanable/dirt,/turf/template_noop,/area/template_noop)

(1,1,1) = {"
wNaeJoTxnJxxTToRRxooNxTTKwUJRKKIUNI
NeJpqmBkpIJMNjjqqMpMpakqJMfqMNpMqJJ
JkqMBJMkMMRpMJpBMMlBqfBNepJMqeMbMMN
NqBNMeMlMNpakeMBBqBBpjBpkeaJjplkJqN
NNBMnepJRpBjqaNaMBMjMMUqpJJpBMqfpfj
naexTIJDKwNNotIotJKtNNnTTNJNKnJDKKI
"}
