"a" = (/obj/effect/paint/sun,/turf/simulated/wall/r_wall,/area/template_noop)
"d" = (/obj/effect/floor_decal/techfloor/orange{dir = 4},/obj/effect/floor_decal/techfloor/orange{dir = 8},/turf/simulated/floor/tiled/techfloor/grid,/area/template_noop)
"e" = (/obj/effect/floor_decal/techfloor/orange{dir = 4},/obj/effect/floor_decal/techfloor/orange{dir = 8},/obj/structure/closet/crate/solar_assembly,/turf/simulated/floor/tiled/techfloor/grid,/area/template_noop)
"f" = (/obj/effect/floor_decal/techfloor/orange/corner{dir = 4},/obj/effect/floor_decal/techfloor/orange/corner{dir = 1},/obj/effect/floor_decal/techfloor/orange/corner,/obj/effect/floor_decal/techfloor/orange/corner{dir = 8},/turf/simulated/floor/tiled/techfloor/grid,/area/template_noop)
"g" = (/obj/effect/paint/sun,/obj/effect/decal/cleanable/dirt,/obj/effect/decal/cleanable/dirt,/turf/simulated/wall/r_wall,/area/template_noop)
"h" = (/obj/structure/catwalk,/obj/machinery/light/small/emergency,/obj/effect/decal/cleanable/dirt,/obj/effect/decal/cleanable/dirt,/obj/effect/decal/cleanable/dirt,/turf/simulated/floor/plating,/area/template_noop)
"i" = (/obj/effect/floor_decal/techfloor/orange,/obj/effect/floor_decal/techfloor/orange{dir = 1},/obj/structure/closet/crate/radiation_gear,/obj/effect/decal/cleanable/dirt,/turf/simulated/floor/tiled/techfloor/grid,/area/template_noop)
"k" = (/obj/effect/floor_decal/industrial/warning{dir = 4},/obj/machinery/door/airlock/hatch,/turf/simulated/floor/tiled/techfloor/grid,/area/template_noop)
"m" = (/obj/effect/paint/sun,/obj/effect/decal/cleanable/dirt,/obj/effect/decal/cleanable/dirt,/obj/effect/decal/cleanable/dirt,/turf/simulated/wall/r_wall,/area/template_noop)
"s" = (/obj/effect/floor_decal/techfloor/orange,/obj/effect/floor_decal/techfloor/orange{dir = 1},/turf/simulated/floor/tiled/techfloor/grid,/area/template_noop)
"t" = (/obj/structure/catwalk,/obj/machinery/light/small/emergency{dir = 1},/turf/simulated/floor/plating,/area/template_noop)
"u" = (/obj/structure/catwalk,/obj/machinery/light/small/emergency,/obj/effect/decal/cleanable/dirt,/turf/simulated/floor/plating,/area/template_noop)
"x" = (/obj/effect/floor_decal/techfloor/orange/corner{dir = 4},/obj/effect/floor_decal/techfloor/orange/corner,/obj/structure/closet/crate,/turf/simulated/floor/tiled/techfloor/grid,/area/template_noop)
"y" = (/obj/effect/floor_decal/techfloor/orange,/obj/effect/floor_decal/techfloor/orange{dir = 1},/obj/effect/decal/cleanable/dirt,/obj/random/trash,/turf/simulated/floor/tiled/techfloor/grid,/area/template_noop)
"A" = (/obj/effect/floor_decal/techfloor/orange{dir = 8},/obj/structure/closet/crate/secure/large,/obj/random/junkyard/ammo,/obj/random/junkyard/ammo,/obj/random/junkyard/ammo,/obj/random/junkyard/ammo,/obj/random/junkyard/ammo,/obj/random/junkyard/ammo,/obj/random/junkyard/ammo,/obj/random/junkyard/ammo,/obj/random/junkyard/ammo,/obj/random/junkyard/ammo,/obj/random/junkyard/ammo,/obj/random/junkyard/ammo,/obj/random/junkyard/ammo,/turf/simulated/floor/tiled/techfloor/grid,/area/template_noop)
"B" = (/obj/effect/floor_decal/industrial/warning{dir = 8},/obj/machinery/door/airlock/hatch,/obj/effect/decal/cleanable/dirt,/turf/simulated/floor/tiled/techfloor/grid,/area/template_noop)
"C" = (/obj/effect/floor_decal/industrial/outline/yellow,/obj/effect/decal/cleanable/dirt,/turf/simulated/floor/tiled/steel_ridged,/area/template_noop)
"I" = (/obj/structure/catwalk,/obj/structure/closet/crate/medical,/obj/random/junkyard/medical,/obj/random/junkyard/medical,/obj/random/junkyard/medical,/obj/random/junkyard/medical,/obj/random/junkyard/medical,/obj/random/junkyard/medical,/turf/simulated/floor/plating,/area/template_noop)
"J" = (/obj/structure/catwalk,/obj/structure/closet/crate/secure/gear,/obj/random/junkyard/biggun,/obj/random/junkyard/biggun,/obj/random/junkyard/biggun,/obj/random/junkyard/biggun,/turf/simulated/floor/plating,/area/template_noop)
"K" = (/obj/structure/catwalk,/obj/machinery/light/small/emergency{dir = 1},/obj/structure/closet/crate/large,/obj/random/junkyard/loot,/obj/random/junkyard/loot,/obj/random/junkyard/loot,/obj/effect/decal/cleanable/dirt,/obj/random/trash,/turf/simulated/floor/plating,/area/template_noop)
"L" = (/obj/effect/floor_decal/techfloor/orange{dir = 4},/turf/simulated/floor/tiled/techfloor/grid,/area/template_noop)
"N" = (/obj/effect/floor_decal/techfloor/orange,/obj/effect/floor_decal/techfloor/orange{dir = 1},/obj/effect/decal/cleanable/dirt,/turf/simulated/floor/tiled/techfloor/grid,/area/template_noop)
"R" = (/obj/structure/catwalk,/turf/simulated/floor/plating,/area/template_noop)
"S" = (/obj/effect/floor_decal/techfloor/orange{dir = 4},/obj/effect/floor_decal/techfloor/orange{dir = 8},/obj/effect/decal/cleanable/dirt,/turf/simulated/floor/tiled/techfloor/grid,/area/template_noop)
"T" = (/obj/effect/floor_decal/techfloor/orange{dir = 8},/obj/random/trash,/obj/random/trash,/turf/simulated/floor/tiled/techfloor/grid,/area/template_noop)
"U" = (/obj/effect/floor_decal/industrial/outline/yellow,/turf/simulated/floor/tiled/steel_ridged,/area/template_noop)
"W" = (/obj/effect/paint/sun,/obj/effect/decal/cleanable/dirt,/turf/simulated/wall/r_wall,/area/template_noop)
"X" = (/obj/effect/floor_decal/techfloor/orange{dir = 4},/obj/effect/decal/cleanable/dirt,/turf/simulated/floor/tiled/techfloor/grid,/area/template_noop)
"Y" = (/obj/effect/floor_decal/techfloor/orange/corner{dir = 1},/obj/effect/floor_decal/techfloor/orange/corner{dir = 8},/turf/simulated/floor/tiled/techfloor/grid,/area/template_noop)

(1,1,1) = {"
aWaaaaaagWW
aLKRdCdRtAa
BxsNfifyNYk
aXuJSUeIhTa
aaaaaWmWaWa
"}
