"a" = (/turf/unsimulated/floor/exoplanet/barren,/area/template_noop)
"b" = (/obj/effect/floor_decal/borderfloor,/obj/structure/closet/crate/secure/large,/obj/effect/decal/cleanable/dirt,/obj/effect/decal/cleanable/dirt,/turf/simulated/floor/tiled/techfloor/grid,/area/template_noop)
"f" = (/obj/effect/floor_decal/industrial/warning{dir = 8},/obj/structure/door_assembly/door_assembly_hatch,/obj/effect/decal/cleanable/dirt,/turf/simulated/floor/tiled/techfloor/grid,/area/template_noop)
"g" = (/obj/machinery/light/small/emergency{dir = 1},/obj/effect/floor_decal/borderfloor,/obj/random/junkyard/bomb_supply,/turf/simulated/floor/tiled/techfloor/grid,/area/template_noop)
"h" = (/obj/random/trash,/obj/random/trash,/turf/unsimulated/floor/exoplanet/barren,/area/template_noop)
"i" = (/obj/item/storage/cargo_containers{icon_state = "arious_lm"},/turf/simulated/floor/plating,/area/template_noop)
"k" = (/obj/effect/floor_decal/borderfloor,/obj/item/storage/cargo_containers{icon_state = "arious_r"},/turf/simulated/floor/tiled/techfloor/grid,/area/template_noop)
"m" = (/obj/structure/closet/crate,/turf/simulated/floor/plating,/area/template_noop)
"o" = (/obj/effect/floor_decal/industrial/warning{dir = 4},/obj/machinery/door/airlock/hatch,/turf/simulated/floor/tiled/techfloor/grid,/area/template_noop)
"s" = (/obj/effect/floor_decal/borderfloor{dir = 8},/turf/simulated/floor/tiled/techfloor/grid,/area/template_noop)
"w" = (/obj/effect/paint/blue,/obj/effect/decal/cleanable/dirt,/turf/simulated/wall/r_wall,/area/template_noop)
"B" = (/obj/random/junkyard/medical/lite,/turf/simulated/floor/plating,/area/template_noop)
"C" = (/turf/simulated/floor/plating,/area/template_noop)
"D" = (/obj/effect/decal/cleanable/dirt,/turf/simulated/floor/plating,/area/template_noop)
"E" = (/obj/effect/paint/blue,/turf/simulated/wall/r_wall,/area/template_noop)
"F" = (/obj/structure/closet/crate/medical,/obj/random/junkyard/medical/lite,/obj/random/junkyard/medical/lite,/obj/effect/decal/cleanable/dirt,/turf/unsimulated/floor/exoplanet/barren,/area/template_noop)
"H" = (/obj/item/storage/cargo_containers{icon_state = "arious_m"},/turf/unsimulated/floor/exoplanet/barren,/area/template_noop)
"J" = (/obj/structure/closet/crate,/obj/random/junkyard/advdevice,/obj/random/junkyard/advdevice,/obj/random/junkyard/powercell,/turf/unsimulated/floor/exoplanet/barren,/area/template_noop)
"O" = (/obj/effect/floor_decal/borderfloor/corner{dir = 1},/turf/simulated/floor/tiled/techfloor/grid,/area/template_noop)
"Q" = (/obj/effect/floor_decal/borderfloor,/turf/simulated/floor/tiled/techfloor/grid,/area/template_noop)
"T" = (/obj/random/trash,/turf/simulated/floor/plating,/area/template_noop)
"V" = (/obj/machinery/light/small/emergency{dir = 1},/obj/effect/floor_decal/borderfloor,/obj/structure/closet/crate/critter,/turf/simulated/floor/tiled/techfloor/grid,/area/template_noop)
"Z" = (/obj/machinery/light/small/emergency,/obj/effect/decal/cleanable/dirt,/turf/simulated/floor/plating,/area/template_noop)

(1,1,1) = {"
wEwwEEEEwEE
EDgbQiHkVTE
fDDaCaDBmso
waCaaaJCZOw
aFhaawwEEEE
"}
