"a" = (/turf/template_noop,/area/template_noop)
"c" = (/obj/effect/floor_decal/corner/black/bordercorner{dir = 1},/turf/simulated/floor/tiled/dark,/area/template_noop)
"d" = (/obj/effect/floor_decal/corner/black/border{dir = 9},/obj/machinery/light/small{dir = 8},/turf/simulated/floor/tiled/dark,/area/template_noop)
"e" = (/obj/effect/floor_decal/corner/black/border{dir = 10},/obj/machinery/light/small,/turf/simulated/floor/tiled/dark,/area/template_noop)
"g" = (/obj/effect/floor_decal/corner/black/border{dir = 9},/obj/machinery/light/small{dir = 1},/turf/simulated/floor/tiled/dark,/area/template_noop)
"h" = (/obj/effect/floor_decal/borderfloor,/obj/effect/floor_decal/corner/black/border,/obj/machinery/light{dir = 8},/turf/simulated/floor/tiled/dark/monotile,/area/template_noop)
"i" = (/obj/structure/window/reinforced{dir = 8},/obj/effect/floor_decal/industrial/hatch/blue,/turf/simulated/floor/tiled/dark/monotile,/area/template_noop)
"j" = (/obj/effect/floor_decal/borderfloor/corner{dir = 4},/obj/effect/floor_decal/corner/black/bordercorner{dir = 4},/turf/simulated/floor/tiled/dark/monotile,/area/template_noop)
"k" = (/obj/effect/floor_decal/corner/black/border{dir = 10},/obj/machinery/light/small{dir = 8},/turf/simulated/floor/tiled/dark,/area/template_noop)
"l" = (/obj/structure/railing/mapped,/obj/structure/railing/mapped{dir = 8; icon_state = "railing0-1"},/turf/unsimulated/floor/bluespace,/area/template_noop)
"m" = (/obj/structure/railing/mapped{dir = 4; icon_state = "railing0-1"},/turf/unsimulated/floor/bluespace,/area/template_noop)
"n" = (/obj/effect/floor_decal/corner/black/bordercorner,/turf/simulated/floor/tiled/dark,/area/template_noop)
"o" = (/turf/unsimulated/floor/bluespace,/area/template_noop)
"p" = (/obj/effect/floor_decal/corner/black/border{dir = 6},/obj/machinery/light/small{dir = 4},/turf/simulated/floor/tiled/dark,/area/template_noop)
"q" = (/obj/effect/floor_decal/borderfloor{dir = 4},/obj/effect/floor_decal/corner/black/border{dir = 4},/obj/machinery/light,/turf/simulated/floor/tiled/dark/monotile,/area/template_noop)
"r" = (/obj/effect/floor_decal/borderfloor/corner,/obj/effect/floor_decal/corner/black/bordercorner,/turf/simulated/floor/tiled/dark/monotile,/area/template_noop)
"s" = (/obj/effect/floor_decal/corner/black/border{dir = 5},/obj/machinery/light/small{dir = 4},/turf/simulated/floor/tiled/dark,/area/template_noop)
"t" = (/obj/effect/floor_decal/borderfloor{dir = 8},/obj/effect/floor_decal/corner/black/border{dir = 8},/obj/machinery/light,/turf/simulated/floor/tiled/dark/monotile,/area/template_noop)
"v" = (/obj/structure/railing/mapped,/turf/unsimulated/floor/bluespace,/area/template_noop)
"w" = (/obj/effect/floor_decal/borderfloor{dir = 8},/obj/effect/floor_decal/corner/black/border{dir = 8},/turf/simulated/floor/tiled/dark/monotile,/area/template_noop)
"x" = (/obj/effect/floor_decal/borderfloor,/obj/effect/floor_decal/corner/black/border,/obj/machinery/light{dir = 4},/turf/simulated/floor/tiled/dark/monotile,/area/template_noop)
"y" = (/obj/effect/floor_decal/borderfloor,/obj/effect/floor_decal/corner/black/border,/turf/simulated/floor/tiled/dark/monotile,/area/template_noop)
"A" = (/obj/structure/window/reinforced,/obj/effect/floor_decal/industrial/hatch/blue,/turf/simulated/floor/tiled/dark/monotile,/area/template_noop)
"B" = (/obj/effect/floor_decal/corner/black/border{dir = 6},/obj/machinery/light/small,/turf/simulated/floor/tiled/dark,/area/template_noop)
"C" = (/obj/structure/table/marble{color = "gray"},/obj/item/card/id/obs/one,/obj/effect/floor_decal/industrial/outline/blue{color = "#50a0d3"},/turf/simulated/floor/tiled/dark,/area/template_noop)
"D" = (/obj/effect/floor_decal/borderfloor{dir = 8},/obj/effect/floor_decal/corner/black/border{dir = 8},/obj/machinery/light{dir = 1},/turf/simulated/floor/tiled/dark/monotile,/area/template_noop)
"F" = (/obj/structure/railing/mapped{dir = 1; icon_state = "railing0-1"},/obj/structure/railing/mapped{dir = 4; icon_state = "railing0-1"},/turf/unsimulated/floor/bluespace,/area/template_noop)
"G" = (/obj/effect/floor_decal/borderfloor/corner{dir = 8},/obj/effect/floor_decal/corner/black/bordercorner{dir = 8},/turf/simulated/floor/tiled/dark/monotile,/area/template_noop)
"H" = (/obj/effect/floor_decal/corner/black/border{dir = 5},/obj/machinery/light/small{dir = 1},/turf/simulated/floor/tiled/dark,/area/template_noop)
"I" = (/obj/effect/floor_decal/borderfloor{dir = 1},/obj/effect/floor_decal/corner/black/border{dir = 1},/obj/machinery/light{dir = 8},/turf/simulated/floor/tiled/dark/monotile,/area/template_noop)
"J" = (/obj/structure/window/reinforced{dir = 1},/obj/effect/floor_decal/industrial/hatch/blue,/turf/simulated/floor/tiled/dark/monotile,/area/template_noop)
"K" = (/obj/effect/floor_decal/borderfloor{dir = 1},/obj/effect/floor_decal/corner/black/border{dir = 1},/turf/simulated/floor/tiled/dark/monotile,/area/template_noop)
"L" = (/obj/effect/floor_decal/borderfloor{dir = 1},/obj/effect/floor_decal/corner/black/border{dir = 1},/obj/machinery/light{dir = 4},/turf/simulated/floor/tiled/dark/monotile,/area/template_noop)
"M" = (/obj/effect/floor_decal/corner/black/bordercorner{dir = 8},/turf/simulated/floor/tiled/dark,/area/template_noop)
"N" = (/obj/structure/railing/mapped{dir = 8; icon_state = "railing0-1"},/turf/unsimulated/floor/bluespace,/area/template_noop)
"P" = (/obj/effect/catwalk_plated/dark,/turf/simulated/floor/plating,/area/template_noop)
"Q" = (/obj/structure/railing/mapped,/obj/structure/railing/mapped{dir = 4; icon_state = "railing0-1"},/turf/unsimulated/floor/bluespace,/area/template_noop)
"R" = (/turf/simulated/wall/r_wall/invincible,/area/template_noop)
"S" = (/obj/structure/railing/mapped{dir = 1; icon_state = "railing0-1"},/obj/structure/railing/mapped{dir = 8; icon_state = "railing0-1"},/turf/unsimulated/floor/bluespace,/area/template_noop)
"T" = (/obj/effect/floor_decal/borderfloor/corner{dir = 1},/obj/effect/floor_decal/corner/black/bordercorner{dir = 1},/turf/simulated/floor/tiled/dark/monotile,/area/template_noop)
"U" = (/obj/effect/floor_decal/corner/black/bordercorner{dir = 4},/turf/simulated/floor/tiled/dark,/area/template_noop)
"V" = (/obj/structure/railing/mapped{dir = 1; icon_state = "railing0-1"},/turf/unsimulated/floor/bluespace,/area/template_noop)
"W" = (/obj/structure/window/reinforced{dir = 4},/obj/effect/floor_decal/industrial/hatch/blue,/turf/simulated/floor/tiled/dark/monotile,/area/template_noop)
"X" = (/obj/effect/floor_decal/borderfloor{dir = 4},/obj/effect/floor_decal/corner/black/border{dir = 4},/obj/machinery/light{dir = 1},/turf/simulated/floor/tiled/dark/monotile,/area/template_noop)
"Z" = (/obj/effect/floor_decal/borderfloor{dir = 4},/obj/effect/floor_decal/corner/black/border{dir = 4},/turf/simulated/floor/tiled/dark/monotile,/area/template_noop)

(1,1,1) = {"
aaaaaaaaaaaaaaa
aooooRDPXRooooa
aoooomwPZNooooa
aooooRwPZRooooa
aoooQgwPZHloooa
aRvRdcwPZUsRvRa
aIKKKKTAjKKKKLa
aPPPPPWCiPPPPPa
ahyyyyGJryyyyxa
aRVRkMwPZnpRVRa
aoooFewPZBSoooa
aooooRwPZRooooa
aoooomwPZNooooa
aooooRtPqRooooa
aaaaaaaaaaaaaaa
"}
