"aD" = (/obj/effect/floor_decal/corner/black/border{dir = 10},/obj/structure/table/standard,/obj/random/junkyard/smokes,/turf/simulated/floor/tiled/dark,/area/template_noop)
"bG" = (/obj/structure/noticeboard{dir = 4; pixel_x = -26},/turf/simulated/floor/tiled/dark,/area/template_noop)
"dN" = (/obj/effect/floor_decal/corner/black/border{dir = 1},/obj/structure/filingcabinet{pixel_x = -5},/obj/structure/filingcabinet{pixel_x = 5},/turf/simulated/floor/tiled/dark,/area/template_noop)
"fC" = (/obj/effect/floor_decal/corner/black/border{dir = 1},/obj/structure/table/standard,/obj/item/paper_bin,/obj/item/pen/multi,/turf/simulated/floor/tiled/dark,/area/template_noop)
"fQ" = (/obj/structure/table/glass,/obj/item/paper_bin,/obj/item/pen/multi,/obj/machinery/light/small,/turf/simulated/floor/tiled/dark/monotile,/area/template_noop)
"fV" = (/obj/structure/bed/chair/padded/black{dir = 8},/turf/simulated/floor/tiled/dark/monotile,/area/template_noop)
"gj" = (/obj/effect/floor_decal/corner/black/border{dir = 8},/obj/structure/table/standard,/obj/item/modular_computer/laptop/preset/custom_loadout/advanced,/turf/simulated/floor/tiled/dark/monotile,/area/template_noop)
"gt" = (/obj/effect/floor_decal/corner/black/border{dir = 10},/turf/simulated/floor/tiled/dark/monotile,/area/template_noop)
"hv" = (/obj/effect/floor_decal/corner/black/border{dir = 1},/obj/structure/extinguisher_cabinet{pixel_y = -29},/turf/simulated/floor/tiled/dark/monotile,/area/template_noop)
"ip" = (/obj/effect/floor_decal/corner/black/border{dir = 4},/obj/effect/floor_decal/corner/black/border{dir = 8},/turf/simulated/floor/tiled/dark,/area/template_noop)
"iA" = (/obj/effect/floor_decal/corner/black/border{dir = 1},/obj/structure/table/standard,/turf/simulated/floor/tiled/dark,/area/template_noop)
"iZ" = (/obj/effect/floor_decal/corner/black/mono,/obj/structure/table/standard,/turf/simulated/floor/tiled/dark/monotile,/area/template_noop)
"jK" = (/obj/effect/floor_decal/corner/black/border{dir = 4},/obj/structure/bed/chair/office/dark{dir = 4},/turf/simulated/floor/tiled/dark,/area/template_noop)
"jZ" = (/obj/effect/floor_decal/corner/black/border{dir = 5},/obj/structure/filingcabinet/chestdrawer,/obj/machinery/light,/turf/simulated/floor/tiled/dark/monotile,/area/template_noop)
"li" = (/obj/effect/floor_decal/corner/black/border,/obj/machinery/light{dir = 1},/turf/simulated/floor/tiled/dark/monotile,/area/template_noop)
"lF" = (/obj/effect/catwalk_plated/dark,/turf/simulated/floor/plating,/area/template_noop)
"mq" = (/obj/effect/floor_decal/corner/black/border,/obj/machinery/light{dir = 8},/turf/simulated/floor/tiled/dark,/area/template_noop)
"mX" = (/obj/effect/floor_decal/corner/black/border{dir = 8},/turf/simulated/floor/tiled/dark,/area/template_noop)
"nI" = (/obj/effect/floor_decal/corner/black/border{dir = 5},/turf/simulated/floor/tiled/dark,/area/template_noop)
"nY" = (/obj/effect/catwalk_plated/dark,/obj/structure/bed/chair/office/dark{dir = 8},/turf/simulated/floor/plating,/area/template_noop)
"ob" = (/obj/structure/bed/chair/office/dark{dir = 4},/turf/simulated/floor/tiled/dark,/area/template_noop)
"pd" = (/obj/effect/floor_decal/corner/black/mono,/obj/machinery/light,/turf/simulated/floor/tiled/dark/monotile,/area/template_noop)
"qf" = (/obj/machinery/light{dir = 8},/obj/machinery/libraryscanner,/obj/structure/holoplant{pixel_y = 12},/turf/simulated/floor/tiled/dark/monotile,/area/template_noop)
"qT" = (/obj/effect/wallframe_spawn/no_grille,/turf/simulated/floor/plating,/area/template_noop)
"rs" = (/obj/effect/floor_decal/corner/black/bordercorner{dir = 8},/turf/simulated/floor/tiled/dark/monotile,/area/template_noop)
"su" = (/obj/effect/floor_decal/corner/black/border{dir = 9},/turf/simulated/floor/tiled/dark,/area/template_noop)
"sx" = (/obj/effect/catwalk_plated/dark,/obj/item/caution,/turf/simulated/floor/plating,/area/template_noop)
"tJ" = (/obj/effect/floor_decal/corner/black/border{dir = 8},/obj/structure/noticeboard{dir = 8; pixel_x = 26},/turf/simulated/floor/tiled/dark,/area/template_noop)
"uo" = (/obj/machinery/photocopier{pixel_x = 11},/turf/simulated/floor/tiled/dark,/area/template_noop)
"uA" = (/obj/effect/floor_decal/corner/black/border{dir = 9},/obj/structure/table/standard,/turf/simulated/floor/tiled/dark,/area/template_noop)
"wL" = (/obj/effect/floor_decal/corner/black/border{dir = 6},/turf/simulated/floor/tiled/dark,/area/template_noop)
"wX" = (/obj/effect/floor_decal/corner/black/border{dir = 1},/obj/structure/bed/chair/padded/black{dir = 1},/turf/simulated/floor/tiled/dark,/area/template_noop)
"xf" = (/obj/effect/floor_decal/corner/black/border{dir = 1},/turf/simulated/floor/tiled/dark/monotile,/area/template_noop)
"xy" = (/obj/effect/floor_decal/corner/black/border{dir = 8},/obj/effect/floor_decal/corner/black/border{dir = 4},/obj/structure/table/standard,/turf/simulated/floor/tiled/dark,/area/template_noop)
"yn" = (/obj/machinery/disposal,/turf/simulated/floor/tiled/dark/monotile,/area/template_noop)
"yC" = (/obj/effect/floor_decal/corner/black/border,/obj/machinery/light{dir = 1},/turf/simulated/floor/tiled/dark,/area/template_noop)
"zo" = (/obj/effect/floor_decal/corner/black/border{dir = 8},/obj/structure/table/glass,/obj/structure/flora/pottedplant/large{pixel_y = 16},/obj/item/material/ashtray/plastic{pixel_y = -5},/turf/simulated/floor/tiled/dark/monotile,/area/template_noop)
"zr" = (/obj/effect/floor_decal/corner/black/border{dir = 9},/turf/simulated/floor/tiled/dark/monotile,/area/template_noop)
"AB" = (/obj/effect/floor_decal/corner/black/border{dir = 4},/turf/simulated/floor/tiled/dark,/area/template_noop)
"AJ" = (/obj/effect/floor_decal/corner/black/border{dir = 8},/obj/machinery/vending/coffee{dir = 8},/obj/machinery/light/small{dir = 1},/turf/simulated/floor/tiled/dark/monotile,/area/template_noop)
"Ba" = (/obj/effect/floor_decal/corner/black/mono,/obj/structure/janitorialcart,/obj/item/mop/advanced{pixel_x = -11; pixel_y = -15},/turf/simulated/floor/tiled/dark/monotile,/area/template_noop)
"BE" = (/obj/effect/floor_decal/corner/black/border{dir = 8},/obj/structure/table/standard,/obj/item/paper_bin,/obj/item/pen/multi,/turf/simulated/floor/tiled/dark,/area/template_noop)
"BK" = (/obj/effect/floor_decal/corner/black/border{dir = 8},/obj/effect/floor_decal/corner/black/border{dir = 4},/obj/structure/table/standard,/obj/item/modular_computer/laptop/preset/custom_loadout/advanced,/turf/simulated/floor/tiled/dark,/area/template_noop)
"BX" = (/obj/effect/floor_decal/corner/black/border{dir = 1},/obj/machinery/light/small{dir = 4},/obj/structure/bed/chair/padded/black{dir = 8},/turf/simulated/floor/tiled/dark,/area/template_noop)
"DE" = (/obj/effect/floor_decal/corner/black/border{dir = 4},/obj/effect/floor_decal/corner/black/border{dir = 8},/obj/structure/table/standard,/obj/item/modular_computer/laptop/preset/custom_loadout/advanced,/turf/simulated/floor/tiled/dark,/area/template_noop)
"Ei" = (/obj/effect/floor_decal/corner/black/border{dir = 6},/obj/structure/bed/chair/office/dark{dir = 4},/turf/simulated/floor/tiled/dark,/area/template_noop)
"EG" = (/obj/effect/floor_decal/corner/black/border,/obj/random/junkyard/tool{pixel_x = 14},/turf/simulated/floor/tiled/dark,/area/template_noop)
"EN" = (/obj/structure/filingcabinet/filingcabinet{pixel_x = 12},/obj/machinery/papershredder{pixel_x = -3; pixel_y = 2},/turf/simulated/floor/tiled/dark,/area/template_noop)
"EV" = (/obj/effect/floor_decal/corner/black/border,/turf/simulated/floor/tiled/dark,/area/template_noop)
"GK" = (/obj/effect/floor_decal/corner/black/border{dir = 10},/turf/simulated/floor/tiled/dark,/area/template_noop)
"Hc" = (/obj/effect/floor_decal/corner/black/mono,/obj/machinery/photocopier,/turf/simulated/floor/tiled/dark/monotile,/area/template_noop)
"He" = (/obj/effect/floor_decal/corner/black/border,/obj/structure/noticeboard{pixel_y = 24},/turf/simulated/floor/tiled/dark,/area/template_noop)
"Jd" = (/obj/effect/floor_decal/corner/black/border{dir = 8},/obj/effect/floor_decal/corner/black/border{dir = 4},/obj/structure/table/standard,/obj/machinery/photocopier/faxmachine,/turf/simulated/floor/tiled/dark,/area/template_noop)
"Jo" = (/obj/effect/floor_decal/corner/black/border{dir = 6},/turf/simulated/floor/tiled/dark/monotile,/area/template_noop)
"JD" = (/obj/effect/floor_decal/corner/black/border{dir = 4},/obj/effect/floor_decal/corner/black/border{dir = 8},/obj/structure/table/standard,/turf/simulated/floor/tiled/dark,/area/template_noop)
"JW" = (/turf/template_noop,/area/template_noop)
"KX" = (/obj/effect/floor_decal/corner/black/border{dir = 4},/obj/structure/filingcabinet{pixel_x = -5},/obj/structure/filingcabinet{pixel_x = 5},/turf/simulated/floor/tiled/dark,/area/template_noop)
"Ls" = (/obj/structure/table/standard,/obj/item/modular_computer/laptop/preset/custom_loadout/advanced,/turf/simulated/floor/tiled/dark,/area/template_noop)
"LR" = (/obj/effect/catwalk_plated/dark,/obj/structure/table/standard,/obj/random/junkyard/advdevice,/obj/random/junkyard/smokes,/turf/simulated/floor/plating,/area/template_noop)
"LS" = (/turf/simulated/floor/tiled/dark,/area/template_noop)
"LW" = (/obj/effect/floor_decal/corner/black/border{dir = 8},/obj/machinery/vending/snack{dir = 8},/obj/machinery/light/small,/turf/simulated/floor/tiled/dark/monotile,/area/template_noop)
"Mh" = (/obj/machinery/door/airlock/glass/command,/turf/simulated/floor/tiled/dark/monotile,/area/template_noop)
"Mq" = (/obj/effect/floor_decal/corner/black/border{dir = 1},/obj/machinery/light/small,/turf/simulated/floor/tiled/dark,/area/template_noop)
"NU" = (/obj/effect/floor_decal/corner/black/border{dir = 8},/obj/structure/bed/chair/office/dark{dir = 1},/turf/simulated/floor/tiled/dark/monotile,/area/template_noop)
"Oc" = (/obj/structure/table/standard,/turf/simulated/floor/tiled/dark,/area/template_noop)
"Ov" = (/obj/effect/floor_decal/corner/black/bordercorner{dir = 1},/obj/structure/filingcabinet{pixel_x = -5},/obj/structure/filingcabinet{pixel_x = 5},/turf/simulated/floor/tiled/dark/monotile,/area/template_noop)
"OL" = (/obj/effect/floor_decal/corner/black/border,/turf/simulated/floor/tiled/dark/monotile,/area/template_noop)
"Po" = (/obj/effect/floor_decal/corner/black/border{dir = 5},/obj/structure/table/standard,/obj/item/paper_bin,/obj/item/pen/multi,/turf/simulated/floor/tiled/dark,/area/template_noop)
"QW" = (/turf/simulated/floor/tiled/dark/monotile,/area/template_noop)
"Rs" = (/obj/effect/floor_decal/corner/black/mono,/turf/simulated/floor/tiled/dark/monotile,/area/template_noop)
"SD" = (/obj/effect/floor_decal/corner/black/mono,/obj/structure/table/standard,/obj/item/modular_computer/laptop/preset/custom_loadout/advanced,/turf/simulated/floor/tiled/dark/monotile,/area/template_noop)
"SO" = (/obj/effect/floor_decal/corner/black/mono,/obj/machinery/papershredder{pixel_y = 10},/turf/simulated/floor/tiled/dark/monotile,/area/template_noop)
"Tf" = (/obj/effect/catwalk_plated/dark,/obj/structure/table/standard,/turf/simulated/floor/plating,/area/template_noop)
"UT" = (/obj/structure/filingcabinet/chestdrawer,/turf/simulated/floor/tiled/dark,/area/template_noop)
"Vu" = (/obj/effect/floor_decal/corner/black/border{dir = 4},/obj/structure/table/standard,/obj/item/paper_bin,/obj/item/pen/multi,/obj/random/junkyard/medical/lite,/turf/simulated/floor/tiled/dark,/area/template_noop)
"Wb" = (/obj/machinery/light{dir = 8},/obj/structure/reagent_dispensers/water_cooler{dir = 4},/turf/simulated/floor/tiled/dark/monotile,/area/template_noop)
"Za" = (/obj/effect/floor_decal/corner/black/border{dir = 4},/turf/simulated/floor/tiled/dark/monotile,/area/template_noop)
"Zd" = (/obj/effect/floor_decal/corner/black/border,/obj/structure/extinguisher_cabinet{pixel_y = 29},/turf/simulated/floor/tiled/dark,/area/template_noop)
"Zk" = (/obj/effect/floor_decal/corner/black/border{dir = 1},/turf/simulated/floor/tiled/dark,/area/template_noop)
"ZF" = (/obj/effect/floor_decal/corner/black/border{dir = 4},/obj/machinery/light/small{dir = 1},/turf/simulated/floor/tiled/dark/monotile,/area/template_noop)
"ZK" = (/turf/simulated/wall/r_wall/invincible,/area/template_noop)

(1,1,1) = {"
JWJWJWJWJWJWJWJWJWJWJWJWJWJWJW
JWRsABHeZdEVyCEVmXRsQWBEuoUTJW
JWZkPoiZLSOcOcHcsuZkQWDEnYtJJW
JWmqEiSDLSobLsSOGKEVQWJDLRmXJW
JWRsKXiAZkdNfCZkmXpdQWGKEVEVJW
JWZKqTqTqTqTZKMhZKZKZKqfQWQWJW
JWZFEVEGEVEVZdEVEVAJqTuAZknIJW
JWZasxlFBaRsRslFlFzoqTxylFipJW
JWZaZkZkMqwXwXwXZkLWqTaDEVwLJW
JWQWfVZKZKqTqTqTqTZKZKWbQWQWJW
JWZkBXZKOLJoEVEVgtlirssuZkZkJW
JWLSLSMhLSVuiZRsmXLSgjJdTfmXJW
JWEVEVZKbGjKSDRsmXLSNUBKnYtJJW
JWynfQZKhvjZiAZkzrxfOvBEENLSJW
JWJWJWJWJWJWJWJWJWJWJWJWJWJWJW
"}
