"ah" = (/obj/effect/floor_decal/corner/black/mono,/obj/structure/noticeboard{dir = 4; pixel_x = -26},/turf/simulated/floor/tiled/dark/monotile,/area/template_noop)
"aA" = (/obj/effect/floor_decal/corner/black/border{dir = 5},/obj/structure/fd/bs_vines,/turf/simulated/floor/tiled/dark,/area/template_noop)
"aM" = (/obj/effect/floor_decal/corner/black/mono,/obj/effect/decal/cleanable/dirt,/turf/simulated/floor/tiled/dark/monotile,/area/template_noop)
"aP" = (/obj/effect/floor_decal/corner/black/bordercorner{dir = 8},/obj/structure/extinguisher_cabinet{pixel_y = 29},/obj/structure/fd/bs_vines,/obj/structure/fd/bs_spikes,/turf/simulated/floor/tiled/dark,/area/template_noop)
"bI" = (/obj/effect/decal/cleanable/dirt,/turf/simulated/floor/tiled/dark/monotile,/area/template_noop)
"cg" = (/obj/structure/table/standard,/obj/effect/floor_decal/corner/black/border{dir = 4},/turf/simulated/floor/tiled/dark,/area/template_noop)
"cF" = (/obj/structure/filingcabinet{pixel_x = -5},/turf/simulated/floor/tiled/dark/monotile,/area/template_noop)
"cL" = (/obj/effect/floor_decal/corner/black/border{dir = 9},/turf/simulated/floor/tiled/dark,/area/template_noop)
"do" = (/obj/effect/floor_decal/corner/black/mono,/obj/structure/fd/bs_vines,/turf/simulated/floor/tiled/dark/monotile,/area/template_noop)
"ft" = (/obj/structure/table/standard,/obj/effect/floor_decal/corner/black/border{dir = 9},/obj/item/paper_bin,/obj/item/pen/multi,/turf/simulated/floor/tiled/dark,/area/template_noop)
"gb" = (/turf/template_noop,/area/template_noop)
"gr" = (/obj/effect/floor_decal/corner/black/mono,/obj/structure/filingcabinet/chestdrawer,/turf/simulated/floor/tiled/dark/monotile,/area/template_noop)
"gZ" = (/obj/structure/table/standard,/obj/effect/floor_decal/corner/black/border{dir = 6},/obj/item/paper_bin,/obj/item/pen/multi,/obj/effect/decal/cleanable/dirt,/turf/simulated/floor/tiled/dark,/area/template_noop)
"hR" = (/obj/machinery/light/small{dir = 1},/obj/effect/floor_decal/corner/black/border{dir = 4},/turf/simulated/floor/tiled/dark,/area/template_noop)
"hT" = (/obj/structure/table,/turf/simulated/floor/plating,/area/template_noop)
"jb" = (/obj/structure/table/standard,/obj/effect/floor_decal/corner/black/border{dir = 9},/turf/simulated/floor/tiled/dark,/area/template_noop)
"jc" = (/turf/simulated/wall/r_wall/invincible,/area/template_noop)
"jd" = (/obj/effect/floor_decal/corner/black/border{dir = 6},/obj/structure/table,/turf/simulated/floor/tiled/dark,/area/template_noop)
"jt" = (/obj/effect/floor_decal/corner/black/mono,/turf/simulated/floor/tiled/dark/monotile,/area/template_noop)
"kk" = (/obj/effect/floor_decal/corner/black/border{dir = 1},/obj/structure/fd/bs_vines,/obj/effect/decal/cleanable/dirt,/turf/simulated/floor/tiled/dark,/area/template_noop)
"kV" = (/obj/machinery/light/small,/obj/effect/floor_decal/corner/black/border{dir = 8},/turf/simulated/floor/tiled/dark,/area/template_noop)
"kZ" = (/obj/effect/floor_decal/corner/black/border{dir = 8},/turf/simulated/floor/tiled/dark,/area/template_noop)
"lo" = (/obj/effect/catwalk_plated/dark,/obj/structure/fd/bs_vines,/turf/simulated/floor/plating,/area/template_noop)
"lR" = (/obj/effect/decal/cleanable/dirt,/obj/effect/decal/cleanable/dirt,/turf/simulated/floor/tiled/dark/monotile,/area/template_noop)
"ma" = (/obj/structure/fd/bs_vines,/turf/simulated/floor/tiled/dark/monotile,/area/template_noop)
"mb" = (/obj/effect/floor_decal/corner/black/border{dir = 4},/turf/simulated/floor/tiled/dark,/area/template_noop)
"mw" = (/obj/effect/catwalk_plated/dark,/obj/structure/fd/bs_vines,/obj/effect/decal/cleanable/dirt,/turf/simulated/floor/plating,/area/template_noop)
"nb" = (/obj/effect/floor_decal/corner/black/border{dir = 1},/obj/effect/decal/cleanable/dirt,/turf/simulated/floor/tiled/dark,/area/template_noop)
"nc" = (/obj/structure/table/standard,/obj/effect/floor_decal/corner/black/border,/obj/item/modular_computer/laptop/preset/custom_loadout/advanced,/obj/effect/decal/cleanable/dirt,/turf/simulated/floor/tiled/dark,/area/template_noop)
"nA" = (/obj/machinery/light/spot{dir = 8},/obj/machinery/vending/coffee{dir = 4},/turf/simulated/floor/tiled/dark/monotile,/area/template_noop)
"ov" = (/turf/simulated/floor/tiled/dark/monotile,/area/template_noop)
"oH" = (/obj/structure/table/standard,/obj/effect/floor_decal/corner/black/border{dir = 4},/obj/random/relic,/obj/random/junkyard/powercell,/turf/simulated/floor/tiled/dark,/area/template_noop)
"pt" = (/obj/machinery/light/spot{dir = 4},/turf/simulated/floor/tiled/dark/monotile,/area/template_noop)
"rP" = (/obj/structure/table/standard,/obj/effect/floor_decal/corner/black/border{dir = 6},/obj/effect/decal/cleanable/dirt,/turf/simulated/floor/tiled/dark,/area/template_noop)
"so" = (/obj/effect/floor_decal/corner/black/bordercorner,/turf/simulated/floor/tiled/dark,/area/template_noop)
"ss" = (/obj/structure/table/standard,/obj/effect/floor_decal/corner/black/border{dir = 8},/obj/item/modular_computer/laptop/preset/custom_loadout/advanced,/turf/simulated/floor/tiled/dark,/area/template_noop)
"sG" = (/obj/effect/floor_decal/corner/black/border{dir = 5},/turf/simulated/floor/tiled/dark,/area/template_noop)
"sX" = (/obj/effect/floor_decal/corner/black/bordercorner,/obj/structure/fd/bs_vines,/obj/structure/fd/bs_crystal,/turf/simulated/floor/tiled/dark,/area/template_noop)
"uM" = (/obj/machinery/light/spot{dir = 4},/obj/machinery/disposal,/obj/effect/decal/cleanable/dirt,/turf/simulated/floor/tiled/dark/monotile,/area/template_noop)
"vc" = (/obj/structure/fd/bs_vines,/turf/simulated/floor/plating,/area/template_noop)
"vx" = (/obj/effect/floor_decal/corner/black/border{dir = 4},/obj/structure/bed/chair/office/dark{dir = 8},/obj/effect/decal/cleanable/dirt,/turf/simulated/floor/tiled/dark,/area/template_noop)
"wc" = (/obj/structure/table/standard,/obj/effect/floor_decal/corner/black/border{dir = 8},/obj/machinery/photocopier/faxmachine,/obj/effect/decal/cleanable/dirt,/turf/simulated/floor/tiled/dark,/area/template_noop)
"ws" = (/obj/effect/floor_decal/corner/black/mono,/obj/structure/bed/chair/office/dark{dir = 1},/turf/simulated/floor/tiled/dark/monotile,/area/template_noop)
"wM" = (/obj/effect/floor_decal/corner/black/mono,/obj/structure/noticeboard{dir = 8; pixel_x = 26},/turf/simulated/floor/tiled/dark/monotile,/area/template_noop)
"xT" = (/obj/machinery/light/small,/obj/effect/floor_decal/corner/black/border{dir = 4},/turf/simulated/floor/tiled/dark,/area/template_noop)
"zt" = (/obj/effect/floor_decal/corner/black/border{dir = 8},/obj/effect/decal/cleanable/dirt,/turf/simulated/floor/tiled/dark,/area/template_noop)
"zD" = (/obj/effect/floor_decal/corner/black/border{dir = 8},/obj/structure/bed/chair/office/dark{dir = 4},/turf/simulated/floor/tiled/dark,/area/template_noop)
"zU" = (/obj/structure/table/standard,/obj/effect/floor_decal/corner/black/border{dir = 8},/obj/structure/fd/bs_vines,/turf/simulated/floor/tiled/dark,/area/template_noop)
"Ad" = (/obj/structure/table/standard,/obj/effect/floor_decal/corner/black/border{dir = 4},/obj/item/modular_computer/laptop/preset/custom_loadout/advanced,/obj/effect/decal/cleanable/dirt,/turf/simulated/floor/tiled/dark,/area/template_noop)
"Ao" = (/obj/effect/floor_decal/corner/black/border{dir = 1},/obj/structure/fd/bs_vines,/obj/structure/fd/bs_spikes,/turf/simulated/floor/tiled/dark,/area/template_noop)
"AK" = (/obj/effect/floor_decal/corner/black/mono,/obj/machinery/photocopier{pixel_x = -10},/obj/structure/fd/bs_vines,/turf/simulated/floor/tiled/dark/monotile,/area/template_noop)
"BL" = (/obj/machinery/light/small{dir = 1},/obj/effect/floor_decal/corner/black/border{dir = 8},/turf/simulated/floor/tiled/dark,/area/template_noop)
"Cn" = (/obj/structure/table/standard,/obj/effect/floor_decal/corner/black/border{dir = 10},/obj/item/paper_bin,/obj/item/pen/multi,/turf/simulated/floor/tiled/dark,/area/template_noop)
"DC" = (/obj/structure/table/standard,/obj/effect/floor_decal/corner/black/border{dir = 10},/turf/simulated/floor/tiled/dark,/area/template_noop)
"EA" = (/obj/structure/table/standard,/obj/effect/floor_decal/corner/black/border{dir = 4},/obj/machinery/photocopier/faxmachine,/obj/effect/decal/cleanable/dirt,/turf/simulated/floor/tiled/dark,/area/template_noop)
"EH" = (/obj/effect/floor_decal/corner/black/bordercorner{dir = 4},/obj/structure/extinguisher_cabinet{pixel_y = -29},/turf/simulated/floor/tiled/dark,/area/template_noop)
"Ft" = (/obj/structure/table/standard,/obj/effect/floor_decal/corner/black/border{dir = 4},/obj/item/modular_computer/laptop/preset/custom_loadout/advanced,/obj/effect/decal/cleanable/dirt,/obj/effect/decal/cleanable/dirt,/turf/simulated/floor/tiled/dark,/area/template_noop)
"Fu" = (/obj/structure/fd/bs_vines,/obj/structure/fd/bs_spikes,/turf/simulated/floor/plating,/area/template_noop)
"GV" = (/obj/effect/floor_decal/corner/black/bordercorner{dir = 1},/obj/effect/decal/cleanable/dirt,/turf/simulated/floor/tiled/dark,/area/template_noop)
"Hn" = (/obj/structure/table/standard,/obj/effect/floor_decal/corner/black/border,/obj/machinery/photocopier/faxmachine,/turf/simulated/floor/tiled/dark,/area/template_noop)
"HD" = (/obj/structure/table/standard,/obj/effect/floor_decal/corner/black/border{dir = 10},/obj/effect/decal/cleanable/dirt,/obj/random/junkyard/smokes,/turf/simulated/floor/tiled/dark,/area/template_noop)
"Ix" = (/obj/structure/table/standard,/obj/effect/floor_decal/corner/black/border{dir = 5},/turf/simulated/floor/tiled/dark,/area/template_noop)
"JC" = (/obj/effect/floor_decal/corner/black/border{dir = 1},/turf/simulated/floor/tiled/dark,/area/template_noop)
"JG" = (/obj/effect/floor_decal/corner/black/border{dir = 1},/obj/random/junkyard/tool,/turf/simulated/floor/tiled/dark,/area/template_noop)
"Km" = (/obj/effect/catwalk_plated/dark,/obj/effect/decal/cleanable/dirt,/turf/simulated/floor/plating,/area/template_noop)
"KW" = (/obj/effect/floor_decal/corner/black/border{dir = 6},/turf/simulated/floor/tiled/dark,/area/template_noop)
"Lk" = (/obj/structure/table/standard,/obj/effect/floor_decal/corner/black/border{dir = 8},/obj/machinery/photocopier/faxmachine,/turf/simulated/floor/tiled/dark,/area/template_noop)
"Lz" = (/turf/simulated/floor/tiled/dark,/area/template_noop)
"MN" = (/obj/structure/table/standard,/obj/effect/floor_decal/corner/black/border{dir = 8},/turf/simulated/floor/tiled/dark,/area/template_noop)
"Nb" = (/obj/effect/floor_decal/corner/black/border,/obj/structure/fd/bs_vines,/turf/simulated/floor/tiled/dark,/area/template_noop)
"Nk" = (/obj/effect/floor_decal/corner/black/border,/turf/simulated/floor/tiled/dark,/area/template_noop)
"NG" = (/obj/effect/floor_decal/corner/black/border{dir = 10},/turf/simulated/floor/tiled/dark,/area/template_noop)
"Oe" = (/obj/effect/catwalk_plated/dark,/turf/simulated/floor/plating,/area/template_noop)
"OU" = (/obj/structure/table/standard,/obj/effect/floor_decal/corner/black/border{dir = 4},/obj/machinery/photocopier/faxmachine,/obj/structure/fd/bs_vines,/turf/simulated/floor/tiled/dark,/area/template_noop)
"Pg" = (/obj/effect/floor_decal/corner/black/border{dir = 4},/obj/structure/bed/chair/office/dark{dir = 8},/turf/simulated/floor/tiled/dark,/area/template_noop)
"Pi" = (/obj/machinery/light/spot{dir = 8},/obj/structure/reagent_dispensers/water_cooler{dir = 4},/turf/simulated/floor/tiled/dark/monotile,/area/template_noop)
"Pw" = (/obj/structure/table/standard,/obj/effect/decal/cleanable/dirt,/turf/simulated/floor/plating,/area/template_noop)
"Qe" = (/obj/effect/floor_decal/corner/black/bordercorner{dir = 8},/turf/simulated/floor/tiled/dark,/area/template_noop)
"QY" = (/obj/effect/floor_decal/corner/black/border{dir = 8},/obj/structure/bed/chair/office/dark{dir = 4},/obj/effect/decal/cleanable/dirt,/turf/simulated/floor/tiled/dark,/area/template_noop)
"Rs" = (/obj/structure/table/standard,/obj/effect/floor_decal/corner/black/border{dir = 4},/obj/machinery/photocopier/faxmachine,/turf/simulated/floor/tiled/dark,/area/template_noop)
"RO" = (/obj/effect/floor_decal/corner/black/bordercorner{dir = 1},/turf/simulated/floor/tiled/dark,/area/template_noop)
"TK" = (/obj/structure/table/standard,/obj/effect/floor_decal/corner/black/border{dir = 4},/obj/item/modular_computer/laptop/preset/custom_loadout/advanced,/turf/simulated/floor/tiled/dark,/area/template_noop)
"Uv" = (/turf/simulated/floor/plating,/area/template_noop)
"UI" = (/obj/structure/table/standard,/obj/effect/floor_decal/corner/black/border{dir = 5},/obj/item/paper_bin,/obj/item/pen/multi,/obj/effect/decal/cleanable/dirt,/turf/simulated/floor/tiled/dark,/area/template_noop)
"VM" = (/obj/structure/fd/bs_vines,/obj/structure/fd/bs_crystal,/turf/simulated/floor/tiled/dark/monotile,/area/template_noop)
"WM" = (/obj/effect/floor_decal/corner/black/border,/obj/effect/decal/cleanable/dirt,/turf/simulated/floor/tiled/dark,/area/template_noop)
"Xh" = (/obj/structure/table/standard,/obj/effect/floor_decal/corner/black/border{dir = 6},/obj/structure/fd/bs_vines,/obj/effect/decal/cleanable/dirt,/turf/simulated/floor/tiled/dark,/area/template_noop)

(1,1,1) = {"
gbgbgbgbgbgbgbgbgbgbgbgbgbgbgb
gbjtkZsXNbaPhRovBLsoNkQembaMgb
gbjtzUOUloMNRsovLkcgKmztPwaMgb
gbahzDFtmwQYTKovssUvOeUvLzwMgb
gbgrCnrPOeCnXhbIHDjdUvDCgZgrgb
gbjcnAUvovovovovovFuUvUvuMjcgb
gbovNGWMUvCnncHnUvUvvcNbKWovgb
gbovlovcUvoHwsAKFukZVMOeKmbIgb
gbovcLAodovcJGJCkkaAvcAosGlRgb
gbjcPimaVMmaovovcFvcUvovptjcgb
gbgrftIxloftIxovjbUIOehTUIgrgb
gbahzDAdKmzDTKovssPgOessvxwMgb
gbjtUvEAOeMNEAovLkcgKmwccgjtgb
gbjtkZUvJCROxTovkVEHnbGVmbjtgb
gbgbgbgbgbgbgbgbgbgbgbgbgbgbgb
"}
