"ck" = (/obj/structure/table/standard,/obj/random/junkyard/loot,/turf/simulated/floor/tiled/dark,/area/template_noop)
"cx" = (/obj/effect/floor_decal/corner/blue/border{dir = 1},/obj/structure/table/standard,/obj/effect/decal/cleanable/dirt,/turf/simulated/floor/tiled/dark,/area/template_noop)
"eu" = (/obj/effect/floor_decal/corner/blue/border{dir = 4},/obj/structure/extinguisher_cabinet{pixel_y = 29},/turf/simulated/floor/tiled/dark,/area/template_noop)
"eS" = (/obj/effect/floor_decal/corner/black/border{dir = 8},/obj/random/junkyard/obstruction,/turf/simulated/floor/tiled/dark,/area/template_noop)
"eZ" = (/obj/random/junkyard/bomb_supply,/obj/random/junkyard/bomb_supply{pixel_x = -5; pixel_y = 8},/turf/simulated/floor/tiled/dark,/area/template_noop)
"hr" = (/obj/effect/catwalk_plated/dark,/obj/effect/decal/cleanable/dirt,/obj/structure/barricade,/turf/simulated/floor/plating,/area/template_noop)
"hS" = (/obj/effect/floor_decal/corner/black/border{dir = 5},/obj/machinery/light/small{dir = 1},/turf/simulated/floor/tiled/dark,/area/template_noop)
"ie" = (/obj/effect/catwalk_plated/dark,/turf/simulated/floor/plating,/area/template_noop)
"iI" = (/obj/machinery/vending/cola{dir = 8; pixel_x = 9},/turf/simulated/floor/tiled/dark,/area/template_noop)
"iU" = (/obj/effect/floor_decal/borderfloorblack{dir = 4},/turf/simulated/floor/tiled/techfloor,/area/template_noop)
"kp" = (/obj/effect/floor_decal/corner/black/border{dir = 1},/obj/structure/table/reinforced,/obj/effect/decal/cleanable/dirt,/obj/effect/decal/cleanable/dirt,/turf/simulated/floor/tiled/dark,/area/template_noop)
"lK" = (/obj/effect/floor_decal/borderfloorblack,/turf/simulated/floor/tiled/techfloor,/area/template_noop)
"lW" = (/obj/structure/girder,/obj/effect/decal/cleanable/greenglow,/turf/simulated/floor/plating,/area/template_noop)
"ml" = (/obj/structure/bed/chair/office/dark,/turf/simulated/floor/tiled/dark,/area/template_noop)
"mQ" = (/obj/effect/floor_decal/borderfloorblack{dir = 4},/obj/machinery/light/small{dir = 8},/turf/simulated/floor/tiled/techfloor,/area/template_noop)
"mY" = (/obj/structure/filingcabinet{pixel_x = 5},/obj/structure/filingcabinet{pixel_x = -5},/obj/structure/noticeboard{dir = 8; pixel_x = 26},/turf/simulated/floor/tiled/dark,/area/template_noop)
"ok" = (/obj/effect/floor_decal/corner/black/border,/obj/effect/decal/cleanable/dirt,/obj/effect/decal/cleanable/dirt,/obj/effect/decal/cleanable/dirt,/turf/simulated/floor/tiled/dark,/area/template_noop)
"oD" = (/obj/structure/bed/roller,/obj/effect/decal/cleanable/blood,/obj/effect/decal/cleanable/vomit,/obj/effect/landmark/corpse/city,/turf/simulated/floor/tiled/dark,/area/template_noop)
"pd" = (/obj/structure/barricade,/turf/simulated/floor/tiled/dark/monotile,/area/template_noop)
"pG" = (/obj/effect/floor_decal/corner/blue/mono,/obj/machinery/door/airlock/glass/command,/turf/simulated/floor/tiled/dark/monotile,/area/template_noop)
"qn" = (/obj/effect/floor_decal/corner/black/border{dir = 10},/turf/simulated/floor/tiled/dark,/area/template_noop)
"qQ" = (/obj/effect/floor_decal/borderfloorblack,/obj/machinery/light/small{dir = 1},/obj/random/junkyard/material,/obj/random/junkyard/material,/turf/simulated/floor/tiled/techfloor,/area/template_noop)
"qV" = (/obj/effect/decal/cleanable/dirt,/turf/simulated/floor/plating,/area/template_noop)
"rs" = (/obj/structure/filingcabinet{pixel_x = -5},/obj/structure/filingcabinet{pixel_x = 5},/turf/simulated/floor/tiled/dark,/area/template_noop)
"rx" = (/obj/effect/catwalk_plated/dark,/obj/structure/table/standard,/obj/item/paper_bin,/obj/item/pen/multi,/turf/simulated/floor/plating,/area/template_noop)
"rZ" = (/obj/effect/floor_decal/corner/blue/border{dir = 9},/obj/effect/decal/cleanable/dirt,/turf/simulated/floor/tiled/dark,/area/template_noop)
"sq" = (/obj/effect/catwalk_plated/dark,/obj/effect/decal/cleanable/dirt,/turf/simulated/floor/plating,/area/template_noop)
"sO" = (/obj/machinery/vending/snack{dir = 4; pixel_x = -9},/turf/simulated/floor/tiled/dark,/area/template_noop)
"sW" = (/obj/structure/mattress/dirty,/turf/simulated/floor/tiled/dark,/area/template_noop)
"tm" = (/obj/effect/floor_decal/corner/blue/border{dir = 10},/obj/structure/girder/displaced,/turf/simulated/floor/tiled/dark,/area/template_noop)
"ty" = (/obj/effect/catwalk_plated/dark,/obj/structure/table/standard,/obj/item/paper_bin,/obj/item/pen/multi,/obj/effect/decal/cleanable/dirt,/turf/simulated/floor/plating,/area/template_noop)
"ue" = (/turf/template_noop,/area/template_noop)
"vb" = (/obj/effect/floor_decal/corner/black/border{dir = 1},/turf/simulated/floor/tiled/dark,/area/template_noop)
"vD" = (/obj/effect/floor_decal/corner/black/border{dir = 4},/turf/simulated/floor/tiled/dark,/area/template_noop)
"xh" = (/obj/effect/floor_decal/corner/black/border{dir = 4},/obj/effect/decal/cleanable/blood,/obj/effect/decal/cleanable/ash,/obj/effect/landmark/corpse/city/natarmay/light,/obj/random/junkyard/biggun,/turf/simulated/floor/tiled/dark,/area/template_noop)
"xE" = (/obj/effect/floor_decal/corner/black/border{dir = 9},/obj/effect/decal/cleanable/ash,/obj/effect/landmark/corpse/city,/turf/simulated/floor/tiled/dark,/area/template_noop)
"ym" = (/obj/effect/floor_decal/corner/blue/border{dir = 6},/turf/simulated/floor/tiled/dark,/area/template_noop)
"AT" = (/obj/effect/floor_decal/corner/blue/mono,/obj/effect/wallframe_spawn/no_grille,/obj/effect/decal/cleanable/dirt,/turf/simulated/floor/tiled/dark/monotile,/area/template_noop)
"AW" = (/obj/effect/floor_decal/corner/black/border{dir = 10},/obj/machinery/light/small,/turf/simulated/floor/tiled/dark,/area/template_noop)
"Bd" = (/obj/effect/catwalk_plated/dark,/obj/effect/decal/cleanable/dirt,/obj/effect/decal/cleanable/dirt,/turf/simulated/floor/plating,/area/template_noop)
"Ce" = (/obj/effect/floor_decal/borderfloorblack{dir = 8},/turf/simulated/floor/tiled/techfloor,/area/template_noop)
"Cx" = (/obj/machinery/light,/turf/simulated/floor/tiled/dark,/area/template_noop)
"CR" = (/obj/effect/floor_decal/corner/black/border{dir = 8},/turf/simulated/floor/tiled/dark,/area/template_noop)
"DD" = (/turf/simulated/floor/plating,/area/template_noop)
"DR" = (/obj/structure/table/standard,/obj/random/junkyard/lilgun,/turf/simulated/floor/tiled/dark,/area/template_noop)
"EY" = (/obj/effect/floor_decal/corner/blue/border{dir = 1},/obj/structure/table/standard,/obj/item/paper_bin,/obj/item/pen/multi,/turf/simulated/floor/tiled/dark,/area/template_noop)
"FA" = (/obj/effect/decal/cleanable/dirt,/obj/structure/barricade,/turf/simulated/floor/plating,/area/template_noop)
"FH" = (/obj/effect/floor_decal/borderfloorblack{dir = 8},/obj/machinery/light/small{dir = 4},/turf/simulated/floor/tiled/techfloor,/area/template_noop)
"FK" = (/obj/structure/bed/chair/office/dark,/obj/machinery/light{dir = 1},/turf/simulated/floor/tiled/dark,/area/template_noop)
"Gd" = (/obj/effect/floor_decal/corner/blue/border{dir = 8},/obj/structure/extinguisher_cabinet{pixel_y = -30},/obj/machinery/fabricator/hacked,/turf/simulated/floor/tiled/dark,/area/template_noop)
"Gk" = (/obj/effect/floor_decal/corner/black/border{dir = 8},/obj/structure/ore_box,/turf/simulated/floor/tiled/dark,/area/template_noop)
"Hm" = (/obj/structure/filingcabinet{pixel_x = 5},/obj/structure/filingcabinet{pixel_x = -5},/turf/simulated/floor/tiled/dark,/area/template_noop)
"Hs" = (/obj/structure/table/standard,/turf/simulated/floor/tiled/dark,/area/template_noop)
"HA" = (/obj/effect/floor_decal/corner/black/border,/turf/simulated/floor/tiled/dark,/area/template_noop)
"HI" = (/obj/random/junkyard/obstruction,/turf/simulated/floor/plating,/area/template_noop)
"HY" = (/obj/effect/floor_decal/corner/black/border{dir = 8},/obj/structure/table/reinforced,/obj/machinery/photocopier/faxmachine,/obj/random/junkyard/powercell{pixel_y = 8},/turf/simulated/floor/tiled/dark,/area/template_noop)
"Io" = (/obj/effect/floor_decal/corner/blue/border{dir = 1},/obj/structure/table/standard,/obj/item/modular_computer/laptop/preset/custom_loadout/advanced,/obj/effect/decal/cleanable/dirt,/turf/simulated/floor/tiled/dark,/area/template_noop)
"ID" = (/obj/effect/floor_decal/borderfloorblack{dir = 4},/obj/machinery/light/small{dir = 8},/obj/random/junkyard/obstruction,/turf/simulated/floor/tiled/techfloor,/area/template_noop)
"Jq" = (/obj/effect/floor_decal/corner/black/border{dir = 8},/obj/effect/decal/cleanable/dirt,/turf/simulated/floor/tiled/dark,/area/template_noop)
"JN" = (/obj/effect/floor_decal/corner/blue/border{dir = 8},/obj/effect/decal/cleanable/dirt,/turf/simulated/floor/tiled/dark,/area/template_noop)
"KB" = (/obj/effect/floor_decal/corner/blue/border{dir = 4},/obj/effect/decal/cleanable/dirt,/turf/simulated/floor/tiled/dark,/area/template_noop)
"KS" = (/obj/effect/floor_decal/corner/blue/border{dir = 8},/turf/simulated/floor/tiled/dark,/area/template_noop)
"Lp" = (/obj/effect/floor_decal/corner/black/border{dir = 6},/obj/machinery/light/small,/obj/random/junkyard/tool,/turf/simulated/floor/tiled/dark,/area/template_noop)
"Lt" = (/obj/effect/floor_decal/corner/blue/border{dir = 8},/obj/structure/extinguisher_cabinet{pixel_y = 29},/turf/simulated/floor/tiled/dark,/area/template_noop)
"Lu" = (/obj/effect/floor_decal/corner/black/border{dir = 1},/obj/structure/table/reinforced,/obj/structure/flora/pottedplant/large{pixel_y = 13},/obj/effect/decal/cleanable/dirt,/turf/simulated/floor/tiled/dark,/area/template_noop)
"LS" = (/obj/effect/floor_decal/corner/blue/border,/obj/structure/table/standard,/obj/item/modular_computer/laptop/preset/custom_loadout/advanced,/turf/simulated/floor/tiled/dark,/area/template_noop)
"LY" = (/obj/effect/landmark/corpse/city,/turf/simulated/floor/plating,/area/template_noop)
"Mx" = (/obj/effect/floor_decal/corner/blue/border{dir = 4},/turf/simulated/floor/tiled/dark,/area/template_noop)
"Mz" = (/obj/effect/floor_decal/corner/blue/border{dir = 5},/turf/simulated/floor/tiled/dark,/area/template_noop)
"MX" = (/obj/effect/floor_decal/borderfloorblack{dir = 1},/obj/machinery/light/small,/turf/simulated/floor/tiled/techfloor,/area/template_noop)
"MZ" = (/obj/effect/decal/cleanable/dirt,/turf/simulated/floor/tiled/dark,/area/template_noop)
"NM" = (/obj/effect/decal/cleanable/dirt,/obj/structure/girder,/turf/simulated/floor/tiled/dark,/area/template_noop)
"NX" = (/obj/structure/mattress,/obj/effect/decal/cleanable/blood,/obj/effect/landmark/corpse/city/natarmay/light,/turf/simulated/floor/plating,/area/template_noop)
"Oi" = (/obj/effect/floor_decal/corner/blue/border{dir = 8},/obj/effect/decal/cleanable/dirt,/obj/effect/decal/cleanable/dirt,/turf/simulated/floor/tiled/dark,/area/template_noop)
"OY" = (/turf/simulated/floor/tiled/dark,/area/template_noop)
"Pj" = (/obj/structure/janitorialcart,/obj/effect/decal/cleanable/greenglow,/turf/simulated/floor/plating,/area/template_noop)
"PX" = (/obj/effect/floor_decal/corner/blue/border{dir = 4},/obj/structure/extinguisher_cabinet{pixel_y = -30},/turf/simulated/floor/tiled/dark,/area/template_noop)
"QQ" = (/obj/structure/bed/chair/office/dark{dir = 1},/obj/machinery/light,/turf/simulated/floor/tiled/dark,/area/template_noop)
"QS" = (/obj/effect/floor_decal/corner/black/border{dir = 1},/obj/structure/barricade,/turf/simulated/floor/tiled/dark,/area/template_noop)
"QV" = (/obj/effect/catwalk_plated/dark,/obj/structure/table/standard,/obj/item/modular_computer/laptop/preset/custom_loadout/advanced,/turf/simulated/floor/plating,/area/template_noop)
"Rw" = (/turf/simulated/wall/r_wall/invincible,/area/template_noop)
"Sd" = (/obj/effect/floor_decal/corner/black/border{dir = 8},/obj/structure/barricade/spike,/obj/structure/grille/broken,/turf/simulated/floor/tiled/dark,/area/template_noop)
"Se" = (/obj/effect/floor_decal/corner/blue/border,/obj/structure/table/standard,/turf/simulated/floor/tiled/dark,/area/template_noop)
"TS" = (/obj/effect/floor_decal/corner/blue/border{dir = 1},/obj/effect/decal/cleanable/dirt,/obj/structure/bed/chair/office/light,/turf/simulated/floor/tiled/dark,/area/template_noop)
"Ub" = (/obj/structure/bed/chair/office/dark{dir = 1},/turf/simulated/floor/tiled/dark,/area/template_noop)
"Ut" = (/obj/effect/floor_decal/corner/blue/mono,/obj/effect/wallframe_spawn/no_grille,/turf/simulated/floor/tiled/dark/monotile,/area/template_noop)
"Uz" = (/obj/effect/floor_decal/corner/blue/border{dir = 1},/obj/effect/landmark/corpse/doctor,/turf/simulated/floor/tiled/dark,/area/template_noop)
"UL" = (/obj/effect/floor_decal/corner/blue/border,/obj/structure/table/standard,/obj/item/paper_bin,/obj/item/pen/multi,/turf/simulated/floor/tiled/dark,/area/template_noop)
"UO" = (/obj/effect/floor_decal/borderfloorblack{dir = 1},/turf/simulated/floor/tiled/techfloor,/area/template_noop)
"Vh" = (/obj/machinery/vending/coffee{density = 0; pixel_y = 19},/turf/simulated/floor/tiled/dark,/area/template_noop)
"VA" = (/obj/structure/filingcabinet{pixel_x = 5},/obj/structure/filingcabinet{pixel_x = -5},/obj/structure/noticeboard{dir = 4; pixel_x = -26},/turf/simulated/floor/tiled/dark,/area/template_noop)
"Wo" = (/obj/machinery/disposal,/turf/simulated/floor/tiled/dark,/area/template_noop)
"WF" = (/obj/effect/floor_decal/corner/black/border,/obj/effect/decal/cleanable/blood,/turf/simulated/floor/tiled/dark,/area/template_noop)
"Xy" = (/obj/effect/catwalk_plated/dark,/obj/structure/barricade/spike,/turf/simulated/floor/plating,/area/template_noop)
"XY" = (/obj/effect/floor_decal/corner/blue/border{dir = 1},/obj/structure/table/standard,/obj/effect/decal/cleanable/cobweb2,/obj/random/junkyard/medical,/obj/random/junkyard/medical,/obj/random/junkyard/medical,/obj/random/junkyard/smokes,/turf/simulated/floor/tiled/dark,/area/template_noop)
"YB" = (/obj/effect/floor_decal/corner/black/border{dir = 4},/obj/effect/decal/cleanable/dirt,/turf/simulated/floor/tiled/dark,/area/template_noop)
"Zv" = (/obj/effect/floor_decal/borderfloorblack{dir = 8},/obj/machinery/light/small{dir = 4},/obj/effect/decal/cleanable/dirt,/turf/simulated/floor/tiled/techfloor,/area/template_noop)
"Zx" = (/obj/effect/floor_decal/corner/black/border{dir = 5},/turf/simulated/floor/tiled/dark,/area/template_noop)
"ZB" = (/obj/effect/floor_decal/borderfloorblack,/obj/machinery/light/small{dir = 1},/turf/simulated/floor/tiled/techfloor,/area/template_noop)

(1,1,1) = {"
ueueueueueueueueueueueueueueue
uersFKOYeuUtqQlKZBUtLtOYFKHmue
ueDRQVrxKBATJqsqxhHIKStyQVHsue
ueVAmlMZMxUtGkieDDDDDDMZmlmYue
ueSeLSULymATSdXyHIpdtmULLSSeue
ueUtUtUtpGRwqnHALYFApGUtUtUtue
uemQvbQSNXhSeZWoNMqVPjkpLuFHue
ueiUieDDievDiIRwsODDsqBdsqCeue
ueIDDDDDHALpOYVhsWAWokHAWFZvue
ueATUtUtpGRwxEvbZxRwpGUtATUtue
uecxIoEYMzUtHYievDUtrZUzTSXYue
ueVAUbOYKBUtCRievDUtOiMZOYHsue
ueHsQVrxMxATeShrYBUtJNBdieoDue
ueHmQQOYPXUtlWUOMXUtGdckCxOYue
ueueueueueueueueueueueueueueue
"}
