"cM" = (/obj/random/junkyard/obstruction,/turf/simulated/floor/tiled/dark/monotile,/area/template_noop)
"dq" = (/obj/effect/floor_decal/corner/black/mono,/obj/structure/filingcabinet/chestdrawer,/turf/simulated/floor/tiled/dark/monotile,/area/template_noop)
"dM" = (/obj/effect/floor_decal/corner/black/border{dir = 5},/turf/simulated/floor/tiled/dark,/area/template_noop)
"ei" = (/turf/template_noop,/area/template_noop)
"eL" = (/obj/effect/floor_decal/corner/black/border{dir = 1},/obj/machinery/papershredder,/turf/simulated/floor/tiled/dark,/area/template_noop)
"fC" = (/obj/effect/floor_decal/corner/black/border,/turf/simulated/floor/tiled/dark,/area/template_noop)
"fK" = (/obj/machinery/light/small,/obj/effect/floor_decal/corner/black/border{dir = 4},/obj/structure/barricade/spike,/turf/simulated/floor/tiled/dark,/area/template_noop)
"jd" = (/obj/effect/floor_decal/corner/black/mono,/obj/machinery/photocopier{pixel_x = -10},/obj/effect/decal/cleanable/dirt,/turf/simulated/floor/tiled/dark/monotile,/area/template_noop)
"jU" = (/obj/effect/catwalk_plated/dark,/obj/effect/decal/cleanable/dirt,/turf/simulated/floor/plating,/area/template_noop)
"lG" = (/obj/effect/floor_decal/corner/black/border{dir = 8},/obj/structure/bed/chair/office/dark{dir = 4},/obj/effect/decal/cleanable/dirt,/obj/effect/decal/cleanable/dirt,/turf/simulated/floor/tiled/dark,/area/template_noop)
"ma" = (/obj/structure/table/standard,/obj/effect/floor_decal/corner/black/border{dir = 9},/turf/simulated/floor/tiled/dark,/area/template_noop)
"me" = (/obj/structure/table/standard,/obj/structure/filingcabinet{pixel_x = -5},/turf/simulated/floor/tiled/dark/monotile,/area/template_noop)
"mj" = (/obj/effect/floor_decal/corner/black/border{dir = 9},/obj/structure/filingcabinet{pixel_x = -9; pixel_y = -15},/obj/effect/decal/cleanable/dirt,/turf/simulated/floor/tiled/dark,/area/template_noop)
"mu" = (/obj/structure/table/standard,/obj/effect/floor_decal/corner/black/border{dir = 4},/obj/effect/decal/cleanable/dirt,/turf/simulated/floor/tiled/dark,/area/template_noop)
"mI" = (/obj/structure/table/standard,/obj/effect/floor_decal/corner/black/border{dir = 5},/obj/item/paper_bin,/obj/item/pen/multi,/turf/simulated/floor/tiled/dark,/area/template_noop)
"ni" = (/obj/effect/decal/cleanable/dirt,/obj/effect/decal/cleanable/dirt,/obj/effect/decal/cleanable/dirt,/turf/simulated/floor/tiled/dark/monotile,/area/template_noop)
"ny" = (/obj/effect/floor_decal/corner/black/mono,/obj/structure/bed/chair/office/dark{dir = 1},/turf/simulated/floor/tiled/dark/monotile,/area/template_noop)
"ob" = (/obj/effect/floor_decal/corner/black/border{dir = 8},/obj/effect/decal/cleanable/dirt,/obj/random/junkyard/tech_supply,/obj/random/junkyard/tech_supply{pixel_x = 13; pixel_y = -2},/obj/random/junkyard/tech_supply{pixel_x = -7; pixel_y = -30},/turf/simulated/floor/tiled/dark,/area/template_noop)
"oQ" = (/obj/effect/floor_decal/corner/black/border{dir = 6},/obj/structure/table/standard,/obj/structure/barricade,/turf/simulated/floor/tiled/dark,/area/template_noop)
"py" = (/obj/structure/table/standard,/obj/effect/floor_decal/corner/black/border{dir = 10},/turf/simulated/floor/tiled/dark,/area/template_noop)
"pI" = (/obj/structure/table/standard,/obj/effect/floor_decal/corner/black/border{dir = 8},/obj/machinery/photocopier/faxmachine,/obj/effect/decal/cleanable/dirt,/turf/simulated/floor/tiled/dark,/area/template_noop)
"rh" = (/obj/structure/table/standard,/obj/effect/floor_decal/corner/black/border,/obj/machinery/photocopier/faxmachine,/turf/simulated/floor/tiled/dark,/area/template_noop)
"rl" = (/obj/effect/floor_decal/corner/black/border{dir = 1},/turf/simulated/floor/tiled/dark,/area/template_noop)
"rH" = (/obj/effect/floor_decal/corner/black/border{dir = 4},/turf/simulated/floor/tiled/dark,/area/template_noop)
"sj" = (/obj/effect/floor_decal/corner/black/border{dir = 4},/obj/structure/table/standard,/turf/simulated/floor/tiled/dark,/area/template_noop)
"up" = (/obj/effect/floor_decal/corner/black/border{dir = 4},/obj/structure/bed/chair/office/dark{dir = 8},/obj/effect/decal/cleanable/blood,/turf/simulated/floor/tiled/dark,/area/template_noop)
"vo" = (/obj/effect/floor_decal/corner/black/mono,/turf/simulated/floor/tiled/dark/monotile,/area/template_noop)
"vy" = (/obj/effect/floor_decal/corner/black/border{dir = 5},/obj/structure/filingcabinet{pixel_x = -5},/obj/structure/filingcabinet{pixel_x = 5},/turf/simulated/floor/tiled/dark,/area/template_noop)
"vZ" = (/obj/effect/floor_decal/corner/black/bordercorner{dir = 4},/obj/structure/extinguisher_cabinet{pixel_y = -29},/obj/random/junkyard/obstruction,/turf/simulated/floor/tiled/dark,/area/template_noop)
"wA" = (/obj/effect/landmark/corpse/city,/obj/effect/decal/cleanable/blood,/turf/simulated/floor/tiled/dark/monotile,/area/template_noop)
"wG" = (/obj/effect/decal/cleanable/dirt,/obj/structure/barricade,/turf/simulated/floor/tiled/dark/monotile,/area/template_noop)
"wK" = (/obj/effect/floor_decal/corner/black/bordercorner{dir = 1},/obj/effect/decal/cleanable/dirt,/turf/simulated/floor/tiled/dark,/area/template_noop)
"xk" = (/obj/effect/floor_decal/corner/black/mono,/obj/structure/noticeboard{dir = 8; pixel_x = 26},/turf/simulated/floor/tiled/dark/monotile,/area/template_noop)
"xB" = (/obj/effect/floor_decal/corner/black/border{dir = 4},/obj/effect/decal/cleanable/dirt,/obj/random/junkyard/obstruction,/turf/simulated/floor/tiled/dark,/area/template_noop)
"xU" = (/obj/machinery/light/spot{dir = 4},/obj/machinery/disposal,/obj/effect/decal/cleanable/dirt,/turf/simulated/floor/tiled/dark/monotile,/area/template_noop)
"yN" = (/obj/structure/table/standard,/turf/simulated/floor/tiled/dark/monotile,/area/template_noop)
"yO" = (/obj/effect/floor_decal/corner/black/border{dir = 10},/obj/machinery/vending/coffee,/obj/effect/decal/cleanable/dirt,/turf/simulated/floor/tiled/dark,/area/template_noop)
"yQ" = (/obj/effect/floor_decal/corner/black/bordercorner,/obj/structure/table/standard,/turf/simulated/floor/tiled/dark,/area/template_noop)
"zb" = (/obj/effect/floor_decal/corner/black/border{dir = 10},/obj/structure/table,/turf/simulated/floor/tiled/dark,/area/template_noop)
"ze" = (/obj/effect/floor_decal/corner/black/border{dir = 4},/obj/structure/bed/chair/office/dark{dir = 8},/obj/effect/decal/cleanable/dirt,/turf/simulated/floor/tiled/dark,/area/template_noop)
"zD" = (/obj/effect/floor_decal/corner/black/border{dir = 8},/obj/structure/bed/chair/office/dark{dir = 4},/turf/simulated/floor/tiled/dark,/area/template_noop)
"zT" = (/obj/structure/table/standard,/obj/effect/floor_decal/corner/black/border{dir = 8},/obj/machinery/photocopier/faxmachine,/turf/simulated/floor/tiled/dark,/area/template_noop)
"Ak" = (/obj/structure/table/standard,/obj/effect/floor_decal/corner/black/border{dir = 9},/obj/item/paper_bin,/obj/item/pen/multi,/obj/effect/decal/cleanable/dirt,/turf/simulated/floor/tiled/dark,/area/template_noop)
"Bb" = (/obj/effect/floor_decal/corner/black/bordercorner{dir = 8},/obj/structure/extinguisher_cabinet{pixel_y = 29},/obj/structure/table,/turf/simulated/floor/tiled/dark,/area/template_noop)
"Bh" = (/obj/effect/floor_decal/corner/black/border{dir = 4},/obj/effect/decal/cleanable/dirt,/turf/simulated/floor/tiled/dark,/area/template_noop)
"Bu" = (/obj/effect/catwalk_plated/dark,/obj/structure/barricade,/turf/simulated/floor/plating,/area/template_noop)
"BM" = (/obj/structure/table/standard,/obj/effect/floor_decal/corner/black/border{dir = 6},/obj/random/junkyard/material,/obj/random/junkyard/material,/turf/simulated/floor/tiled/dark,/area/template_noop)
"BQ" = (/obj/effect/landmark/corpse/city/natarmay/light,/obj/effect/decal/cleanable/dirt,/obj/effect/decal/cleanable/blood,/obj/random/junkyard/handgun,/turf/simulated/floor/tiled/dark/monotile,/area/template_noop)
"BR" = (/obj/effect/floor_decal/corner/black/bordercorner{dir = 8},/obj/effect/decal/cleanable/dirt,/turf/simulated/floor/tiled/dark,/area/template_noop)
"Cn" = (/obj/structure/table/standard,/obj/effect/floor_decal/corner/black/border{dir = 9},/obj/item/paper_bin,/obj/item/pen/multi,/turf/simulated/floor/tiled/dark,/area/template_noop)
"Cq" = (/obj/effect/floor_decal/corner/black/bordercorner{dir = 4},/turf/simulated/floor/tiled/dark,/area/template_noop)
"Dw" = (/obj/structure/table/standard,/obj/effect/floor_decal/corner/black/border{dir = 8},/obj/item/modular_computer/laptop/preset/custom_loadout/advanced,/obj/effect/decal/cleanable/dirt,/turf/simulated/floor/tiled/dark,/area/template_noop)
"DK" = (/obj/effect/floor_decal/corner/black/border{dir = 10},/turf/simulated/floor/tiled/dark,/area/template_noop)
"Ew" = (/obj/structure/table/standard,/obj/effect/floor_decal/corner/black/border{dir = 4},/turf/simulated/floor/tiled/dark,/area/template_noop)
"Gj" = (/obj/effect/floor_decal/corner/black/border{dir = 8},/turf/simulated/floor/tiled/dark,/area/template_noop)
"Gm" = (/obj/structure/table/standard,/obj/effect/floor_decal/corner/black/border{dir = 10},/obj/item/paper_bin,/obj/item/pen/multi,/turf/simulated/floor/tiled/dark,/area/template_noop)
"Gr" = (/obj/structure/table/standard,/obj/effect/floor_decal/corner/black/border{dir = 8},/obj/effect/decal/cleanable/dirt,/turf/simulated/floor/tiled/dark,/area/template_noop)
"HQ" = (/obj/effect/floor_decal/corner/black/border{dir = 1},/obj/effect/decal/cleanable/dirt,/turf/simulated/floor/tiled/dark,/area/template_noop)
"HR" = (/obj/structure/table/standard,/obj/effect/floor_decal/corner/black/border{dir = 4},/obj/item/modular_computer/laptop/preset/custom_loadout/advanced,/obj/effect/decal/cleanable/dirt,/turf/simulated/floor/tiled/dark,/area/template_noop)
"Im" = (/obj/effect/decal/cleanable/dirt,/obj/effect/decal/cleanable/dirt,/turf/simulated/floor/tiled/dark/monotile,/area/template_noop)
"Je" = (/obj/effect/floor_decal/corner/black/border{dir = 8},/obj/structure/table/standard,/obj/random/junkyard/ammo,/turf/simulated/floor/tiled/dark,/area/template_noop)
"Lc" = (/obj/structure/barricade,/turf/simulated/floor/tiled/dark/monotile,/area/template_noop)
"Lg" = (/obj/structure/table/standard,/obj/effect/floor_decal/corner/black/border{dir = 8},/obj/item/modular_computer/laptop/preset/custom_loadout/advanced,/turf/simulated/floor/tiled/dark,/area/template_noop)
"Ll" = (/obj/effect/floor_decal/corner/black/border{dir = 1},/obj/effect/landmark/corpse/city,/turf/simulated/floor/tiled/dark,/area/template_noop)
"LV" = (/turf/simulated/floor/tiled/dark/monotile,/area/template_noop)
"MI" = (/obj/effect/floor_decal/corner/black/border{dir = 6},/obj/structure/barricade,/turf/simulated/floor/tiled/dark,/area/template_noop)
"ML" = (/obj/effect/floor_decal/corner/black/border{dir = 6},/turf/simulated/floor/tiled/dark,/area/template_noop)
"MP" = (/obj/machinery/light/small{dir = 1},/obj/effect/floor_decal/corner/black/border{dir = 8},/obj/random/junkyard/obstruction,/turf/simulated/floor/tiled/dark,/area/template_noop)
"Nr" = (/obj/effect/floor_decal/corner/black/border{dir = 8},/obj/structure/table,/turf/simulated/floor/tiled/dark,/area/template_noop)
"Nu" = (/turf/simulated/wall/r_wall/invincible,/area/template_noop)
"OZ" = (/obj/effect/floor_decal/corner/black/mono,/obj/machinery/photocopier/faxmachine,/turf/simulated/floor/tiled/dark/monotile,/area/template_noop)
"Pw" = (/obj/machinery/light/small,/obj/effect/floor_decal/corner/black/border{dir = 8},/turf/simulated/floor/tiled/dark,/area/template_noop)
"PB" = (/obj/effect/floor_decal/corner/black/border{dir = 1},/obj/item/paper_bin,/obj/item/pen/multi{pixel_x = 14; pixel_y = -19},/turf/simulated/floor/tiled/dark,/area/template_noop)
"Qz" = (/obj/effect/floor_decal/corner/black/border{dir = 8},/obj/effect/decal/cleanable/dirt,/turf/simulated/floor/tiled/dark,/area/template_noop)
"QB" = (/obj/structure/table/standard,/obj/effect/floor_decal/corner/black/border{dir = 6},/obj/item/paper_bin,/obj/item/pen/multi,/obj/effect/decal/cleanable/dirt,/turf/simulated/floor/tiled/dark,/area/template_noop)
"QD" = (/obj/structure/table/standard,/obj/effect/floor_decal/corner/black/border{dir = 5},/obj/effect/decal/cleanable/dirt,/turf/simulated/floor/tiled/dark,/area/template_noop)
"QR" = (/obj/effect/floor_decal/corner/black/mono,/obj/item/modular_computer/laptop/preset/custom_loadout/advanced,/obj/effect/decal/cleanable/dirt,/turf/simulated/floor/tiled/dark/monotile,/area/template_noop)
"Rf" = (/obj/structure/table/standard,/obj/effect/floor_decal/corner/black/border{dir = 4},/obj/machinery/photocopier/faxmachine,/turf/simulated/floor/tiled/dark,/area/template_noop)
"Ri" = (/obj/effect/floor_decal/corner/black/mono,/obj/effect/decal/cleanable/dirt,/turf/simulated/floor/tiled/dark/monotile,/area/template_noop)
"Rj" = (/obj/structure/table/standard,/obj/structure/filingcabinet/chestdrawer,/turf/simulated/floor/tiled/dark/monotile,/area/template_noop)
"RC" = (/obj/effect/floor_decal/corner/black/mono,/obj/structure/noticeboard{dir = 4; pixel_x = -26},/turf/simulated/floor/tiled/dark/monotile,/area/template_noop)
"RR" = (/obj/machinery/light/spot{dir = 4},/turf/simulated/floor/tiled/dark/monotile,/area/template_noop)
"Se" = (/obj/structure/table/standard,/obj/effect/floor_decal/corner/black/border{dir = 5},/obj/effect/decal/cleanable/dirt,/obj/random/junkyard/powercell,/obj/random/junkyard/smokes,/turf/simulated/floor/tiled/dark,/area/template_noop)
"Sq" = (/obj/structure/table/standard,/obj/effect/floor_decal/corner/black/border,/turf/simulated/floor/tiled/dark,/area/template_noop)
"Th" = (/obj/machinery/light/spot{dir = 8},/obj/effect/decal/cleanable/dirt,/obj/effect/decal/cleanable/blood,/turf/simulated/floor/tiled/dark/monotile,/area/template_noop)
"TH" = (/obj/effect/floor_decal/corner/black/border{dir = 6},/obj/effect/decal/cleanable/dirt,/turf/simulated/floor/tiled/dark,/area/template_noop)
"TI" = (/obj/structure/table/standard,/obj/effect/floor_decal/corner/black/border{dir = 9},/obj/effect/decal/cleanable/dirt,/turf/simulated/floor/tiled/dark,/area/template_noop)
"Vm" = (/obj/effect/decal/cleanable/dirt,/turf/simulated/floor/tiled/dark/monotile,/area/template_noop)
"Vu" = (/obj/effect/catwalk_plated/dark,/turf/simulated/floor/plating,/area/template_noop)
"VI" = (/obj/machinery/light/small{dir = 1},/obj/effect/floor_decal/corner/black/border{dir = 4},/obj/structure/barricade/spike,/turf/simulated/floor/tiled/dark,/area/template_noop)
"VX" = (/obj/structure/table/standard,/obj/effect/floor_decal/corner/black/border{dir = 8},/turf/simulated/floor/tiled/dark,/area/template_noop)
"Wq" = (/obj/structure/table/standard,/obj/effect/floor_decal/corner/black/border{dir = 5},/obj/item/paper_bin,/obj/item/pen/multi,/obj/effect/decal/cleanable/dirt,/turf/simulated/floor/tiled/dark,/area/template_noop)
"WB" = (/obj/effect/floor_decal/corner/black/bordercorner,/obj/effect/decal/cleanable/dirt,/turf/simulated/floor/tiled/dark,/area/template_noop)
"WL" = (/obj/effect/floor_decal/corner/black/border{dir = 1},/obj/effect/decal/cleanable/dirt,/obj/structure/barricade,/turf/simulated/floor/tiled/dark,/area/template_noop)
"Xi" = (/obj/effect/floor_decal/corner/black/border{dir = 9},/obj/effect/decal/cleanable/dirt,/turf/simulated/floor/tiled/dark,/area/template_noop)
"Xp" = (/obj/effect/floor_decal/corner/black/bordercorner{dir = 1},/obj/structure/barricade,/turf/simulated/floor/tiled/dark,/area/template_noop)
"Xq" = (/obj/machinery/light/spot{dir = 8},/turf/simulated/floor/tiled/dark/monotile,/area/template_noop)
"Yp" = (/obj/structure/table/standard,/obj/random/junkyard/toolbox,/turf/simulated/floor/tiled/dark/monotile,/area/template_noop)
"ZJ" = (/obj/effect/catwalk_plated/dark,/obj/structure/reagent_dispensers/water_cooler{dir = 4},/obj/effect/decal/cleanable/dirt,/turf/simulated/floor/plating,/area/template_noop)
"ZQ" = (/obj/effect/landmark/corpse/city,/obj/effect/decal/cleanable/dirt,/turf/simulated/floor/tiled/dark/monotile,/area/template_noop)

(1,1,1) = {"
eieieieieieieieieieieieieieiei
eiRiobWBfCBbVILVMPyQfCBRrHOZei
eivoGjBhjUGjrHBQGjsjVuNrEwRiei
eiRCQzxBVuJerHVmGjsjBuVXBhxkei
eivoDKMLVuDKoQYpzbMIVupyQBdqei
eiNuThLVLVLVLVLVwALVLVVmxUNuei
eiyNyOfCvoGmSqrhSqBMvofCTHcMei
eiRjjUZJvomunyjdvoGrQRjUVucMei
eimemjLlvoXiHQeLPBvyRiHQdMwGei
eiNuXqLVLVVmImLVLVLcLVLVRRNuei
eidqAkQDVuCnSeLVTImIVumaWqdqei
eiRClGHRVuzDHRniLgupVuDwzexkei
eivoVXRfVuVXRfZQzTmuBupImuvoei
eivoGjCqrlXpfKLVPwvZWLwKBhvoei
eieieieieieieieieieieieieieiei
"}
