"ae" = (/obj/effect/floor_decal/corner/black/border{dir = 10},/obj/structure/fd/bs_vines,/turf/simulated/floor/tiled/dark,/area/template_noop)
"ah" = (/obj/structure/fd/bs_vines,/turf/simulated/floor/plating,/area/template_noop)
"aR" = (/obj/effect/floor_decal/borderfloorblack{dir = 1},/turf/simulated/floor/tiled/techfloor,/area/template_noop)
"bh" = (/obj/effect/floor_decal/corner/blue/mono,/obj/effect/wallframe_spawn/no_grille,/turf/simulated/floor/tiled/dark/monotile,/area/template_noop)
"bF" = (/obj/effect/floor_decal/borderfloorblack{dir = 8},/obj/effect/decal/cleanable/dirt,/turf/simulated/floor/tiled/techfloor,/area/template_noop)
"ct" = (/obj/structure/fd/bs_vines,/obj/structure/fd/bs_crystal,/turf/simulated/floor/plating,/area/template_noop)
"dg" = (/obj/effect/floor_decal/corner/black/border{dir = 10},/obj/machinery/light/small,/obj/structure/fd/bs_vines,/turf/simulated/floor/tiled/dark,/area/template_noop)
"dy" = (/obj/effect/floor_decal/corner/blue/border{dir = 10},/turf/simulated/floor/tiled/dark,/area/template_noop)
"el" = (/obj/effect/catwalk_plated/dark,/obj/structure/fd/bs_vines,/obj/structure/fd/bs_spikes,/turf/simulated/floor/plating,/area/template_noop)
"eQ" = (/obj/structure/filingcabinet{pixel_x = 5},/obj/structure/filingcabinet{pixel_x = -5},/obj/structure/noticeboard{dir = 8; pixel_x = 26},/turf/simulated/floor/tiled/dark,/area/template_noop)
"fA" = (/turf/simulated/floor/plating,/area/template_noop)
"fR" = (/obj/effect/catwalk_plated/dark,/obj/structure/table/standard,/obj/item/paper_bin,/obj/item/pen/multi,/obj/effect/decal/cleanable/dirt,/turf/simulated/floor/plating,/area/template_noop)
"hX" = (/obj/effect/catwalk_plated/dark,/obj/structure/table/standard,/obj/item/modular_computer/laptop/preset/custom_loadout/advanced,/turf/simulated/floor/plating,/area/template_noop)
"iG" = (/obj/effect/decal/cleanable/dirt,/turf/simulated/wall/r_wall/invincible,/area/template_noop)
"iO" = (/obj/effect/floor_decal/corner/black/border{dir = 8},/obj/machinery/papershredder,/turf/simulated/floor/tiled/dark,/area/template_noop)
"jm" = (/obj/effect/floor_decal/corner/blue/border{dir = 8},/turf/simulated/floor/tiled/dark,/area/template_noop)
"jY" = (/obj/machinery/vending/cola{dir = 8; pixel_x = 9},/turf/simulated/floor/tiled/dark,/area/template_noop)
"km" = (/obj/structure/fd/bs_vines,/turf/simulated/floor/tiled/dark,/area/template_noop)
"kn" = (/obj/effect/catwalk_plated/dark,/turf/simulated/floor/plating,/area/template_noop)
"kK" = (/obj/effect/catwalk_plated/dark,/obj/effect/decal/cleanable/dirt,/turf/simulated/floor/plating,/area/template_noop)
"lg" = (/obj/effect/floor_decal/corner/black/border{dir = 4},/obj/structure/fd/bs_vines,/turf/simulated/floor/tiled/dark,/area/template_noop)
"mD" = (/obj/effect/floor_decal/corner/black/border,/obj/structure/flora/pottedplant/large{pixel_x = -18; pixel_y = 13},/turf/simulated/floor/tiled/dark,/area/template_noop)
"nh" = (/obj/structure/bed/chair/office/dark,/obj/effect/decal/cleanable/dirt,/obj/effect/decal/cleanable/dirt,/turf/simulated/floor/tiled/dark,/area/template_noop)
"no" = (/obj/effect/floor_decal/corner/blue/border{dir = 4},/turf/simulated/floor/tiled/dark,/area/template_noop)
"oj" = (/obj/effect/floor_decal/corner/black/border{dir = 9},/obj/machinery/light/small{dir = 1},/turf/simulated/floor/tiled/dark,/area/template_noop)
"oy" = (/obj/effect/floor_decal/corner/blue/border{dir = 1},/obj/structure/table/standard,/turf/simulated/floor/tiled/dark,/area/template_noop)
"pA" = (/obj/effect/floor_decal/corner/blue/border{dir = 5},/obj/effect/decal/cleanable/dirt,/turf/simulated/floor/tiled/dark,/area/template_noop)
"pD" = (/obj/effect/floor_decal/corner/blue/border{dir = 8},/obj/structure/extinguisher_cabinet{pixel_y = -30},/turf/simulated/floor/tiled/dark,/area/template_noop)
"qD" = (/obj/structure/filingcabinet{pixel_x = 5},/obj/structure/filingcabinet{pixel_x = -5},/obj/structure/noticeboard{dir = 8; pixel_x = 26},/turf/simulated/floor/plating,/area/template_noop)
"sq" = (/obj/effect/catwalk_plated/dark,/obj/structure/table/standard,/obj/item/paper_bin,/obj/item/pen/multi,/obj/effect/decal/cleanable/dirt,/obj/effect/decal/cleanable/dirt,/turf/simulated/floor/plating,/area/template_noop)
"sH" = (/obj/effect/floor_decal/corner/blue/border{dir = 1},/obj/structure/table/standard,/obj/item/modular_computer/laptop/preset/custom_loadout/advanced,/obj/effect/decal/cleanable/dirt,/turf/simulated/floor/tiled/dark,/area/template_noop)
"tj" = (/obj/structure/fd/bs_vines,/obj/structure/fd/bs_spikes,/obj/effect/decal/cleanable/dirt,/turf/simulated/floor/plating,/area/template_noop)
"tl" = (/obj/structure/fd/bs_vines,/obj/effect/decal/cleanable/dirt,/turf/simulated/floor/plating,/area/template_noop)
"tJ" = (/obj/effect/decal/cleanable/dirt,/turf/simulated/floor/plating,/area/template_noop)
"tT" = (/obj/effect/floor_decal/corner/blue/border,/obj/structure/table/standard,/turf/simulated/floor/tiled/dark,/area/template_noop)
"uq" = (/obj/effect/floor_decal/corner/black/border{dir = 6},/obj/machinery/light/small,/turf/simulated/floor/tiled/dark,/area/template_noop)
"uA" = (/obj/structure/fd/bs_vines,/obj/structure/fd/bs_spikes,/turf/simulated/floor/plating,/area/template_noop)
"uP" = (/obj/structure/filingcabinet{pixel_x = 5},/obj/structure/filingcabinet{pixel_x = -5},/obj/structure/noticeboard{dir = 4; pixel_x = -26},/turf/simulated/floor/tiled/dark,/area/template_noop)
"vC" = (/obj/effect/floor_decal/corner/black/border,/turf/simulated/floor/tiled/dark,/area/template_noop)
"wO" = (/obj/effect/floor_decal/corner/blue/mono,/turf/simulated/floor/tiled/dark/monotile,/area/template_noop)
"xj" = (/turf/template_noop,/area/template_noop)
"xs" = (/obj/effect/floor_decal/corner/blue/border,/obj/structure/table/standard,/obj/item/modular_computer/laptop/preset/custom_loadout/advanced,/turf/simulated/floor/tiled/dark,/area/template_noop)
"zD" = (/obj/effect/floor_decal/borderfloorblack,/obj/structure/fd/bs_vines,/turf/simulated/floor/tiled/techfloor,/area/template_noop)
"zL" = (/obj/effect/floor_decal/borderfloorblack,/obj/machinery/light/small{dir = 1},/turf/simulated/floor/tiled/techfloor,/area/template_noop)
"At" = (/obj/effect/floor_decal/corner/blue/border,/obj/structure/table/standard,/obj/random/junkyard/advdevice,/obj/random/junkyard/bomb_supply,/turf/simulated/floor/tiled/dark,/area/template_noop)
"AF" = (/obj/effect/floor_decal/corner/black/border{dir = 1},/obj/structure/table,/obj/effect/decal/cleanable/dirt,/obj/effect/decal/cleanable/dirt,/turf/simulated/floor/tiled/dark,/area/template_noop)
"AI" = (/obj/effect/catwalk_plated/dark,/obj/structure/table,/turf/simulated/floor/plating,/area/template_noop)
"BH" = (/obj/structure/bed/chair/office/dark{dir = 1},/obj/machinery/light,/turf/simulated/floor/tiled/dark,/area/template_noop)
"BK" = (/obj/structure/filingcabinet{pixel_x = 5},/obj/structure/filingcabinet{pixel_x = -5},/turf/simulated/floor/tiled/dark,/area/template_noop)
"Ce" = (/obj/effect/floor_decal/corner/black/border{dir = 1},/obj/structure/table/reinforced,/obj/effect/decal/cleanable/dirt,/obj/effect/decal/cleanable/dirt,/obj/random/junkyard/smokes,/turf/simulated/floor/tiled/dark,/area/template_noop)
"CO" = (/obj/structure/bed/chair/office/dark{dir = 1},/turf/simulated/floor/tiled/dark,/area/template_noop)
"DD" = (/obj/effect/floor_decal/corner/blue/mono,/obj/machinery/door/airlock/glass/command,/turf/simulated/floor/tiled/dark/monotile,/area/template_noop)
"DH" = (/obj/effect/floor_decal/corner/blue/mono,/obj/effect/wallframe_spawn/no_grille,/obj/effect/decal/cleanable/dirt,/turf/simulated/floor/tiled/dark/monotile,/area/template_noop)
"DO" = (/obj/effect/floor_decal/corner/blue/border{dir = 1},/obj/structure/table/standard,/obj/item/paper_bin,/obj/item/pen/multi,/turf/simulated/floor/tiled/dark,/area/template_noop)
"Eo" = (/obj/effect/floor_decal/corner/blue/mono,/obj/machinery/door/airlock/glass/command,/obj/effect/decal/cleanable/dirt,/turf/simulated/floor/tiled/dark/monotile,/area/template_noop)
"FU" = (/obj/effect/floor_decal/corner/blue/border,/obj/structure/table/standard,/obj/item/paper_bin,/obj/item/pen/multi,/obj/effect/decal/cleanable/dirt,/turf/simulated/floor/tiled/dark,/area/template_noop)
"Gw" = (/obj/effect/floor_decal/corner/blue/border{dir = 4},/obj/structure/extinguisher_cabinet{pixel_y = -30},/turf/simulated/floor/tiled/dark,/area/template_noop)
"GG" = (/obj/structure/bed/chair/office/dark,/obj/effect/decal/cleanable/dirt,/turf/simulated/floor/tiled/dark,/area/template_noop)
"GV" = (/obj/effect/floor_decal/corner/blue/border{dir = 6},/turf/simulated/floor/tiled/dark,/area/template_noop)
"Hh" = (/obj/effect/floor_decal/corner/blue/border,/obj/structure/table/standard,/obj/item/modular_computer/laptop/preset/custom_loadout/advanced,/obj/effect/decal/cleanable/dirt,/turf/simulated/floor/tiled/dark,/area/template_noop)
"Hi" = (/obj/effect/catwalk_plated/dark,/obj/structure/fd/bs_vines,/obj/effect/decal/cleanable/dirt,/obj/effect/decal/cleanable/dirt,/turf/simulated/floor/plating,/area/template_noop)
"HO" = (/obj/effect/floor_decal/corner/black/border{dir = 4},/obj/effect/decal/cleanable/dirt,/turf/simulated/floor/tiled/dark,/area/template_noop)
"HR" = (/obj/effect/floor_decal/corner/blue/border,/obj/structure/table,/obj/effect/decal/cleanable/dirt,/turf/simulated/floor/tiled/dark,/area/template_noop)
"IF" = (/obj/effect/floor_decal/corner/black/border,/obj/structure/fd/bs_vines,/turf/simulated/floor/tiled/dark,/area/template_noop)
"IM" = (/obj/effect/floor_decal/corner/blue/mono,/obj/structure/fd/bs_vines,/turf/simulated/floor/tiled/dark/monotile,/area/template_noop)
"Jf" = (/obj/effect/decal/cleanable/dirt,/turf/simulated/floor/tiled/dark,/area/template_noop)
"MJ" = (/obj/effect/floor_decal/corner/blue/border{dir = 4},/obj/effect/decal/cleanable/dirt,/turf/simulated/floor/tiled/dark,/area/template_noop)
"MX" = (/obj/effect/catwalk_plated/dark,/obj/structure/table/standard,/obj/item/paper_bin,/obj/item/pen/multi,/turf/simulated/floor/plating,/area/template_noop)
"NX" = (/obj/structure/table/standard,/obj/random/relic,/turf/simulated/floor/tiled/dark,/area/template_noop)
"Oq" = (/turf/simulated/floor/tiled/dark,/area/template_noop)
"Ou" = (/obj/effect/floor_decal/borderfloorblack{dir = 1},/obj/machinery/light/small,/obj/effect/decal/cleanable/dirt,/turf/simulated/floor/tiled/techfloor,/area/template_noop)
"OZ" = (/obj/structure/table/standard,/turf/simulated/floor/tiled/dark,/area/template_noop)
"Pq" = (/obj/structure/bed/chair/office/dark,/obj/machinery/light{dir = 1},/turf/simulated/floor/tiled/dark,/area/template_noop)
"Pw" = (/obj/machinery/vending/coffee{density = 0; pixel_y = 19},/obj/effect/decal/cleanable/dirt,/turf/simulated/floor/tiled/dark,/area/template_noop)
"PK" = (/obj/effect/floor_decal/borderfloorblack{dir = 8},/obj/machinery/light/small{dir = 4},/turf/simulated/floor/tiled/techfloor,/area/template_noop)
"Qa" = (/obj/effect/floor_decal/corner/black/border{dir = 1},/obj/effect/decal/cleanable/dirt,/obj/effect/decal/cleanable/dirt,/turf/simulated/floor/tiled/dark,/area/template_noop)
"Qh" = (/obj/structure/filingcabinet{pixel_x = -5},/obj/structure/filingcabinet{pixel_x = 5},/turf/simulated/floor/tiled/dark,/area/template_noop)
"Rf" = (/obj/effect/floor_decal/borderfloorblack{dir = 4},/obj/machinery/light/small{dir = 8},/obj/structure/fd/bs_vines,/turf/simulated/floor/tiled/techfloor,/area/template_noop)
"RR" = (/obj/effect/floor_decal/corner/black/border{dir = 1},/turf/simulated/floor/tiled/dark,/area/template_noop)
"SD" = (/obj/effect/floor_decal/corner/blue/border{dir = 1},/obj/structure/table/standard,/obj/item/modular_computer/laptop/preset/custom_loadout/advanced,/turf/simulated/floor/tiled/dark,/area/template_noop)
"Ue" = (/obj/effect/floor_decal/corner/black/border{dir = 9},/turf/simulated/floor/tiled/dark,/area/template_noop)
"UN" = (/obj/effect/floor_decal/corner/blue/border{dir = 4},/obj/structure/extinguisher_cabinet{pixel_y = 29},/obj/effect/decal/cleanable/dirt,/turf/simulated/floor/tiled/dark,/area/template_noop)
"Ve" = (/obj/effect/floor_decal/corner/black/border{dir = 8},/obj/structure/table/reinforced,/obj/machinery/photocopier/faxmachine,/turf/simulated/floor/tiled/dark,/area/template_noop)
"Vo" = (/obj/effect/floor_decal/borderfloorblack{dir = 8},/obj/machinery/light/small{dir = 4},/obj/structure/fd/bs_vines,/obj/effect/decal/cleanable/dirt,/turf/simulated/floor/tiled/techfloor,/area/template_noop)
"VA" = (/obj/effect/floor_decal/borderfloorblack{dir = 4},/turf/simulated/floor/tiled/techfloor,/area/template_noop)
"Wd" = (/turf/simulated/wall/r_wall/invincible,/area/template_noop)
"Wx" = (/obj/effect/floor_decal/corner/black/border{dir = 5},/obj/machinery/light/small{dir = 1},/obj/structure/fd/bs_vines,/obj/effect/decal/cleanable/dirt,/turf/simulated/floor/tiled/dark,/area/template_noop)
"WD" = (/obj/effect/floor_decal/corner/black/border{dir = 5},/obj/structure/fd/bs_vines,/obj/effect/decal/cleanable/dirt,/turf/simulated/floor/tiled/dark,/area/template_noop)
"WE" = (/obj/effect/floor_decal/corner/blue/mono,/obj/effect/wallframe_spawn/no_grille,/obj/effect/decal/cleanable/dirt,/obj/effect/decal/cleanable/dirt,/turf/simulated/floor/tiled/dark/monotile,/area/template_noop)
"WN" = (/obj/effect/floor_decal/corner/black/border{dir = 8},/turf/simulated/floor/tiled/dark,/area/template_noop)
"Xd" = (/obj/effect/floor_decal/corner/black/border{dir = 4},/turf/simulated/floor/tiled/dark,/area/template_noop)
"Xh" = (/obj/effect/floor_decal/corner/black/border{dir = 1},/obj/effect/decal/cleanable/dirt,/turf/simulated/floor/tiled/dark,/area/template_noop)
"Xw" = (/obj/effect/floor_decal/corner/blue/border{dir = 8},/obj/structure/extinguisher_cabinet{pixel_y = 29},/turf/simulated/floor/tiled/dark,/area/template_noop)
"Yc" = (/obj/effect/floor_decal/corner/black/border{dir = 6},/turf/simulated/floor/tiled/dark,/area/template_noop)
"ZA" = (/obj/effect/floor_decal/borderfloorblack{dir = 1},/obj/machinery/light/small,/turf/simulated/floor/tiled/techfloor,/area/template_noop)
"ZQ" = (/obj/effect/catwalk_plated/dark,/obj/structure/fd/bs_vines,/obj/effect/decal/cleanable/dirt,/turf/simulated/floor/plating,/area/template_noop)

(1,1,1) = {"
xjxjxjxjxjxjxjxjxjxjxjxjxjxjxj
xjQhPqfAUNuAzLzDzLbhXwOqPqBKxj
xjOZhXsqnotlOqfAXdbhjmMXhXOZxj
xjuPGGJfahtlahahlgbhjmJfnheQxj
xjAtxsHRGVwOctZQXdbhdyFUHhtTxj
xjDHDHtJIMWdaeIFYcWdEoWEDHbhxj
xjRfRRRRXhWxOqOqJfojQaAFCePKxj
xjVAelknknXdjYWdOqWNHikKkKbFxj
xjRfIFIFvCuqOqPwOqdgtjmDvCVoxj
xjbhbhbhDDWdUeQaWDiGfAfAbhbhxj
xjoySDDOpADHVeknXdctahDOsHoyxj
xjuPCOJfnobhiOknXduAfAOqCOqDxj
xjOZhXfRMJDHWNkKHObhjmtJAINXxj
xjBKBHOqGwbhZAaROubhpDkmBHBKxj
xjxjxjxjxjxjxjxjxjxjxjxjxjxjxj
"}
