"bb" = (/obj/effect/floor_decal/corner/black/border{dir = 8},/obj/structure/fd/bs_vines,/obj/structure/fd/bs_crystal,/turf/simulated/floor/tiled/dark,/area/template_noop)
"bS" = (/obj/effect/floor_decal/corner/black/border{dir = 8},/obj/effect/floor_decal/corner/black/border{dir = 4},/obj/structure/table/standard,/obj/machinery/photocopier/faxmachine,/turf/simulated/floor/tiled/dark,/area/template_noop)
"cx" = (/obj/effect/floor_decal/corner/black/mono,/obj/structure/fd/bs_vines,/turf/simulated/floor/tiled/dark/monotile,/area/template_noop)
"cR" = (/obj/effect/floor_decal/corner/black/border{dir = 8},/obj/structure/table/standard,/obj/structure/fd/bs_vines,/turf/simulated/floor/tiled/dark/monotile,/area/template_noop)
"dv" = (/obj/effect/floor_decal/corner/black/border,/obj/structure/fd/bs_vines,/turf/simulated/floor/tiled/dark/monotile,/area/template_noop)
"eG" = (/obj/structure/table,/turf/simulated/floor/plating,/area/template_noop)
"fO" = (/obj/structure/bed/chair/office/dark{dir = 4},/turf/simulated/floor/tiled/dark,/area/template_noop)
"gt" = (/obj/effect/floor_decal/corner/black/mono,/obj/effect/decal/cleanable/dirt,/turf/simulated/floor/tiled/dark/monotile,/area/template_noop)
"hQ" = (/obj/effect/floor_decal/corner/black/border{dir = 9},/obj/effect/decal/cleanable/dirt,/turf/simulated/floor/tiled/dark,/area/template_noop)
"ic" = (/obj/machinery/door/airlock/glass/command,/turf/simulated/floor/tiled/dark/monotile,/area/template_noop)
"jx" = (/obj/effect/floor_decal/corner/black/border{dir = 1},/obj/structure/extinguisher_cabinet{pixel_y = -29},/turf/simulated/floor/tiled/dark/monotile,/area/template_noop)
"kp" = (/obj/effect/floor_decal/corner/black/border{dir = 10},/obj/structure/fd/bs_vines,/obj/effect/decal/cleanable/dirt,/obj/effect/decal/cleanable/dirt,/turf/simulated/floor/tiled/dark/monotile,/area/template_noop)
"kq" = (/obj/effect/floor_decal/corner/black/border{dir = 1},/obj/structure/table/standard,/obj/random/junkyard/advdevice,/turf/simulated/floor/tiled/dark,/area/template_noop)
"lo" = (/obj/effect/floor_decal/corner/black/border{dir = 6},/obj/structure/bed/chair/office/dark{dir = 4},/turf/simulated/floor/tiled/dark,/area/template_noop)
"lw" = (/turf/simulated/wall/r_wall/invincible,/area/template_noop)
"lG" = (/turf/template_noop,/area/template_noop)
"mx" = (/obj/machinery/light/small{dir = 4},/turf/simulated/floor/plating,/area/template_noop)
"mD" = (/obj/structure/fd/bs_vines,/obj/structure/fd/bs_spikes,/turf/simulated/floor/tiled/dark,/area/template_noop)
"nJ" = (/turf/simulated/floor/tiled/dark,/area/template_noop)
"pa" = (/obj/effect/catwalk_plated/dark,/obj/structure/bed/chair/office/dark{dir = 8},/obj/effect/decal/cleanable/dirt,/turf/simulated/floor/plating,/area/template_noop)
"pu" = (/obj/structure/fd/bs_vines,/obj/effect/decal/cleanable/dirt,/turf/simulated/floor/plating,/area/template_noop)
"qq" = (/obj/effect/floor_decal/corner/black/border{dir = 9},/obj/structure/fd/bs_vines,/turf/simulated/floor/tiled/dark/monotile,/area/template_noop)
"rK" = (/obj/effect/floor_decal/corner/black/mono,/obj/machinery/papershredder{pixel_y = 10},/turf/simulated/floor/tiled/dark/monotile,/area/template_noop)
"rR" = (/obj/machinery/disposal,/turf/simulated/floor/tiled/dark/monotile,/area/template_noop)
"se" = (/obj/random/junkyard/toolbox,/turf/simulated/floor/tiled/dark/monotile,/area/template_noop)
"sg" = (/obj/structure/fd/bs_vines,/turf/simulated/floor/tiled/dark/monotile,/area/template_noop)
"sl" = (/obj/effect/floor_decal/corner/black/border{dir = 1},/obj/effect/decal/cleanable/dirt,/turf/simulated/floor/tiled/dark,/area/template_noop)
"sI" = (/obj/effect/decal/cleanable/dirt,/turf/simulated/floor/tiled/dark/monotile,/area/template_noop)
"ti" = (/obj/effect/floor_decal/corner/black/mono,/obj/machinery/photocopier,/turf/simulated/floor/tiled/dark/monotile,/area/template_noop)
"tB" = (/obj/structure/fd/bs_vines,/obj/random/relic,/turf/simulated/floor/tiled/dark,/area/template_noop)
"uf" = (/obj/structure/filingcabinet/chestdrawer,/turf/simulated/floor/tiled/dark,/area/template_noop)
"uM" = (/obj/effect/floor_decal/corner/black/border{dir = 1},/turf/simulated/floor/tiled/dark,/area/template_noop)
"uS" = (/obj/effect/floor_decal/corner/black/bordercorner{dir = 8},/turf/simulated/floor/tiled/dark/monotile,/area/template_noop)
"uY" = (/obj/effect/floor_decal/corner/black/border{dir = 8},/turf/simulated/floor/tiled/dark/monotile,/area/template_noop)
"vp" = (/obj/effect/catwalk_plated/dark,/obj/structure/table/standard,/turf/simulated/floor/plating,/area/template_noop)
"vR" = (/obj/machinery/light/small,/obj/structure/fd/bs_vines,/turf/simulated/floor/plating,/area/template_noop)
"xm" = (/obj/structure/table/standard,/turf/simulated/floor/tiled/dark,/area/template_noop)
"yn" = (/obj/effect/floor_decal/corner/black/border{dir = 8},/obj/structure/table/standard,/obj/item/paper_bin,/obj/item/pen/multi,/turf/simulated/floor/tiled/dark,/area/template_noop)
"yp" = (/obj/effect/floor_decal/corner/black/border{dir = 4},/obj/machinery/light/small{dir = 1},/turf/simulated/floor/tiled/dark/monotile,/area/template_noop)
"yQ" = (/obj/effect/floor_decal/corner/black/border{dir = 1},/obj/structure/table/standard,/obj/item/paper_bin,/obj/item/pen/multi,/turf/simulated/floor/tiled/dark,/area/template_noop)
"zb" = (/obj/effect/catwalk_plated/dark,/turf/simulated/floor/plating,/area/template_noop)
"zx" = (/obj/effect/floor_decal/corner/black/border{dir = 5},/obj/effect/decal/cleanable/dirt,/turf/simulated/floor/tiled/dark,/area/template_noop)
"zP" = (/obj/effect/floor_decal/corner/black/border{dir = 1},/obj/structure/fd/bs_vines,/turf/simulated/floor/tiled/dark,/area/template_noop)
"Af" = (/obj/effect/floor_decal/corner/black/border,/obj/structure/noticeboard{pixel_y = 24},/turf/simulated/floor/tiled/dark,/area/template_noop)
"BK" = (/obj/structure/table/glass,/obj/item/paper_bin,/obj/item/pen/multi,/obj/machinery/light/small,/turf/simulated/floor/tiled/dark/monotile,/area/template_noop)
"Cf" = (/obj/effect/floor_decal/corner/black/border{dir = 8},/obj/structure/fd/bs_vines,/turf/simulated/floor/tiled/dark,/area/template_noop)
"CL" = (/obj/structure/filingcabinet/filingcabinet{pixel_x = 12},/obj/machinery/papershredder{pixel_x = -3; pixel_y = 2},/turf/simulated/floor/tiled/dark,/area/template_noop)
"DU" = (/obj/effect/floor_decal/corner/black/border{dir = 4},/obj/structure/filingcabinet{pixel_x = -5},/obj/structure/filingcabinet{pixel_x = 5},/turf/simulated/floor/tiled/dark,/area/template_noop)
"Er" = (/obj/effect/floor_decal/corner/black/border{dir = 9},/turf/simulated/floor/tiled/dark,/area/template_noop)
"FE" = (/obj/structure/table,/turf/simulated/floor/tiled/dark,/area/template_noop)
"Gs" = (/obj/effect/catwalk_plated/dark,/obj/structure/fd/bs_vines,/obj/structure/fd/bs_spikes,/turf/simulated/floor/plating,/area/template_noop)
"GM" = (/obj/structure/noticeboard{dir = 4; pixel_x = -26},/turf/simulated/floor/plating,/area/template_noop)
"GR" = (/turf/simulated/floor/plating,/area/template_noop)
"Il" = (/obj/effect/decal/cleanable/dirt,/turf/simulated/floor/plating,/area/template_noop)
"Jw" = (/obj/effect/floor_decal/corner/black/border{dir = 1},/obj/structure/fd/bs_vines,/obj/structure/fd/bs_spikes,/turf/simulated/floor/tiled/dark/monotile,/area/template_noop)
"Kg" = (/obj/effect/floor_decal/corner/black/border,/turf/simulated/floor/tiled/dark,/area/template_noop)
"Kr" = (/obj/effect/floor_decal/corner/black/border{dir = 1},/obj/structure/table/standard,/turf/simulated/floor/tiled/dark,/area/template_noop)
"Ks" = (/obj/effect/floor_decal/corner/black/border{dir = 10},/turf/simulated/floor/tiled/dark,/area/template_noop)
"KO" = (/obj/effect/floor_decal/corner/black/border{dir = 8},/obj/structure/noticeboard{dir = 8; pixel_x = 26},/obj/effect/decal/cleanable/dirt,/turf/simulated/floor/tiled/dark,/area/template_noop)
"KY" = (/obj/machinery/light{dir = 8},/obj/structure/reagent_dispensers/water_cooler{dir = 4},/turf/simulated/floor/tiled/dark/monotile,/area/template_noop)
"Lz" = (/obj/structure/fd/bs_vines,/turf/simulated/floor/plating,/area/template_noop)
"LC" = (/turf/simulated/floor/tiled/dark/monotile,/area/template_noop)
"Mb" = (/obj/effect/floor_decal/corner/black/border{dir = 1},/obj/machinery/light/small,/turf/simulated/floor/tiled/dark,/area/template_noop)
"Mg" = (/obj/effect/floor_decal/corner/black/border{dir = 10},/obj/structure/table/standard,/obj/random/junkyard/bomb_supply,/obj/random/junkyard/tech_supply,/turf/simulated/floor/tiled/dark,/area/template_noop)
"Mj" = (/obj/structure/table/standard,/obj/item/modular_computer/laptop/preset/custom_loadout/advanced,/turf/simulated/floor/tiled/dark,/area/template_noop)
"MG" = (/obj/effect/floor_decal/corner/black/border,/obj/machinery/light{dir = 1},/turf/simulated/floor/tiled/dark/monotile,/area/template_noop)
"Np" = (/obj/effect/floor_decal/corner/black/border{dir = 4},/obj/structure/fd/bs_vines,/obj/structure/fd/bs_crystal,/turf/simulated/floor/tiled/dark,/area/template_noop)
"NN" = (/obj/effect/floor_decal/corner/black/mono,/obj/structure/table/standard,/turf/simulated/floor/tiled/dark/monotile,/area/template_noop)
"OS" = (/obj/effect/floor_decal/corner/black/border{dir = 1},/obj/structure/bed/chair/padded/black{dir = 1},/turf/simulated/floor/tiled/dark,/area/template_noop)
"PH" = (/obj/effect/floor_decal/corner/black/border{dir = 4},/turf/simulated/floor/tiled/dark/monotile,/area/template_noop)
"QF" = (/obj/effect/floor_decal/corner/black/bordercorner{dir = 1},/obj/structure/filingcabinet{pixel_x = -5},/obj/structure/filingcabinet{pixel_x = 5},/turf/simulated/floor/tiled/dark/monotile,/area/template_noop)
"QM" = (/obj/effect/floor_decal/corner/black/border{dir = 8},/turf/simulated/floor/tiled/dark,/area/template_noop)
"QO" = (/obj/effect/floor_decal/corner/black/border{dir = 9},/obj/structure/table,/turf/simulated/floor/tiled/dark,/area/template_noop)
"Rp" = (/obj/effect/floor_decal/corner/black/border{dir = 6},/obj/effect/decal/cleanable/dirt,/turf/simulated/floor/tiled/dark,/area/template_noop)
"Rr" = (/obj/effect/floor_decal/corner/black/mono,/obj/structure/table/standard,/obj/structure/fd/bs_vines,/turf/simulated/floor/tiled/dark/monotile,/area/template_noop)
"Rz" = (/obj/machinery/photocopier{pixel_x = 11},/turf/simulated/floor/tiled/dark,/area/template_noop)
"RB" = (/obj/effect/floor_decal/corner/black/border{dir = 4},/obj/effect/floor_decal/corner/black/border{dir = 8},/obj/structure/table/standard,/turf/simulated/floor/tiled/dark,/area/template_noop)
"RU" = (/obj/effect/floor_decal/corner/black/border{dir = 8},/obj/structure/noticeboard{dir = 8; pixel_x = 26},/turf/simulated/floor/tiled/dark,/area/template_noop)
"Th" = (/obj/structure/fd/bs_vines,/obj/structure/fd/bs_spikes,/turf/simulated/floor/plating,/area/template_noop)
"TD" = (/obj/structure/bed/chair/padded/black{dir = 8},/obj/effect/decal/cleanable/dirt,/turf/simulated/floor/tiled/dark/monotile,/area/template_noop)
"TM" = (/obj/effect/floor_decal/corner/black/border{dir = 8},/obj/effect/floor_decal/corner/black/border{dir = 4},/obj/structure/table/standard,/obj/item/modular_computer/laptop/preset/custom_loadout/advanced,/turf/simulated/floor/tiled/dark,/area/template_noop)
"TT" = (/obj/machinery/light{dir = 8},/obj/machinery/libraryscanner,/obj/structure/holoplant{pixel_y = 12},/turf/simulated/floor/tiled/dark/monotile,/area/template_noop)
"TV" = (/obj/effect/floor_decal/corner/black/border,/obj/machinery/light{dir = 1},/turf/simulated/floor/tiled/dark,/area/template_noop)
"Ve" = (/obj/effect/floor_decal/corner/black/border,/obj/machinery/light{dir = 8},/obj/structure/fd/bs_vines,/turf/simulated/floor/tiled/dark,/area/template_noop)
"Wd" = (/obj/structure/fd/bs_vines,/obj/structure/fd/bs_spikes,/obj/effect/decal/cleanable/dirt,/turf/simulated/floor/plating,/area/template_noop)
"WB" = (/obj/effect/floor_decal/corner/black/border{dir = 4},/obj/effect/floor_decal/corner/black/border{dir = 8},/obj/structure/table/standard,/obj/item/modular_computer/laptop/preset/custom_loadout/advanced,/turf/simulated/floor/tiled/dark,/area/template_noop)
"Ym" = (/obj/effect/floor_decal/corner/black/mono,/turf/simulated/floor/tiled/dark/monotile,/area/template_noop)
"YB" = (/obj/effect/floor_decal/corner/black/border{dir = 10},/obj/effect/decal/cleanable/dirt,/turf/simulated/floor/tiled/dark,/area/template_noop)
"YG" = (/obj/effect/wallframe_spawn/no_grille,/turf/simulated/floor/plating,/area/template_noop)
"YS" = (/obj/effect/catwalk_plated/dark,/obj/structure/bed/chair/office/dark{dir = 8},/turf/simulated/floor/plating,/area/template_noop)
"Zc" = (/obj/effect/floor_decal/corner/black/border{dir = 4},/obj/effect/floor_decal/corner/black/border{dir = 8},/turf/simulated/floor/tiled/dark,/area/template_noop)
"Zp" = (/obj/effect/floor_decal/corner/black/border{dir = 5},/obj/structure/table/standard,/obj/item/paper_bin,/obj/item/pen/multi,/obj/structure/fd/bs_vines,/turf/simulated/floor/tiled/dark,/area/template_noop)
"Zq" = (/obj/effect/floor_decal/corner/black/border,/obj/structure/extinguisher_cabinet{pixel_y = 29},/turf/simulated/floor/tiled/dark,/area/template_noop)
"ZP" = (/obj/effect/floor_decal/corner/black/border{dir = 5},/obj/structure/filingcabinet/chestdrawer,/obj/machinery/light,/turf/simulated/floor/tiled/dark/monotile,/area/template_noop)

(1,1,1) = {"
lGlGlGlGlGlGlGlGlGlGlGlGlGlGlG
lGYmNpAfZqKgTVKgQMgtseynRzuflG
lGuMZpRrmDxmFEtihQuMLCWBpaKOlG
lGVeloNNnJnJMjrKYBKgsgRBvpQMlG
lGYmDUkquMzPyQuMCfYmThKsKgKglG
lGlwYGYGYGYGlwiclwLzlwTTsIsIlG
lGypKgKgKgIlZqKgLzLzLzQOuMzxlG
lGPHzbIlGRgtgtGsGRGRYGGRzbZclG
lGGRuMIlMbOSOSOSuMvRYGMgKgRplG
lGLCTDlwlwYGYGYGYGlwlwKYsIsIlG
lGGRmxlwdvGRKgGRkpMGuSErsluMlG
lGnJGRicnJeGWdcxQMnJcRbSvpQMlG
lGKgGRlwGMfOpuIlbbtBuYTMYSRUlG
lGrRBKlwjxZPKrGRqqJwQFynCLnJlG
lGlGlGlGlGlGlGlGlGlGlGlGlGlGlG
"}
