//MAP CONVERTED BY dmm2tgm.py THIS HEADER COMMENT PREVENTS RECONVERSION, DO NOT REMOVE
"a" = (
/obj/effect/landmark/damager,
/obj/effect/paint/black,
/turf/simulated/wall/alium,
/area/template_noop)
"b" = (
/obj/effect/decal/cleanable/dirt,
/obj/effect/decal/cleanable/dirt,
/turf/simulated/floor/fixed/alium{
	icon = 'icons/turf/flooring/tiles.dmi';
	icon_state = "stone";
	color = "#445933"
	},
/area/template_noop)
"c" = (
/obj/effect/landmark/scorcher,
/turf/simulated/floor/fixed/alium{
	icon = 'icons/turf/flooring/tiles.dmi';
	icon_state = "stone";
	color = "#445933"
	},
/area/template_noop)
"d" = (
/obj/effect/landmark/damager,
/turf/simulated/wall/sandstone,
/area/template_noop)
"e" = (
/obj/machinery/artifact,
/obj/effect/razorweb/mapped{
	alpha = 200
	},
/turf/simulated/floor/fixed/alium,
/area/template_noop)
"g" = (
/obj/effect/paint/black,
/turf/simulated/wall/uranium,
/area/template_noop)
"h" = (
/obj/random/loot,
/turf/simulated/floor/fixed/alium{
	icon = 'icons/turf/flooring/tiles.dmi';
	icon_state = "stone";
	color = "#445933"
	},
/area/template_noop)
"i" = (
/obj/item/remains/xeno,
/obj/effect/razorweb/mapped{
	alpha = 200
	},
/turf/simulated/floor/fixed/alium,
/area/template_noop)
"k" = (
/obj/effect/reactor_radiate{
	radiation_power = 110;
	req_range = 7
	},
/turf/simulated/wall/sandstonediamond,
/area/template_noop)
"n" = (
/obj/effect/decal/cleanable/dirt,
/obj/item/stack/material/rods,
/turf/template_noop,
/area/template_noop)
"o" = (
/obj/effect/decal/cleanable/dirt,
/turf/simulated/floor/fixed/alium{
	icon = 'icons/turf/flooring/tiles.dmi';
	icon_state = "stone";
	color = "#445933"
	},
/area/template_noop)
"p" = (
/obj/effect/paint/red,
/obj/effect/paint_stripe/blue,
/turf/simulated/wall/uranium,
/area/template_noop)
"q" = (
/obj/item/remains/xeno,
/obj/effect/decal/cleanable/dirt,
/turf/simulated/floor/fixed/alium{
	icon = 'icons/turf/flooring/tiles.dmi';
	icon_state = "stone";
	color = "#445933"
	},
/area/template_noop)
"r" = (
/obj/effect/decal/cleanable/dirt,
/obj/item/nullrod,
/obj/structure/table/glass/pglass,
/turf/simulated/floor/fixed/alium{
	icon = 'icons/turf/flooring/tiles.dmi';
	icon_state = "stone";
	color = "#445933"
	},
/area/template_noop)
"t" = (
/obj/effect/landmark/exoplanet_spawn/plant,
/turf/template_noop,
/area/template_noop)
"u" = (
/obj/effect/decal/cleanable/dirt,
/obj/random/loot,
/turf/simulated/floor/fixed/alium{
	icon = 'icons/turf/flooring/tiles.dmi';
	icon_state = "stone";
	color = "#445933"
	},
/area/template_noop)
"v" = (
/obj/effect/razorweb/mapped{
	alpha = 200
	},
/turf/simulated/floor/fixed/alium,
/area/template_noop)
"w" = (
/obj/effect/landmark/exoplanet_spawn/plant,
/obj/item/stack/material/rods,
/turf/template_noop,
/area/template_noop)
"y" = (
/turf/unsimulated/floor/exoplanet/water/shallow,
/area/template_noop)
"A" = (
/obj/effect/decal/cleanable/cobweb,
/obj/item/remains/xeno,
/obj/effect/razorweb/mapped{
	alpha = 200
	},
/turf/simulated/floor/fixed/alium,
/area/template_noop)
"C" = (
/obj/random/loot,
/turf/template_noop,
/area/template_noop)
"D" = (
/obj/effect/landmark/exoplanet_spawn/plant,
/obj/effect/decal/cleanable/dirt,
/obj/item/stack/material/rods,
/turf/template_noop,
/area/template_noop)
"E" = (
/obj/item/arrow,
/turf/simulated/floor/fixed/alium{
	icon = 'icons/turf/flooring/tiles.dmi';
	icon_state = "stone";
	color = "#445933"
	},
/area/template_noop)
"F" = (
/turf/simulated/wall/sandstone,
/area/template_noop)
"G" = (
/obj/machinery/door/unpowered/simple/uranium,
/turf/simulated/floor/fixed/alium,
/area/template_noop)
"H" = (
/obj/effect/landmark/scorcher,
/obj/effect/decal/cleanable/dirt,
/turf/template_noop,
/area/template_noop)
"K" = (
/obj/effect/landmark/exoplanet_spawn/plant,
/obj/effect/decal/cleanable/dirt,
/turf/template_noop,
/area/template_noop)
"L" = (
/turf/simulated/floor/fixed/alium{
	icon = 'icons/turf/flooring/tiles.dmi';
	icon_state = "stone";
	color = "#445933"
	},
/area/template_noop)
"M" = (
/obj/item/remains/xeno,
/obj/effect/decal/cleanable/dirt,
/turf/template_noop,
/area/template_noop)
"N" = (
/obj/effect/landmark/scorcher,
/obj/effect/decal/cleanable/dirt,
/turf/simulated/floor/fixed/alium{
	icon = 'icons/turf/flooring/tiles.dmi';
	icon_state = "stone";
	color = "#445933"
	},
/area/template_noop)
"O" = (
/obj/effect/decal/cleanable/dirt,
/turf/template_noop,
/area/template_noop)
"Q" = (
/obj/effect/paint/red,
/obj/effect/paint_stripe/blue,
/turf/simulated/wall/alium,
/area/template_noop)
"S" = (
/turf/template_noop,
/area/template_noop)
"T" = (
/obj/item/arrow,
/obj/effect/decal/cleanable/dirt,
/turf/simulated/floor/fixed/alium{
	icon = 'icons/turf/flooring/tiles.dmi';
	icon_state = "stone";
	color = "#445933"
	},
/area/template_noop)
"U" = (
/obj/effect/paint/black,
/turf/simulated/wall/alium,
/area/template_noop)
"V" = (
/turf/simulated/floor/fixed/alium,
/area/template_noop)
"W" = (
/obj/effect/decal/cleanable/dirt,
/obj/structure/table/glass/pglass,
/turf/simulated/floor/fixed/alium{
	icon = 'icons/turf/flooring/tiles.dmi';
	icon_state = "stone";
	color = "#445933"
	},
/area/template_noop)
"X" = (
/obj/effect/landmark/damager,
/obj/effect/paint/black,
/turf/simulated/wall/uranium,
/area/template_noop)
"Y" = (
/obj/effect/landmark/scorcher,
/obj/effect/decal/cleanable/dirt,
/obj/item/stack/material/rods,
/turf/simulated/floor/fixed/alium{
	icon = 'icons/turf/flooring/tiles.dmi';
	icon_state = "stone";
	color = "#445933"
	},
/area/template_noop)
"Z" = (
/obj/item/remains/xeno,
/turf/template_noop,
/area/template_noop)

(1,1,1) = {"
S
S
d
F
F
F
d
d
d
S
F
d
d
d
F
d
d
S
S
"}
(2,1,1) = {"
S
d
d
C
D
c
V
S
F
H
F
O
V
o
L
o
d
d
S
"}
(3,1,1) = {"
F
F
t
O
Y
D
U
O
F
O
F
O
U
q
o
T
u
d
F
"}
(4,1,1) = {"
F
w
N
K
K
S
U
O
O
O
O
O
U
L
L
b
o
L
F
"}
(5,1,1) = {"
d
M
D
n
g
U
U
U
U
g
a
a
U
G
g
W
o
o
F
"}
(6,1,1) = {"
d
K
N
K
G
o
b
b
b
o
L
L
L
o
U
W
E
N
d
"}
(7,1,1) = {"
d
V
U
a
a
o
p
Q
Q
G
Q
Q
p
L
U
U
U
V
d
"}
(8,1,1) = {"
F
n
O
S
a
o
Q
A
y
y
y
v
Q
o
a
O
O
O
d
"}
(9,1,1) = {"
F
F
F
O
a
o
Q
y
y
e
y
y
Q
o
a
O
F
F
d
"}
(10,1,1) = {"
S
O
S
O
g
L
G
y
e
k
e
y
G
L
X
S
O
S
S
"}
(11,1,1) = {"
F
F
F
O
U
L
Q
y
y
e
y
y
Q
L
U
S
F
F
d
"}
(12,1,1) = {"
F
S
S
S
a
o
Q
v
y
y
y
i
Q
L
U
O
O
S
F
"}
(13,1,1) = {"
F
V
U
U
a
L
p
Q
Q
G
Q
Q
p
o
U
U
U
V
F
"}
(14,1,1) = {"
d
o
o
W
U
L
o
o
L
L
o
o
L
o
G
L
N
o
F
"}
(15,1,1) = {"
d
o
o
W
g
G
U
U
U
g
U
U
U
U
g
o
o
L
F
"}
(16,1,1) = {"
d
h
o
N
L
o
U
O
O
O
Z
O
U
u
N
o
o
q
d
"}
(17,1,1) = {"
F
F
o
o
o
o
U
S
F
O
F
O
U
o
o
W
r
d
d
"}
(18,1,1) = {"
S
d
d
L
o
c
V
S
F
O
F
S
V
N
o
W
d
d
S
"}
(19,1,1) = {"
S
S
F
d
d
d
d
F
F
S
F
F
d
d
F
F
F
S
S
"}
