"al" = (/obj/random/flora/school,/obj/structure/fd/placeholder/better{opacity = 0},/turf/unsimulated/floor/exoplanet/grass,/area/psionic_school/outdoor)
"aX" = (/obj/structure/stairs/west,/turf/simulated/floor/wood/walnut,/area/psionic_school/indoor)
"cP" = (/obj/structure/fd/placeholder/better{opacity = 0},/turf/simulated/wall/concrete,/area/psionic_school/outdoor)
"dg" = (/turf/simulated/wall/concrete,/area/psionic_school/outdoor)
"eY" = (/obj/structure/girder,/turf/simulated/floor/plating,/area/psionic_school/outdoor)
"iD" = (/turf/unsimulated/floor/reinforced,/area/psionic_school/indoor)
"jr" = (/turf/simulated/floor/plating,/area/psionic_school/indoor)
"jA" = (/obj/structure/stairs/east,/turf/simulated/floor/plating,/area/psionic_school/indoor)
"lm" = (/turf/simulated/floor/tiled/techfloor/grid,/area/psionic_school/indoor)
"oZ" = (/turf/unsimulated/floor/exoplanet/grass,/area/psionic_school/outdoor)
"pI" = (/obj/structure/girder,/turf/simulated/floor/plating,/area/psionic_school/indoor)
"sQ" = (/obj/structure/wall_frame/concrete,/turf/simulated/floor/plating,/area/psionic_school/indoor)
"uC" = (/obj/structure/stairs/north,/turf/simulated/floor/tiled/techfloor/grid,/area/psionic_school/indoor)
"uE" = (/obj/structure/fd/placeholder/better{opacity = 0},/obj/random/flora/school,/turf/unsimulated/floor/exoplanet/grass,/area/psionic_school/outdoor)
"xF" = (/obj/effect/overmap/visitable/sector/psyonic_school_ruins2,/turf/unsimulated/wall{color = "black"},/area/psionic_school/outdoor)
"yJ" = (/turf/unsimulated/floor/exoplanet/concrete/reinforced,/area/psionic_school/indoor)
"Ac" = (/turf/unsimulated/floor/exoplanet/barren,/area/psionic_school/outdoor)
"AD" = (/obj/structure/wall_frame/wood/walnut,/turf/simulated/floor/wood/walnut,/area/psionic_school/indoor)
"BG" = (/obj/random/flora/school,/turf/unsimulated/floor/exoplanet/grass,/area/psionic_school/outdoor)
"Cp" = (/obj/structure/stairs/west,/turf/simulated/floor/plating,/area/psionic_school/indoor)
"Cw" = (/obj/structure/ladder/up,/turf/simulated/floor/plating,/area/psionic_school/indoor)
"GU" = (/obj/structure/stairs/south,/turf/simulated/floor/plating,/area/psionic_school/indoor)
"Hg" = (/obj/structure/fd/placeholder/better{opacity = 0},/turf/unsimulated/floor/exoplanet/barren,/area/psionic_school/outdoor)
"Kc" = (/turf/simulated/wall/concrete,/area/psionic_school/indoor)
"Kt" = (/turf/unsimulated/floor/exoplanet/concrete,/area/psionic_school/indoor)
"MQ" = (/turf/unsimulated/wall{color = "black"},/area/psionic_school/outdoor)
"NK" = (/turf/unsimulated/floor/exoplanet/concrete,/area/psionic_school/outdoor)
"OW" = (/turf/simulated/floor/wood/walnut,/area/psionic_school/indoor)
"PC" = (/obj/structure/stairs/north,/turf/simulated/floor/plating,/area/psionic_school/indoor)
"RT" = (/turf/unsimulated/wall{color = "black"},/area/psionic_school/indoor)
"Ul" = (/obj/structure/stairs/south,/turf/unsimulated/floor/exoplanet/concrete,/area/psionic_school/indoor)
"US" = (/turf/simulated/wall/walnut,/area/psionic_school/indoor)
"Vv" = (/obj/structure/fd/placeholder/better{opacity = 0},/turf/unsimulated/floor/exoplanet/grass,/area/psionic_school/outdoor)
"Wz" = (/obj/structure/girder,/obj/structure/fd/placeholder/better{opacity = 0},/turf/simulated/floor/plating,/area/psionic_school/outdoor)
"Xu" = (/turf/unsimulated/floor/reinforced,/area/psionic_school/outdoor)
"Xy" = (/turf/simulated/floor/tiled/techfloor,/area/psionic_school/indoor)

(1,1,1) = {"
MQMQMQMQMQMQMQMQMQMQMQMQMQMQMQMQMQMQMQMQMQMQMQMQMQMQMQMQMQMQMQMQMQMQMQMQMQMQMQMQMQMQMQMQMQMQMQMQMQMQMQMQMQMQMQMQMQMQMQMQMQMQMQMQMQMQMQMQMQMQMQMQMQMQMQMQMQMQMQMQMQMQMQMQMQMQMQMQMQMQMQMQMQMQMQMQMQMQMQMQ
MQBGBGBGBGdgdgAcAcAcBGBGBGBGBGBGBGBGBGBGBGBGBGBGBGBGBGBGBGBGBGBGBGBGBGBGBGBGBGBGBGBGBGBGBGBGBGBGBGBGBGBGBGBGBGBGBGBGBGBGBGBGBGBGBGBGBGBGBGBGBGBGBGBGBGBGBGBGBGBGBGBGBGBGBGBGBGBGBGBGBGBGBGBGBGBGBGBGBGMQ
MQBGBGBGdgdgdgdgAcAcBGBGBGBGBGBGBGBGBGBGBGBGBGBGBGBGBGBGBGBGBGBGBGBGBGBGBGBGBGBGBGBGBGBGBGBGBGBGBGBGBGBGBGBGBGBGBGBGBGBGBGBGBGBGBGBGBGBGBGBGBGBGBGBGBGBGBGBGBGBGBGBGBGBGBGBGBGBGBGBGBGBGBGBGBGBGBGBGBGMQ
MQBGBGBGdgeYeYdgAcAcBGBGBGBGBGBGBGBGBGBGBGBGBGBGBGBGBGBGBGBGBGBGBGBGBGBGBGBGBGBGBGBGBGBGBGBGBGBGBGBGBGBGBGBGBGBGBGBGBGBGBGBGBGBGBGBGBGBGBGBGBGBGBGBGBGBGBGBGBGBGBGBGBGBGBGBGBGBGBGBGBGBGBGBGBGBGBGBGBGMQ
MQalalalcPWzWzcPHguEuEuEuEuEuEuEuEuEuEuEuEuEuEuEuEuEuEuEuEuEuEuEuEuEuEuEuEuEuEuEuEuEuEuEuEuEuEuEuEuEuEuEuEuEuEuEuEuEuEuEuEuEuEuEuEuEuEuEuEuEuEuEuEuEuEuEuEuEuEuEuEuEuEuEuEuEuEuEuEuEuEuEuEuEuEuEuEuEuEMQ
MQBGBGoZdgdgdgdgoZBGBGBGBGBGBGBGBGBGBGBGBGBGBGBGBGBGBGBGBGBGBGBGBGBGBGBGBGBGBGBGBGBGBGBGBGBGBGBGBGBGBGBGBGBGBGBGBGBGBGBGBGBGBGBGBGBGBGBGBGBGBGBGBGBGBGBGBGBGBGBGBGBGBGBGBGBGoZoZoZoZoZoZoZoZoZoZBGBGBGMQ
MQBGBGoZoZdgdgoZoZoZoZoZoZoZBGBGBGBGBGBGBGBGBGBGBGBGoZoZoZoZBGBGBGBGBGBGoZoZoZoZoZBGBGBGBGBGBGBGBGBGBGBGBGBGoZoZoZoZoZoZBGBGBGBGBGBGBGBGBGBGoZoZoZoZoZoZoZoZoZoZoZoZoZoZoZoZoZoZoZoZoZoZoZoZoZoZoZoZBGMQ
MQBGBGoZAcdgdgAcoZoZoZoZoZoZoZoZoZoZoZoZoZoZoZoZoZoZoZoZoZoZoZoZBGBGBGoZoZoZoZoZoZoZoZBGBGBGBGBGBGoZoZoZoZoZoZoZoZoZoZoZoZoZoZoZoZoZoZoZoZoZoZoZoZoZoZoZoZoZoZKcKcKcKcKcKcKcOWOWKcKcKcKcKcKcKcoZoZoZoZMQ
MQBGBGoZAcdgdgAcoZoZoZUSUSUSUSADUSUSADUSUSADUSUSADUSUSADUSUSNKNKNKNKNKNKNKoZoZoZoZoZoZoZBGBGBGoZoZoZoZoZoZoZoZoZoZKcKcKcKcKcKcKcKcKcKcKcKcKcKcKcKcKcKcKcKcKcoZKcjrjrjrjrjrKcOWOWKcjrjrjrjrjrKcoZoZoZBGMQ
MQBGBGoZAcdgdgAcAcoZoZUSOWOWOWOWOWUSOWOWOWOWOWUSOWOWOWOWOWUSNKBGBGBGBGBGNKoZoZoZoZoZoZoZoZoZoZoZoZoZoZoZoZoZoZoZoZKcKtKtKtKtKtKtKtKtKtKtKtKtKtKtKtKtKtKtKtKcoZKcjrjrjrKcjrjrOWOWKcjrKcjrjrjrKcoZoZoZBGMQ
MQBGoZoZAcdgdgAcAcoZoZOWOWOWOWOWOWUSOWOWOWOWOWOWOWOWOWOWOWOWNKBGBGBGBGBGNKKcKcKcKcjrKcKcKcKcoZKcKcKcKcjrKcKcKcKcoZjrKtKtKtiDiDKtiDiDKtiDiDKtiDiDKtiDiDKtKtjroZKcjrjrKcjrjrjrOWOWjrjrjrKcjrjrKcoZoZoZBGMQ
MQBGoZAcAcdgdgAcoZoZoZUSOWOWOWOWOWOWOWOWOWOWOWUSOWOWOWOWOWOWNKBGBGBGBGBGNKKcjrjrjrjrjrjrjrKcoZKcjrjrjrjrjrjrjrKcoZKcKtKtKtiDiDKtiDiDKtiDiDKtiDiDKtiDiDKtKtKcoZKcjrKcjrjrjrKcOWOWKcjrjrjrKcjrKcoZoZoZBGMQ
MQBGoZAcdgdgdgdgAcoZoZUSOWOWOWOWOWUSOWOWOWOWOWUSOWOWOWOWOWUSNKBGBGBGBGBGNKsQjrKcjrKcjrKcjrKcoZKcjrKcjrKcjrKcjrKcoZKcKtKtKtiDiDiDiDiDiDiDiDiDiDiDiDiDiDiDKtKcoZKcjrjrjrjrjrKcOWOWKcjrjrjrjrjrKcoZoZBGBGMQ
MQBGAcAcdgeYeYdgAcoZoZUSOWOWOWOWOWUSUSOWUSUSUSUSUSUSUSUSUSUSNKBGBGBGBGBGNKsQjrjrjrjrjrjrjrKcoZKcjrjrjrjrjrjrjrKcoZKcKtKtKtiDiDiDiDiDiDiDiDiDiDiDiDiDiDiDKtKcoZKcjrKcKcKcKcKcOWOWKcKcKcjrKcKcKcoZoZBGBGMQ
MQBGAcoZdgeYeYdgAcoZoZUSUSOWUSUSUSUSOWOWOWUSNKNKNKNKNKNKNKNKNKBGBGBGBGBGNKKcjrjrjrjrjrjrjrKcoZKcjrjrjrjrjrjrjrKcoZKcKtKtKtiDiDiDiDiDiDiDiDiDiDiDiDiDiDiDKtKcoZOWOWOWOWOWOWOWOWOWOWOWOWOWOWOWOWoZoZBGBGMQ
MQBGAcAcdgdgdgdgAcoZoZUSOWOWOWOWOWOWOWOWOWUSNKNKNKNKNKNKNKNKNKNKNKNKNKNKNKKcjrjrjrKcjrjrjrKcoZKcjrjrjrKcjrjrjrKcoZKcKtKtKciDiDKciDiDKciDiDKciDiDKciDiDKcKtKcoZOWOWOWOWOWOWOWOWOWOWOWOWOWOWOWOWoZoZBGBGMQ
MQBGAcAcAcdgdgAcoZoZoZUSOWOWOWUSUSUSUSOWOWUSNKNKKcKcKcKcKcKcKcKcKcKcKcNKNKKcjrjrKcKcKcjrjrKcoZKcjrjrKcKcKcjrjrKcoZKcKtKtKtiDiDiDiDiDiDiDiDiDiDiDiDiDiDiDKtKcoZKcKcKcjrKcKcKcOWOWKcKcKcKcjrKcKcoZoZBGBGMQ
MQBGAcoZAcdgdgoZAcoZoZUSOWOWOWUSaXOWOWOWOWUSNKNKKcjrjrjrjrjrjrjrjrjrKcNKNKKcjrjrjrKcjrjrjrKcoZKcjrjrjrKcjrjrjrKcoZKcKtKtKtiDiDiDiDiDiDiDiDiDiDiDiDiDiDiDKtKcoZKcjrjrjrjrjrKcOWOWKcjrjrjrjrjrKcoZoZoZBGMQ
MQBGAcAcAcdgdgAcoZAcoZUSOWOWOWUSaXOWOWOWOWUSNKNKKcKcjrKcKcKcKcKcjrKcKcNKNKKcjrjrjrjrjrjrjrKcoZKcjrjrjrjrjrjrjrKcoZKcKtKcKtiDiDiDiDiDiDiDiDiDiDiDiDiDiDiDKtKcoZKcjrKcjrjrjrKcOWOWKcjrjrjrKcjrKcoZoZoZBGMQ
MQoZoZAcAcdgdgAcAcAcoZUSUSOWUSUSUSUSUSOWUSUSNKNKKcjrjrjrKcjrjrjrjrjrKcNKNKsQjrjrjrjrjrjrjrKcoZKcjrjrjrjrjrjrjrsQoZKcUlKcKtiDiDKtiDiDKtiDiDKtiDiDKtiDiDKtKtKcoZKcjrjrKcjrjrKcOWOWjrjrjrKcjrjrKcoZoZBGBGMQ
MQoZoZAcAcdgdgAcoZAcoZUSOWOWOWOWUSOWOWOWOWUSNKNKsQjrjrjrjrjrjrjrjrjrKcNKNKsQjrKcjrKcjrKcjrKcoZKcjrKcjrKcjrKcjrsQoZKcKcKcKtiDiDKtiDiDKtiDiDKtiDiDKtiDiDKtKtKcoZKcjrjrjrKcjrKcOWOWjrjrKcjrjrjrKcoZoZBGBGMQ
MQoZoZAcoZdgdgAcAcAcoZUSOWOWOWOWUSOWOWOWOWOWNKNKsQjrjrjrKcjrjrjrjrjrKcNKNKKcjrjrjrjrjrjrjrKcoZKcjrjrjrjrjrjrjrKcoZKcpIKcKtiDiDKtKtKtKtKtKtKtKtKtKtKtKtKtKtKcoZKcjrjrjrjrjrKcOWOWKcjrjrjrjrjrKcoZoZBGBGMQ
MQBGoZoZdgdgdgdgAcoZoZUSOWOWOWOWUSOWOWOWOWOWNKNKKcjrjrjrKcjrKcKcKcjrKcNKNKKcKcjrKcKcKcjrKcKcoZKcKcjrKcKcKcjrKcKcoZKcKcKcKtiDiDKtKcKcKcKcKcKcKcKcKcKcKcKcKcKcoZKcKcjrKcKcKcKcOWOWKcKcKcKcKcKcKcoZoZBGBGMQ
MQBGoZoZdgeYeYdgAcoZoZUSOWOWOWOWOWOWOWOWOWUSNKNKKcKcjrKcKcKcKcjrjrjrsQNKNKNKNKNKNKNKNKNKNKNKNKNKNKNKNKNKNKNKNKNKNKNKNKNKNKXuXuNKNKNKNKNKNKNKNKNKNKNKNKNKNKNKNKNKNKNKNKNKNKNKNKNKNKNKNKNKoZoZoZoZBGBGBGMQ
MQBGoZAcdgeYeYdgAcoZoZUSUSADADUSUSUSADADUSUSNKNKKcjrjrjrjrjrKcjrjrjrsQNKNKNKNKNKNKNKNKNKNKNKNKNKNKNKNKNKNKNKNKNKNKNKNKNKXuXuXuXuNKNKNKNKNKNKNKNKNKNKNKNKNKNKNKNKNKNKNKNKNKNKNKNKNKNKNKNKoZoZoZoZBGBGBGMQ
MQBGoZAcdgdgdgdgAcoZoZoZoZoZoZoZoZoZoZoZoZoZNKNKKcjrjrjrjrjrKcjrjrjrKcNKNKXuXuXuXuXuXuXuXuXuXuXuXuXuXuXuXuXuXuXuXuXuXuXuXuXuXuXuXuXuXuXuXuXuXuXuXuXuXuXuXuXuXuXuXuXuXuXuXuXuXuXuXuXuNKNKoZoZoZoZBGBGBGMQ
MQBGAcAcAcdgdgAcoZoZoZoZoZoZoZoZoZoZoZoZoZoZNKNKKcjrjrjrjrjrjrjrjrjrjrNKNKXuXuXuXuXuXuXuXuXuXuXuXuXuXuXuXuXuXuXuXuXuXuXuXuXuXuXuXuXuXuXuXuXuXuXuXuXuXuXuXuXuXuXuXuXuXuXuXuXuXuXuXuXuNKNKoZoZoZoZBGBGBGMQ
MQBGAcAcAcdgdgAcoZoZKcKcjrKcKcKcsQKcKcKcsQKcKcNKKcjrjrjrjrjrKcjrjrjrjrNKNKXuXuXuXuXuXuXuXuXuXuXuXuXuXuXuXuXuXuXuXuXuXuXuXuXuXuXuXuXuXuXuXuXuXuXuXuXuXuXuXuXuXuXuXuXuXuXuXuXuXuXuXuXuNKNKoZoZoZoZoZBGBGMQ
MQBGAcAcAcdgdgAcAcoZKcjrjrjrjrjrjrjrKcjrjrjrKcNKKcKcKcjrjrKcKcjrjrjrKcNKNKXuXuXuXuXuXuXuXuXuXuXuXuXuXuXuXuXuXuXuXuXuXuXuXuXuXuXuXuXuXuXuXuXuXuXuXuXuXuXuXuXuXuXuXuXuXuXuXuXuXuXuXuXuNKNKoZoZoZoZoZBGBGMQ
MQBGBGAcAcdgdgAcAcoZKcjrjrjrKcjrjrjrKcjrjrjrKcNKsQjrjrjrjrjrKcKcKcKcKcNKNKNKNKNKNKNKNKNKNKNKNKNKNKNKNKNKNKNKNKNKNKNKNKXuXuXuXuXuXuNKNKNKNKNKNKNKNKNKNKNKNKNKNKNKNKNKNKNKNKNKNKNKNKNKNKNKoZoZoZoZBGBGBGMQ
MQBGBGAcAcdgdgAcAcoZsQjrKcjrKcjrKcjrKcjrKcjrKcNKsQjrjrjrjrjrKcNKNKNKNKNKNKNKNKNKNKNKNKNKNKNKNKNKNKNKNKNKNKNKNKNKNKNKNKNKXuXuXuXuNKNKNKNKNKNKNKNKNKNKNKNKNKNKNKNKNKNKNKNKNKNKNKNKNKNKNKNKoZoZoZoZBGBGBGMQ
MQBGAcAcAcdgdgAcAcAcKcjrjrjrKcjrjrjrjrjrjrjrKcNKKcjrjrjrjrjrKcNKKcKcKcsQsQKcjrjrKcsQsQKcKcKcNKKcKcsQsQKcKcKcjrKcKcNKNKNKXuXuXuXuNKNKKcKcKcKcyJyJKcKcKcKcKcKcyJyJKcKcKcKcNKoZoZoZoZoZoZoZoZoZoZoZBGBGBGMQ
MQBGAcoZdgdgdgdgAcAcKcjrjrjrKcjrjrKcKcKcKcjrKcNKKcKcsQsQsQKcKcNKKcjrjrjrjrjrjrjrjrjrjrjrjrKcNKKcjrjrjrjrjrjrjrjrKcKcNKNKXuXuXuXuNKNKKcpIpIKcyJyJKcpIpIpIpIKcyJyJKcKcpIKcNKoZoZoZoZoZoZoZoZoZoZoZBGBGBGMQ
MQBGoZAcdgeYeYdgAcAcKcKcKcjrKcKcKcKcjrjrjrjrKcNKNKNKNKNKNKNKNKNKKcjrKcjrKcjrKcKcjrKcjrKcjrKcNKKcjrKcKcjrKcjrKcjrjrsQNKNKXuXuXuXuNKNKKcpIKcKcyJyJKcKcKcKcKcKcyJyJKcKcpIKcNKoZoZNKNKNKNKNKNKNKoZoZBGBGBGMQ
MQBGAcAcdgeYeYdgAcAcKcjrjrjrjrjrjrKcjrjrjrjrsQNKBGBGBGBGBGBGBGNKKcjrjrjrjrjrjrjrjrjrjrjrjrKcNKKcjrjrjrjrKcjrKcjrjrsQNKNKXuXuXuXuNKNKKcKcKcyJyJyJKcKcyJyJKcKcyJyJKcKcpIKcNKoZoZNKKclmKcKcKcNKoZoZBGBGBGMQ
MQAcAcAcdgdgdgdgAcAcKcjrjrjrjrjrjrjrjrjrjrjrsQNKBGBGBGBGBGBGBGNKKcjrjrjrKcjrjrjrjrKcjrjrjrKcNKKcjrjrjrjrjrjrjrjrjrKcNKNKXuXuXuXuNKNKyJyJyJyJyJyJyJyJyJyJyJyJyJyJyJKcpIKcNKoZoZNKKcXyKcuCKcNKoZoZBGBGBGMQ
MQAcAcAcAcAcAcAcAcAcKcKcKcsQsQKcKcKcKcjrjrKcKcNKBGBGBGBGBGBGBGNKKcKcjrKcKcKcKcKcKcKcKcjrKcKcNKKcKcjrKcKcKcKcKcjrKcKcNKNKXuXuXuXuNKNKyJyJyJyJyJyJyJyJyJyJyJyJyJyJyJKcpIKcNKoZoZNKKcXyKclmKcNKoZoZoZBGBGMQ
MQAcAcAcAcAcAcAcAcAcAcAcAcAcAcAcAcNKNKNKNKNKNKNKNKNKNKNKNKNKNKNKNKNKNKNKNKNKNKNKNKNKNKNKNKNKNKNKNKNKNKNKNKNKNKNKNKNKNKNKXuXuXuXuNKNKKcKcKcKcyJyJKcKcyJyJKcKcyJyJKcKcpIKcNKoZoZNKKcXylmXyKcNKoZoZoZBGBGMQ
MQAcAcAcAcAcAcAcAcAcAcAcAcAcAcNKAcNKNKAcAcNKNKNKNKKcKcKcKcKcjrKcKcKcKcKcKcKcKcKcKcKcKcKcKcKcKcKcKcKcKcKcKcKcKcKcKcKcNKNKXuXuXuXuNKNKKcpIKcKcyJyJKcKcKcKcKcKcyJyJKcKcpIKcNKoZoZNKKcKcKcKcKcNKoZoZoZBGBGMQ
MQXuXuXuXuXuXuXuXuXuXuXuXuXuXuXuXuXuXuXuXuXuXuNKNKKcjrjrjrjrjrjrjrjrKcjrjrjrjrjrjrjrjrjrjrjrjrjrKcjrjrjrjrjrjrjrjrKcNKNKXuXuXuXuNKNKKcpIKcyJyJyJyJKcpIpIKcyJyJyJyJKcpIKcNKoZoZNKNKNKNKNKNKNKoZoZoZBGBGMQ
MQXuXuXuXuXuXuXuXuXuXuXuXuXuXuXuXuXuXuXuXuXuXuNKNKsQjrjrjrjrjrjrjrjrjrjrjrjrjrjrjrKcjrjrjrjrjrjrjrjrjrjrjrjrjrjrjrsQNKNKXuXuXuXuNKNKKcpIKcyJyJyJyJKcpIpIKcyJyJyJyJKcpIKcNKoZoZoZoZoZoZoZoZoZoZoZoZBGBGMQ
MQXuXuXuXuXuXuXuXuXuXuXuXuXuXuXuXuXuXuXuXuXuXuNKNKsQjrjrjrjrjrjrjrjrKcKcKcKcKcKcKcKcKcKcKcKcKcKcKcjrjrjrjrjrjrjrjrsQNKNKXuXuXuXuNKNKKcpIKcKcyJyJKcKcKcKcKcKcyJyJKcKcpIKcNKoZoZoZoZoZoZoZoZoZoZoZBGBGBGMQ
MQXuXuXuXuXuXuXuXuXuXuXuXuXuXuXuXuXuXuXuXuXuXuNKNKKcjrjrjrjrjrKcjrjrKcjrjrjrjrjrjrjrjrjrjrjrjrjrKcjrjrKcjrjrjrjrjrKcNKNKXuXuXuXuNKNKKcKcKcKcyJyJKcKcyJyJKcKcyJyJKcKcKcKcNKoZoZoZoZoZoZoZoZoZoZoZBGBGBGMQ
MQAcAcAcAcAcAcAcAcAcAcAcAcAcNKNKAcNKXuXuXuXuXuNKNKKcjrjrKcjrjrjrjrjrKcjrKcjrjrjrjrKcKcKcjrjrKcjrKcjrjrjrjrjrKcjrjrKcNKNKXuXuXuXuNKNKyJyJyJyJyJyJyJyJyJyJyJyJyJyJKcKcKcKcNKoZoZoZoZoZoZoZoZoZoZBGBGBGBGMQ
MQAcAcAcAcAcAcAcAcAcAcAcAcAcAcAcNKAcNKXuXuXuXuNKNKKcjrjrKcjrjrjrjrjrKcjrjrjrKcjrjrjrCwKcjrjrjrjrKcjrjrjrjrjrKcjrjrKcNKNKXuXuXuXuNKNKyJyJyJyJyJyJyJyJyJyJyJyJyJyJyJKcKcKcNKoZoZoZoZoZoZoZoZoZoZBGBGBGBGMQ
MQAcAcAcAcoZoZAcAcAcoZoZAcAcoZoZAcNKNKXuXuXuXuNKNKKcGUGUKcjrjrjrjrjrjrjrKcjrKcKcKcKcKcKcjrjrKcjrjrjrjrjrjrjrKcGUGUKcNKNKXuXuXuXuNKNKKcKcKcKcyJyJKcKcyJyJKcKcKcyJyJyJKcKcNKoZoZoZoZoZoZoZoZoZoZBGBGBGBGMQ
MQBGAcoZdgdgdgdgoZAcAcoZdgdgdgdgoZNKNKXuXuXuXuNKNKKcKcKcKcKcjrKcKcjrKcjrjrjrKcjrjrjrjrKcjrjrjrjrKcjrKcKcjrKcKcKcKcKcNKNKXuXuXuXuNKNKKcKcKcKcKcKcKcKcKcKcKcKcKcKcyJyJyJyJNKoZoZoZoZoZoZoZoZoZoZBGBGBGBGMQ
MQBGAcoZdgeYeYdgdgdgdgdgdgeYeYdgAcNKNKXuXuXuXuNKNKyJyJyJyJKcjrjrjrjrKcjrKcjrKcjrjrjrjrjrjrjrKcjrKcjrjrjrjrKcyJyJyJyJNKNKXuXuXuXuNKNKKcpIpIpIpIpIpIpIpIpIpIKcKcKcKcyJyJyJNKoZoZoZoZoZoZoZoZoZoZBGBGBGBGMQ
MQBGAcoZdgeYeYdgdgdgdgdgdgeYeYdgAcNKNKXuXuXuXuNKNKyJyJyJyJsQjrjrjrjrKcjrjrjrjrjrjrjrjrjrjrjrjrjrKcjrjrjrjrsQyJyJyJyJNKNKXuXuXuXuNKNKKcKcKcKcKcKcKcKcKcKcKcKcKcKcKcyJyJyJNKoZoZoZoZoZoZoZoZoZoZoZBGBGBGMQ
MQBGAcAcdgdgdgdgoZAcAcAcdgdgdgdgAcNKNKXuXuXuXuNKNKKcKcyJyJKcjrjrjrjrKcjrjrjrjrjrjrjrjrjrjrjrjrjrKcjrjrjrjrKcyJyJKcKcNKNKXuXuXuXuNKNKNKNKNKNKNKNKNKNKNKNKNKNKNKNKNKNKNKNKNKoZoZoZoZoZoZoZoZoZoZoZBGBGBGMQ
MQBGoZAcAcAcAcoZAcoZoZAcAcdgdgAcAcNKNKXuXuXuXuNKNKKcKcyJyJKcKcjrjrKcKcKcsQsQKcKcKcKcKcKcKcsQsQKcKcKcjrjrKcKcyJyJKcKcNKNKXuXuXuXuNKNKKcKcjrKcKcKcKcKcKcKcKcKcKcKcKcKcKcKcKcoZoZoZoZoZoZoZoZoZoZoZBGBGBGMQ
MQBGoZoZoZAcAcAcAcAcAcAcAcdgdgAcAcNKNKXuXuXuXuNKNKNKNKNKNKNKNKNKNKNKNKNKNKNKNKNKNKNKNKNKNKNKNKNKNKNKNKNKNKNKNKNKNKNKNKNKXuXuXuXuNKNKKcjrjrjrjrjrKcjrjrjrjrjrjrjrjrjrjrjrKcoZoZoZoZoZoZoZoZoZoZoZBGBGBGMQ
MQBGBGoZoZoZoZAcAcoZAcAcoZdgdgAcAcNKNKXuXuXuXuXuNKNKNKNKNKNKNKNKNKNKNKNKNKNKNKNKNKNKNKNKNKNKNKNKNKNKNKNKNKNKNKNKNKNKNKXuXuXuXuXuNKNKsQjrjrjrjrjrjrjrjrKcjrjrKcjrjrjrjrjrKcoZoZoZoZoZoZoZoZoZoZoZoZBGBGMQ
MQBGBGoZoZoZoZoZAcAcAcAcoZdgdgAcoZNKNKXuXuXuXuXuXuXuXuXuXuXuXuXuXuXuXuXuXuXuXuXuXuXuXuXuXuXuXuXuXuXuXuXuXuXuXuXuXuXuXuXuXuXuXuXuNKNKsQjrKcKcjrjrKcjrjrKcjrjrKcjrjrKcjrjrsQoZoZoZoZoZoZoZoZoZoZoZoZBGBGMQ
MQBGBGBGoZoZoZoZoZAcAcAcAcdgdgAcoZNKNKXuXuXuXuXuXuXuXuXuXuXuXuXuXuXuXuXuXuXuXuXuXuXuXuXuXuXuXuXuXuXuXuXuXuXuXuXuXuXuXuXuXuXuXuXuNKNKKcjrjrjrjrjrKcjrjrjrjrjrKcjrjrKcjrjrsQoZoZoZoZoZoZoZoZoZoZoZoZBGBGMQ
MQBGBGBGoZoZoZoZoZoZAcAcoZdgdgoZoZNKNKXuXuXuXuXuXuXuXuXuXuXuXuXuXuXuXuXuXuXuXuXuXuXuXuXuXuXuXuXuXuXuXuXuXuXuXuXuXuXuXuXuXuXuXuXuNKNKKcKcKcsQsQKcKcKcKcKcjrKcKcjrjrjrjrjrKcoZoZoZoZoZoZoZoZoZoZoZoZBGBGMQ
MQBGBGBGoZoZoZoZoZoZAcAcdgdgdgdgoZNKNKXuXuXuXuXuXuXuXuXuXuXuXuXuXuXuXuXuXuXuXuXuXuXuXuXuXuXuXuXuXuXuXuXuXuXuXuXuXuXuXuXuXuXuXuXuNKNKoZoZoZoZoZoZoZoZKcjrjrjrKcKcjrKcKcKcKcoZoZoZoZoZoZoZoZoZoZoZoZBGBGMQ
MQBGBGBGBGoZoZoZoZoZAcAcdgeYeYdgoZNKNKXuXuXuXuXuNKNKNKNKNKNKNKNKNKNKNKNKNKNKNKNKNKNKNKNKNKNKNKNKNKNKNKNKNKNKNKNKNKNKNKXuXuXuXuXuNKNKNKNKNKNKNKNKNKNKjrjrjrjrjrjrjrjrjrjrjroZoZoZoZoZoZoZoZoZoZoZoZoZBGMQ
MQBGBGBGBGoZoZoZoZoZoZAcdgeYeYdgAcNKNKXuXuXuXuNKNKNKNKNKNKNKNKNKNKNKNKNKNKNKNKNKNKNKNKNKNKNKNKNKNKNKNKNKNKNKNKNKNKNKNKNKXuXuXuXuNKNKNKNKNKNKNKNKNKNKjrjrjrjrjrjrjrjrjrjrKcoZoZoZoZoZoZoZoZoZoZoZoZoZBGMQ
MQBGBGBGBGoZoZoZoZoZoZAcdgdgdgdgAcNKNKXuXuXuXuNKNKNKKcKcKcKcKcKcKcsQsQKcKcKcKcKcKcKcKcKcsQsQKcKcKcKcKcKcKcKcKcKcKcNKNKNKXuXuXuXuNKNKoZoZoZoZoZoZoZoZKcjrjrjrKcKcKcKcjrKcKcoZoZoZoZoZoZoZoZoZoZoZoZoZBGMQ
MQBGBGBGBGoZoZoZoZoZoZoZoZdgdgAcAcNKNKXuXuXuXuNKNKKcKcjrjrjrKcjrjrjrjrjrjrjrjrjrjrjrjrjrjrjrjrjrKcjrjrjrjrjAKcjrKcKcNKNKXuXuXuXuNKNKKcKcKcsQsQKcKcKcKcKcjrKcKcPCPCKcjrjrKcoZoZoZoZoZoZoZoZoZoZoZoZoZBGMQ
MQBGBGBGBGoZoZoZoZoZoZAcAcdgdgAcAcNKNKXuXuXuXuNKNKjrjrjrjrjrKcjrjrjrjrjrKcKcjrjrjrjrjrKcKcjrjrjrKcjrjrjrjrjAKcjrjrKcNKNKXuXuXuXuNKNKKcjrjrjrjrjrKcjrjrjrjrjrKcjrjrKcjrjrsQoZoZoZoZoZoZoZoZoZoZoZoZoZBGMQ
MQBGBGBGBGoZoZoZoZoZoZoZAcdgdgAcoZNKNKXuXuXuXuNKNKjrjrjrjrjrjrjrjrKcjrjrjrKcKcjrjrjrjrjrjrjrKcjrKcjrjrKcKcKcKcKcKcKcNKNKXuXuXuXuNKNKsQjrKcKcjrjrKcjrjrKcjrjrKcjrjrKcjrjrsQoZoZoZoZoZoZoZoZoZoZoZoZoZBGMQ
MQBGBGBGBGoZoZoZoZoZoZoZAcdgdgAcoZNKNKXuXuXuXuNKNKKcKcKcjrjrKcjrjrKcKcjrjrjrjrjrjrKcjrjrjrjrjrjrjrjrjrjrjrjrjrjrjrKcNKNKXuXuXuXuNKNKsQjrjrjrjrjrjrjrjrKcjrjrKcjrjrjrjrjrKcoZoZoZoZoZoZoZoZoZoZoZoZoZoZMQ
MQBGBGBGBGBGoZoZoZoZoZAcAcdgdgAcAcNKNKXuXuXuXuNKNKKcjrjrjrjrjrjrjrjrKcjrjrjrjrjrKcKcjrKcKcjrjrjrjrKcjrjrjrKcjrjrjrKcNKNKXuXuXuXuNKNKKcjrjrjrjrjrKcjrjrjrjrjrjrjrjrjrjrjrKcoZoZoZoZoZoZoZoZoZoZoZoZoZBGMQ
MQBGBGBGBGBGoZoZoZoZAcAcoZdgdgAcAcNKNKXuXuXuXuNKNKKcKcjrjrjrjrjrjrjrjrjrjrjrjrjrjrjrjrjrjrjrjrjrjrjrjrjrjrjrjrKcjrKcNKNKXuXuXuXuNKNKKcKcjrKcKcKcKcKcKcKcKcKcKcKcKcKcKcKcKcoZoZoZoZoZoZoZoZoZoZoZoZoZBGMQ
MQBGBGBGBGBGoZoZoZoZAcoZdgdgdgdgAcNKNKXuXuXuXuNKNKsQjrjrjrjrjrKcKcjrjrjrjrKcjrjrjrjrjrjrjrjrjrKcjrjrjrjrjrjrjrjrjrsQNKNKXuXuXuXuNKNKoZoZoZoZoZoZoZoZoZoZoZoZoZoZoZoZoZoZoZoZoZoZoZoZoZoZoZoZoZoZoZoZBGMQ
MQBGBGBGBGBGoZoZoZoZAcoZdgeYeYdgAcNKNKXuXuXuXuNKNKsQjrjrKcKcjrjrjrjrjrjrjrjrjrjrjrjrjrjrjrjrKcjrjrjrjrKcjrjrjrjrjrsQNKNKXuXuXuXuNKNKKcKcKcKcKcKcKcKcKcKcKcKcKcKcKcKcKcKcKcoZoZoZoZoZoZoZoZoZoZoZoZoZBGMQ
MQBGBGBGBGBGoZoZoZoZAcAcdgeYeYdgBGNKNKXuXuXuXuNKNKKcjrjrjrjrjrjrjrjrKcKcjrjrjrjrKcKcjrjrjrjrjrjrjrjrjrjrjrjrKcjrjrKcNKNKXuXuXuXuNKNKKcjrjrjrjrjrjrjrjrjrjrjrjrjrjrjrjrjrKcoZoZoZoZoZoZoZoZoZoZoZoZBGBGMQ
MQBGBGBGBGBGoZoZoZoZoZAcdgdgdgdgBGNKNKXuXuXuXuNKNKKcjrKcjrjrKcjrjrjrjrKcjrjrjrjrjrjrjrKcjrjrjrjrjrjrjrjrjrjrjrjrjrKcNKNKXuXuXuXuNKNKsQjrKcjrjrjrjrjrjrjrjrjrKcjrjrjrKcjrKcoZoZoZoZoZoZoZoZoZoZoZoZBGBGMQ
MQBGBGBGBGBGoZoZoZoZoZAcAcdgdgAcBGNKNKXuXuXuXuNKNKKcjrjrjrjrjrjrjrjrjrjrjrjrKcjrjrjrjrKcjrjrjrKcjrKcjrjrjrKcKcjrjrKcNKNKXuXuXuXuNKNKsQjrjrjrKcjrKcKcKcjrKcKcKcjrjrjrjrjrKcoZoZoZoZoZoZoZoZoZoZoZoZBGBGMQ
MQBGBGBGBGBGoZoZoZAcAcAcAcdgdgAcAcNKNKXuXuXuXuNKNKKcKcKcKcKcKcKcjrjrKcjrjrjrjrjrjrjrjrjrjrjrjrjrjrjrjrjrjrjrjrjrKcKcNKNKXuXuXuXuNKNKKcKcKcKcKcjrjrKcjrjrjrjrKcKcKcKcjrKcKcoZoZoZoZoZoZoZoZoZoZoZBGBGBGMQ
MQBGBGBGBGBGoZoZoZAcoZAcAcdgdgAcAcNKNKXuXuXuXuNKNKKcjrjrKcCpjrjrjrjrKcjrjrKcjrjrjrKcKcjrjrjrKcjrjrKcjrjrKcjrjrjrjrjrNKNKXuXuXuXuNKNKKcjrjrjrjrjrjrKcjrjrjrjrjrKcjrjrjrjrKcoZoZoZoZoZoZoZoZoZoZoZBGBGBGMQ
MQBGBGBGBGBGoZoZoZAcAcAcAcdgdgAcoZNKNKXuXuXuXuNKNKKcKcjrKcCpjrjrjrjrKcjrjrKcjrjrjrjrjrjrjrjrjrjrjrjrjrjrjrjrKcjrKcKcNKNKXuXuXuXuNKNKjrjrjrKcjrKcjrKcjrjrKcjrjrjrjrjrKcjrKcoZoZoZoZoZoZoZoZoZoZoZBGBGBGMQ
MQBGBGBGBGBGoZoZoZoZAcAcAcdgdgAcAcNKNKXuXuXuXuNKNKNKKcKcKcKcKcKcKcKcKcsQsQKcKcKcKcKcKcKcKcKcKcKcKcKcsQsQKcKcKcKcKcNKNKNKXuXuXuXuNKNKKcjrjrjrjrjrjrjrjrjrjrjrjrKcjrjrjrjrKcoZoZoZoZoZoZoZoZoZoZoZBGBGBGMQ
MQBGBGBGBGBGoZoZoZoZAcoZAcdgdgAcAcNKNKXuXuXuXuNKNKNKNKNKNKNKNKNKNKNKNKNKNKNKNKNKNKNKNKNKNKNKNKNKNKNKNKNKNKNKNKNKNKNKNKNKXuXuXuXuNKNKKcKcKcjrKcKcKcKcjrjrjrjrjrKcjrjrjrjrKcoZoZoZoZoZoZoZoZoZoZoZBGBGBGMQ
MQBGBGBGBGBGoZoZoZoZAcoZdgdgdgdgAcNKNKXuXuXuXuXuNKNKNKNKNKNKNKNKNKNKNKNKNKNKNKNKNKNKNKNKNKNKNKNKNKNKNKNKNKNKNKNKNKNKNKXuXuXuXuXuNKNKsQjrjrjrjrjrjrKcKcKcKcKcKcKcKcKcjrKcKcoZoZoZoZoZoZoZoZoZoZoZBGBGBGMQ
MQBGBGBGBGBGoZoZoZoZAcAcdgeYeYdgoZNKNKXuXuXuXuXuXuXuXuXuXuXuXuXuXuXuXuXuXuXuXuXuXuXuXuXuXuXuXuXuXuXuXuXuXuXuXuXuXuXuXuXuXuXuXuXuNKNKsQjrjrKcjrjrjrjroZoZoZoZoZoZoZoZoZoZoZoZoZoZoZoZoZoZoZoZoZoZBGBGBGMQ
MQBGBGBGBGBGoZoZoZoZAcAcdgeYeYdgoZNKNKXuXuXuXuXuXuXuXuXuXuXuXuXuXuXuXuXuXuXuXuXuXuXuXuXuXuXuXuXuXuXuXuXuXuXuXuXuXuXuXuXuXuXuXuXuNKNKKcjrjrjrjrKcKcKcoZoZoZoZoZoZoZoZoZoZoZoZoZoZoZoZoZoZoZoZoZoZoZBGBGMQ
MQBGBGBGBGoZoZoZoZoZAcAcdgdgdgdgAcNKNKXuXuXuXuXuXuXuXuXuXuXuXuXuXuXuXuXuXuXuXuXuXuXuXuXuXuXuXuXuXuXuXuXuXuXuXuXuXuXuXuXuXuXuXuXuNKNKKcjrjrjrjrjrCwKcoZoZoZoZoZoZoZoZoZoZoZoZoZoZoZoZoZoZoZoZoZoZoZBGBGMQ
MQBGBGBGBGoZoZoZoZoZoZAcAcdgdgAcAcNKNKXuXuXuXuXuXuXuXuXuXuXuXuXuXuXuXuXuXuXuXuXuXuXuXuXuXuXuXuXuXuXuXuXuXuXuXuXuXuXuXuXuXuXuXuXuNKNKKcKcKcsQsQKcKcKcoZoZoZoZoZoZoZoZoZoZoZoZoZoZoZoZoZoZoZoZoZoZoZBGBGMQ
MQBGBGBGBGoZoZoZoZoZoZAcAcdgdgAcoZNKNKNKNKNKNKNKNKNKNKNKNKNKNKNKNKNKNKNKNKNKNKNKNKNKNKNKNKNKNKNKNKNKNKNKNKNKNKNKNKNKNKXuXuXuXuXuNKNKoZoZoZoZoZAcoZAcAcoZAcAcAcoZoZoZoZAcAcAcAcoZoZoZoZAcAcAcAcAcAcAcBGMQ
MQBGBGBGBGoZoZoZoZoZoZAcAcdgdgAcoZNKNKNKNKNKNKNKNKNKNKNKNKNKNKNKNKNKNKNKNKNKNKNKNKNKNKNKNKNKNKNKNKNKNKNKNKNKNKNKNKNKNKNKXuXuXuXuNKNKNKNKNKNKNKNKNKNKAcAcAcNKNKNKNKNKNKAcAcAcNKNKNKAcAcAcNKAcAcAcAcAcAcMQ
MQBGBGBGBGoZoZoZoZoZoZoZAcdgdgAcAcoZKcKcsQsQKcjrKcKcKcKcKcKcKcKcjrKcsQsQKcKcoZKcKcjrKcKcsQsQKcsQsQKcKcKcyJyJKcKcKcKcNKNKXuXuXuXuXuNKNKNKNKNKNKNKAcAcAcAcAcAcAcNKNKNKAcAcAcNKNKNKNKNKNKNKAcAcNKAcAcAcAcMQ
MQBGBGBGBGoZoZoZoZoZoZAcAcdgdgAcAcoZKcjrjrjrKcjrjrjrKcjrjrjrjrKcjrjrjrjrjrKcoZKcjrjrjrjrjrjrKcjrjrjrjrKcyJyJKcpIpIKcNKNKXuXuXuXuXuXuXuXuXuXuXuXuXuXuXuXuXuXuXuXuXuXuXuXuXuXuXuXuXuXuXuXuXuXuXuXuXuXuXuMQ
MQBGBGBGBGoZoZoZoZoZAcAcAcdgdgAcAcoZKcjrjrjrKcjrKcjrKcjrKcjrjrKcjrjrjrjrjrKcoZKcjrKcjrjrjrjrjrjrjrKcjrKcyJyJKcpIpIKcNKNKXuXuXuXuXuXuXuXuXuXuXuXuXuXuXuXuXuXuXuXuXuXuXuXuXuXuXuXuXuXuXuXuXuXuXuXuXuXuXuMQ
MQBGBGBGBGoZoZoZoZoZAcAcdgdgdgdgAcAcKcjrKcjrjrjrjrjrKcjrjrKcjrKcjrjrKcKcKcKcoZKcjrjrjrKcjrjrKcjrjrjrjrjryJyJKcKcKcKcNKNKXuXuXuXuXuXuXuXuXuXuXuXuXuXuXuXuXuXuXuXuXuXuXuXuXuXuXuXuXuXuXuXuXuXuXuXuXuXuXuMQ
MQBGBGBGBGoZoZoZoZoZAcAcdgeYeYdgAcAcKcjrjrjrKcjrKcjrKcjrjrjrjrjrjrjrKcPCPCKcoZKcjrjrjrjrjrjrKcjrKcjrjrjryJyJyJyJyJyJNKNKXuXuXuXuXuXuXuXuXuXuXuXuXuXuXuXuXuXuXuXuXuXuXuXuXuXuXuXuXuXuXuXuXuXuXuXuXuXuXuMQ
MQBGBGBGBGoZoZoZoZoZAcAcdgeYeYdgAcAcKcKcKcKcKcjrjrjrKcKcjrjrKcKcKcKcKcjrjrKcoZKcKcKcKcjrKcKcKcjrjrjrjrKcyJyJyJyJyJyJAcNKNKAcAcAcAcAcAcAcAcAcAcAcAcAcAcAcAcAcAcAcAcAcAcAcAcAcAcAcAcAcAcAcAcAcAcAcAcAcAcMQ
MQBGBGBGBGoZoZoZoZoZAcAcdgdgdgdgAcAcKcjrjrjrKcKcjrKcKcjrjrjrjrjrjrKcjrjrjrKcoZKcjrjrjrjrjrjrKcKcKcKcKcKcKcKcsQsQKcKcNKNKAcNKNKAcAcAcAcAcAcAcAcAcAcAcAcAcAcAcAcAcAcAcAcAcAcAcAcAcAcAcAcAcAcAcAcAcAcAcAcMQ
MQBGBGBGBGBGoZoZoZoZoZAcAcdgdgAcAcoZKcjrjrjrjrjrjrjrjrjrjrjrjrjrjrKcjrKcjrjroZKcjrjrKcKcjrjrjrjrjrjrKcjrjrjrjrjrjrKcoZoZoZoZBGBGBGoZAcAcAcBGBGAcAcAcAcAcAcAcAcAcAcAcAcAcAcAcAcAcAcAcAcAcAcAcAcAcAcAcoZMQ
MQBGBGBGBGBGoZoZoZoZoZAcAcdgdgAcAcoZjrjrKcjrKcjrKcjrKcjrKcjrKcjrjrjrjrjrjrKcoZKcjrjrjrKcjrKcjrKcjrjrKcjrjrKcjrjrjrjroZoZBGBGBGBGBGBGBGBGBGBGBGBGBGoZAcAcAcAcAcAcoZBGAcAcAcAcoZBGBGAcAcAcAcAcAcoZBGBGBGMQ
MQBGBGBGBGBGoZoZoZoZoZAcAcdgdgAcAcoZKcjrjrjrjrjrjrjrKcjrjrjrjrjrjrKcjrjrjrKcoZKcjrjrjrjrjrjrjrjrjrjrjrjrjrjrjrjrjrKcoZoZBGBGBGBGBGBGBGBGBGBGBGBGBGBGBGoZoZBGBGBGBGBGBGBGBGBGBGBGBGBGBGBGBGBGBGBGBGBGBGMQ
RTBGBGBGBGBGBGoZoZoZAcAcAcdgdgAcAcoZKcKcsQsQKcKcKcKcKcKcKcKcKcKcKcKcsQsQKcKcoZKcKcKcKcKcKcKcKcKcKcKcKcKcKcKcKcKcKcKcoZBGBGBGBGBGBGBGBGBGBGBGBGBGBGBGBGBGBGBGBGBGBGBGBGBGBGBGBGBGBGBGBGBGBGBGBGBGBGBGBGMQ
RTBGBGBGBGBGBGoZoZoZAcAcAcdgdgAcAcAcoZoZoZoZoZoZoZoZoZoZoZoZoZoZoZoZoZoZoZoZoZoZoZoZoZoZoZoZoZoZoZoZoZoZoZoZoZoZoZoZoZBGBGBGBGBGBGBGBGBGBGBGBGBGBGBGBGBGBGBGBGBGBGBGBGBGBGBGBGBGBGBGBGBGBGBGBGBGBGBGBGMQ
RTalalaluEuEuEuEuEuEuEHgHgcPcPHgHgHguEuEHguEuEuEuEuEuEuEuEuEuEuEuEuEuEuEuEuEuEuEuEVvVvVvVvVvVvVvVvVvVvuEVvVvVvVvVvVvuEuEuEuEuEuEuEuEuEuEuEuEuEuEuEuEuEuEuEuEuEuEuEuEuEuEuEuEuEuEuEuEuEuEuEuEuEuEuEuEuEMQ
RTBGBGBGBGBGBGBGBGBGBGAcdgdgdgdgAcAcBGAcAcAcAcBGBGBGBGBGBGBGBGBGBGBGBGBGBGBGBGBGBGBGBGBGBGBGBGBGBGBGoZoZoZoZoZBGBGBGBGBGBGBGBGBGBGBGBGBGBGBGBGBGBGBGBGBGBGBGBGBGBGBGBGBGBGBGBGBGBGBGBGBGBGBGBGBGBGBGBGMQ
RTBGBGBGBGBGBGBGBGBGBGBGdgeYeYdgAcAcBGBGAcAcBGBGBGBGBGBGBGBGBGBGBGBGBGBGBGBGBGBGBGBGBGBGBGBGBGBGBGBGBGBGBGBGBGBGBGBGBGBGBGBGBGBGBGBGBGBGBGBGBGBGBGBGBGBGBGBGBGBGBGBGBGBGBGBGBGBGBGBGBGBGBGBGBGBGBGBGBGMQ
RTBGBGBGBGBGBGBGBGBGBGBGdgeYeYdgAcBGBGBGBGBGBGBGBGBGBGBGBGBGBGBGBGBGBGBGBGBGBGBGBGBGBGBGBGBGBGBGBGBGBGBGBGBGBGBGBGBGBGBGBGBGBGBGBGBGBGBGBGBGBGBGBGBGBGBGBGBGBGBGBGBGBGBGBGBGBGBGBGBGBGBGBGBGBGBGBGBGBGMQ
xFMQMQMQMQMQMQMQMQMQMQMQMQMQMQMQMQMQMQMQMQMQMQMQMQMQMQMQMQMQMQMQMQMQMQMQMQMQMQMQMQMQMQMQMQMQMQMQMQMQMQMQMQMQMQMQMQMQMQMQMQMQMQMQMQMQMQMQMQMQMQMQMQMQMQMQMQMQMQMQMQMQMQMQMQMQMQMQMQMQMQMQMQMQMQMQMQMQMQMQ
"}
