//MAP CONVERTED BY dmm2tgm.py THIS HEADER COMMENT PREVENTS RECONVERSION, DO NOT REMOVE
"a" = (
/turf/template_noop,
/area/template_noop)
"b" = (
/turf/simulated/wall/sandstonediamond,
/area/template_noop)
"c" = (
/turf/simulated/floor/fixed/alium,
/area/template_noop)
"e" = (
/obj/structure/fountain,
/turf/template_noop,
/area/template_noop)
"r" = (
/turf/simulated/wall/sandstone,
/area/template_noop)
"H" = (
/obj/structure/monolith{
	active = 1;
	pixel_y = 10
	},
/turf/simulated/floor/fixed/alium,
/area/template_noop)
"K" = (
/obj/random/loot,
/turf/template_noop,
/area/template_noop)

(1,1,1) = {"
a
a
a
a
a
a
a
a
b
c
b
a
a
a
a
a
a
a
a
"}
(2,1,1) = {"
a
a
a
a
r
r
r
c
c
c
c
c
r
r
r
a
a
a
a
"}
(3,1,1) = {"
a
a
r
r
r
K
a
a
b
c
b
a
a
a
r
r
r
a
a
"}
(4,1,1) = {"
a
a
r
c
c
c
c
c
c
c
c
c
c
c
c
c
r
a
a
"}
(5,1,1) = {"
a
r
r
c
H
a
b
a
b
c
b
a
b
a
H
c
r
r
a
"}
(6,1,1) = {"
a
r
a
c
a
c
c
c
c
c
c
c
c
c
K
c
a
r
a
"}
(7,1,1) = {"
a
r
a
c
b
c
H
a
b
c
b
a
H
c
b
c
a
r
a
"}
(8,1,1) = {"
a
c
a
c
a
c
a
a
c
c
c
a
a
c
a
c
a
c
a
"}
(9,1,1) = {"
b
c
b
c
b
c
b
c
c
a
c
c
b
c
b
c
b
c
b
"}
(10,1,1) = {"
c
c
c
c
c
c
c
c
a
e
a
c
c
c
c
c
c
c
c
"}
(11,1,1) = {"
b
c
b
c
b
c
b
c
c
a
c
c
b
c
b
c
b
c
b
"}
(12,1,1) = {"
a
c
a
c
a
c
a
a
c
c
c
a
a
c
a
c
a
c
a
"}
(13,1,1) = {"
a
r
a
c
b
c
H
a
b
c
b
a
H
c
b
c
K
r
a
"}
(14,1,1) = {"
a
r
a
c
a
c
c
c
c
c
c
c
c
c
a
c
a
r
a
"}
(15,1,1) = {"
a
r
r
c
H
a
b
a
b
c
b
a
b
a
H
c
r
r
a
"}
(16,1,1) = {"
a
a
r
c
c
c
c
c
c
c
c
c
c
c
c
c
r
a
a
"}
(17,1,1) = {"
a
a
r
r
r
K
a
a
b
c
b
a
a
a
r
r
r
a
a
"}
(18,1,1) = {"
a
a
a
a
r
r
r
c
c
c
c
c
r
r
r
a
a
a
a
"}
(19,1,1) = {"
a
a
a
a
a
a
a
a
b
c
b
a
a
a
a
a
a
a
a
"}
