"a" = (/obj/structure/vehiclewall{dir = 9},/turf/simulated/open,/area/interior)
"b" = (/obj/structure/vehiclewall{dir = 1},/obj/structure/closet/secure_closet/medical_wall/pills{pixel_y = 5},/turf/simulated/open,/area/interior)
"d" = (/obj/structure/vehiclewall{dir = 1},/turf/simulated/open,/area/interior)
"e" = (/obj/structure/vehiclewall{dir = 5},/turf/simulated/open,/area/interior)
"f" = (/obj/structure/vehiclewall{dir = 8},/turf/simulated/open,/area/interior)
"g" = (/obj/structure/bed/chair/shuttle{dir = 4},/turf/simulated/floor/tiled/monotile_dark,/area/interior)
"h" = (/turf/simulated/floor/tiled/monotile_dark,/area/interior)
"i" = (/obj/structure/bed/chair/shuttle{dir = 8},/turf/simulated/floor/tiled/monotile_dark,/area/interior)
"j" = (/obj/structure/vehiclewall{dir = 4},/turf/simulated/open,/area/interior)
"k" = (/obj/machinery/monitor,/obj/structure/table/standard,/turf/simulated/floor/tiled/monotile_dark,/area/interior)
"l" = (/obj/structure/table/standard,/obj/machinery/defibrillator,/turf/simulated/floor/tiled/monotile_dark,/area/interior)
"m" = (/obj/structure/bed,/turf/simulated/floor/tiled/monotile_dark,/area/interior)
"n" = (/obj/structure/table/standard,/obj/item/intubation_tube,/obj/item/intubation_tube,/obj/item/weapon/reagent_containers/syringe,/obj/item/weapon/reagent_containers/syringe,/turf/simulated/floor/tiled/monotile_dark,/area/interior)
"o" = (/obj/structure/vehiclewall{dir = 8; layer = 2.9},/turf/simulated/open,/area/interior)
"p" = (/obj/structure/railing{dir = 1},/obj/structure/table/rack,/obj/item/weapon/reagent_containers/syringe/adrenaline,/obj/item/weapon/reagent_containers/syringe/adrenaline,/obj/item/weapon/reagent_containers/glass/bottle/dopamine,/obj/item/weapon/reagent_containers/glass/bottle/ampoule/morphine,/obj/item/weapon/reagent_containers/glass/bottle/ampoule/morphine,/obj/item/weapon/reagent_containers/glass/bottle/ampoule/amicile,/turf/simulated/floor/tiled/monotile_dark,/area/interior)
"q" = (/obj/effect/vehicle_entrance,/obj/machinery/light/invis,/turf/simulated/floor/tiled/monotile_dark,/area/interior)
"r" = (/obj/structure/table/standard,/turf/simulated/floor/tiled/monotile_dark,/area/interior)
"s" = (/obj/structure/vehiclewall{dir = 4; layer = 2.9},/turf/simulated/open,/area/interior)
"t" = (/obj/structure/vehiclewall{dir = 10},/turf/simulated/open,/area/interior)
"u" = (/obj/structure/vehiclewall/ambulance,/turf/simulated/open,/area/interior)
"v" = (/obj/structure/vehicledoor,/turf/simulated/open,/area/interior)
"w" = (/obj/structure/vehiclewall{dir = 6},/turf/simulated/open,/area/interior)

(1,1,1) = {"
abdde
fghij
fkhlj
fmhnj
opqrs
tuvuw
"}
