"cc" = (/obj/structure/catwalk,/obj/effect/decal/cleanable/dirt,/obj/effect/decal/cleanable/generic,/turf/simulated/floor/plating,/area/template_noop)
"dF" = (/obj/structure/railing/mapped{dir = 1},/obj/effect/decal/cleanable/dirt,/turf/template_noop,/area/template_noop)
"fs" = (/obj/effect/floor_decal/borderfloor{dir = 5},/obj/effect/decal/cleanable/dirt,/turf/simulated/floor/tiled/steel_ridged,/area/template_noop)
"fD" = (/obj/structure/railing/mapped{dir = 1},/turf/unsimulated/floor/exoplanet/barren,/area/template_noop)
"gK" = (/obj/effect/decal/cleanable/dirt,/obj/effect/decal/cleanable/dirt,/turf/unsimulated/floor/exoplanet/barren,/area/template_noop)
"hk" = (/obj/effect/floor_decal/borderfloor{dir = 5},/obj/effect/floor_decal/industrial/warning{dir = 4},/turf/simulated/floor/tiled/steel_ridged,/area/template_noop)
"hu" = (/obj/effect/floor_decal/borderfloor{dir = 6},/obj/effect/floor_decal/industrial/warning{dir = 4},/turf/simulated/floor/tiled/steel_ridged,/area/template_noop)
"hQ" = (/turf/unsimulated/floor/exoplanet/barren,/area/template_noop)
"id" = (/obj/effect/floor_decal/techfloor/orange{dir = 8},/obj/effect/floor_decal/industrial/warning{dir = 4},/turf/simulated/floor/tiled/techfloor/grid,/area/template_noop)
"ip" = (/obj/effect/floor_decal/borderfloor,/obj/effect/floor_decal/industrial/warning{dir = 1},/turf/simulated/floor/tiled/steel_ridged,/area/template_noop)
"jL" = (/obj/effect/floor_decal/techfloor/orange{dir = 4},/obj/effect/floor_decal/industrial/warning{dir = 8},/obj/structure/closet/crate,/turf/simulated/floor/tiled/techfloor/grid,/area/template_noop)
"jW" = (/obj/structure/railing/mapped{dir = 1},/obj/structure/railing/mapped{dir = 8; icon_state = "railing0-1"},/turf/template_noop,/area/template_noop)
"kJ" = (/obj/structure/catwalk,/obj/item/storage/cargo_containers{icon_state = "watatsumi_r"; layer = 4.09},/turf/simulated/floor/plating,/area/template_noop)
"mq" = (/obj/effect/floor_decal/industrial/hatch/yellow,/obj/item/storage/cargo_containers{icon_state = "watatsumi_l"},/obj/effect/decal/cleanable/dirt,/turf/simulated/floor/tiled/techfloor,/area/template_noop)
"mt" = (/obj/structure/catwalk,/obj/item/storage/cargo_containers{icon_state = "lockmart_l"},/obj/item/storage/cargo_containers{icon_state = "grant_lm"; layer = 4.10; pixel_y = 23},/turf/simulated/floor/plating,/area/template_noop)
"oZ" = (/turf/template_noop,/area/template_noop)
"pJ" = (/obj/effect/floor_decal/industrial/hatch/yellow,/obj/item/storage/cargo_containers{icon_state = "lockmart_r"},/obj/item/storage/cargo_containers{icon_state = "grant_r"; layer = 4.10; pixel_y = 23},/obj/structure/largecrate{layer = 4.09; pixel_x = -4; pixel_y = -8},/turf/simulated/floor/tiled/techfloor,/area/template_noop)
"pQ" = (/turf/simulated/floor/tiled/techfloor/grid,/area/template_noop)
"qg" = (/obj/structure/railing/mapped{dir = 1},/obj/structure/railing/mapped{dir = 4; icon_state = "railing0-1"},/turf/template_noop,/area/template_noop)
"sn" = (/turf/simulated/floor/plating,/area/template_noop)
"sp" = (/obj/effect/wallframe_spawn/reinforced,/turf/simulated/floor/plating,/area/template_noop)
"ti" = (/turf/simulated/mineral/volcanic,/area/template_noop)
"tM" = (/obj/effect/decal/cleanable/dirt,/turf/simulated/wall/r_wall,/area/template_noop)
"wX" = (/obj/structure/railing/mapped,/turf/unsimulated/floor/exoplanet/barren,/area/template_noop)
"xp" = (/obj/effect/floor_decal/borderfloor{dir = 1},/obj/effect/floor_decal/industrial/warning,/obj/effect/decal/cleanable/dirt,/turf/simulated/floor/tiled/steel_ridged,/area/template_noop)
"yt" = (/obj/structure/railing/mapped,/turf/template_noop,/area/template_noop)
"zc" = (/obj/effect/floor_decal/industrial/hatch/yellow,/obj/structure/closet/crate/hydroponics,/obj/effect/decal/cleanable/dirt,/turf/simulated/floor/tiled/techfloor,/area/template_noop)
"zg" = (/obj/effect/floor_decal/borderfloor,/obj/effect/floor_decal/industrial/warning{dir = 1},/obj/effect/decal/cleanable/generic,/turf/simulated/floor/tiled/steel_ridged,/area/template_noop)
"zO" = (/obj/structure/catwalk,/obj/item/storage/cargo_containers{icon_state = "watatsumi_m"; layer = 4.09},/turf/simulated/floor/plating,/area/template_noop)
"zR" = (/obj/structure/catwalk,/turf/simulated/floor/plating,/area/template_noop)
"zU" = (/obj/structure/catwalk,/obj/random/trash,/obj/random/trash,/turf/simulated/floor/plating,/area/template_noop)
"zV" = (/obj/effect/floor_decal/techfloor/orange{dir = 8},/obj/effect/floor_decal/industrial/warning/corner{dir = 4},/obj/effect/floor_decal/industrial/warning/corner,/turf/simulated/floor/tiled/techfloor/grid,/area/template_noop)
"AA" = (/obj/structure/railing/mapped{dir = 8; icon_state = "railing0-1"},/turf/template_noop,/area/template_noop)
"Ce" = (/obj/effect/floor_decal/borderfloor{dir = 1},/obj/effect/floor_decal/industrial/warning,/turf/simulated/floor/tiled/steel_ridged,/area/template_noop)
"CT" = (/obj/structure/railing/mapped{dir = 1},/turf/template_noop,/area/template_noop)
"Dg" = (/obj/structure/railing/mapped,/obj/structure/railing/mapped{dir = 8; icon_state = "railing0-1"},/turf/unsimulated/floor/exoplanet/barren,/area/template_noop)
"Dn" = (/obj/effect/floor_decal/borderfloor,/obj/effect/floor_decal/borderfloor{dir = 1},/obj/effect/floor_decal/industrial/warning{dir = 1},/obj/effect/floor_decal/industrial/warning,/obj/effect/decal/cleanable/dirt,/turf/simulated/floor/tiled/steel_ridged,/area/template_noop)
"EC" = (/turf/simulated/floor/tiled/techfloor,/area/template_noop)
"FD" = (/obj/effect/floor_decal/borderfloor,/obj/effect/floor_decal/industrial/warning{dir = 1},/obj/item/storage/cargo_containers{icon_state = "trijent_m"},/turf/simulated/floor/tiled/steel_ridged,/area/template_noop)
"FF" = (/obj/effect/floor_decal/borderfloor,/obj/effect/floor_decal/industrial/warning{dir = 1},/obj/structure/closet/crate/medical,/obj/effect/decal/cleanable/dirt,/turf/simulated/floor/tiled/steel_ridged,/area/template_noop)
"FU" = (/obj/effect/floor_decal/industrial/hatch/yellow,/obj/item/storage/cargo_containers{icon_state = "lockmart_m"},/obj/item/storage/cargo_containers{icon_state = "grant_rm"; layer = 4.10; pixel_y = 23},/turf/simulated/floor/tiled/techfloor,/area/template_noop)
"Gk" = (/obj/effect/floor_decal/borderfloor,/obj/effect/floor_decal/industrial/warning{dir = 1},/obj/structure/closet/crate/critter,/turf/simulated/floor/tiled/steel_ridged,/area/template_noop)
"HX" = (/obj/effect/floor_decal/borderfloor{dir = 1},/obj/effect/floor_decal/industrial/warning,/obj/structure/closet/crate,/obj/effect/decal/cleanable/dirt,/turf/simulated/floor/tiled/steel_ridged,/area/template_noop)
"Ic" = (/obj/effect/floor_decal/borderfloor{dir = 9},/turf/simulated/floor/tiled/steel_ridged,/area/template_noop)
"It" = (/obj/effect/decal/cleanable/dirt,/obj/effect/decal/cleanable/dirt,/turf/template_noop,/area/template_noop)
"Je" = (/obj/effect/floor_decal/borderfloor,/obj/effect/floor_decal/industrial/warning{dir = 1},/obj/item/storage/cargo_containers{icon_state = "trijent_l"},/turf/simulated/floor/tiled/steel_ridged,/area/template_noop)
"KG" = (/obj/effect/decal/cleanable/dirt,/turf/unsimulated/floor/exoplanet/barren,/area/template_noop)
"KU" = (/obj/structure/railing/mapped,/obj/structure/railing/mapped{dir = 8; icon_state = "railing0-1"},/turf/template_noop,/area/template_noop)
"Lt" = (/obj/effect/floor_decal/borderfloor,/obj/effect/floor_decal/industrial/warning{dir = 1},/obj/item/storage/cargo_containers{icon_state = "trijent_r"},/turf/simulated/floor/tiled/steel_ridged,/area/template_noop)
"Mu" = (/obj/effect/floor_decal/industrial/hatch/yellow,/turf/simulated/floor/tiled/techfloor,/area/template_noop)
"Nd" = (/obj/structure/railing/mapped{dir = 4; icon_state = "railing0-1"},/turf/template_noop,/area/template_noop)
"NH" = (/obj/effect/floor_decal/techfloor/orange{dir = 4},/obj/effect/floor_decal/industrial/warning/corner{dir = 1},/obj/effect/floor_decal/industrial/warning/corner{dir = 8},/obj/effect/decal/cleanable/dirt,/turf/simulated/floor/tiled/techfloor/grid,/area/template_noop)
"NS" = (/obj/effect/floor_decal/techfloor/orange{dir = 4},/obj/effect/floor_decal/industrial/warning{dir = 8},/obj/random/trash,/turf/simulated/floor/tiled/techfloor/grid,/area/template_noop)
"NZ" = (/obj/structure/railing/mapped,/obj/effect/decal/cleanable/dirt,/turf/template_noop,/area/template_noop)
"PU" = (/obj/structure/railing/mapped,/obj/structure/railing/mapped{dir = 4; icon_state = "railing0-1"},/obj/effect/decal/cleanable/dirt,/turf/template_noop,/area/template_noop)
"PX" = (/obj/effect/floor_decal/borderfloor{dir = 4},/obj/effect/floor_decal/borderfloor{dir = 8},/obj/effect/floor_decal/industrial/warning{dir = 4},/obj/effect/floor_decal/industrial/warning{dir = 8},/turf/simulated/floor/tiled/steel_ridged,/area/template_noop)
"Rb" = (/obj/effect/floor_decal/techfloor/orange{dir = 8},/obj/effect/floor_decal/industrial/warning{dir = 4},/obj/effect/decal/cleanable/dirt,/turf/simulated/floor/tiled/techfloor/grid,/area/template_noop)
"Rt" = (/obj/effect/floor_decal/borderfloor,/obj/effect/floor_decal/borderfloor{dir = 1},/obj/effect/floor_decal/industrial/warning{dir = 1},/obj/effect/floor_decal/industrial/warning,/turf/simulated/floor/tiled/steel_ridged,/area/template_noop)
"Sq" = (/obj/effect/floor_decal/borderfloor{dir = 4},/obj/effect/floor_decal/industrial/warning/corner{dir = 4},/obj/effect/floor_decal/industrial/warning/corner,/turf/simulated/floor/tiled/steel_ridged,/area/template_noop)
"SF" = (/obj/structure/railing/mapped{dir = 1},/obj/structure/railing/mapped{dir = 8; icon_state = "railing0-1"},/turf/unsimulated/floor/exoplanet/barren,/area/template_noop)
"Te" = (/obj/effect/floor_decal/industrial/outline/yellow,/obj/effect/decal/cleanable/dirt,/turf/simulated/floor/tiled/techfloor,/area/template_noop)
"TW" = (/obj/structure/catwalk,/obj/structure/closet/crate/large,/turf/simulated/floor/plating,/area/template_noop)
"Uc" = (/obj/effect/decal/cleanable/dirt,/turf/template_noop,/area/template_noop)
"Uy" = (/obj/effect/floor_decal/industrial/outline/yellow,/turf/simulated/floor/tiled/techfloor,/area/template_noop)
"We" = (/obj/structure/railing/mapped{dir = 4; icon_state = "railing0-1"},/turf/unsimulated/floor/exoplanet/barren,/area/template_noop)
"Wf" = (/turf/simulated/wall/r_wall,/area/template_noop)
"Wi" = (/obj/effect/floor_decal/industrial/hatch/yellow,/obj/effect/decal/cleanable/dirt,/turf/simulated/floor/tiled/techfloor,/area/template_noop)
"Ya" = (/obj/structure/closet/crate/freezer/rations,/turf/template_noop,/area/template_noop)
"Yj" = (/obj/effect/floor_decal/borderfloor{dir = 1},/obj/effect/floor_decal/industrial/warning,/obj/structure/closet/crate/solar_assembly,/turf/simulated/floor/tiled/steel_ridged,/area/template_noop)

(1,1,1) = {"
oZoZoZoZoZoZoZoZoZoZoZoZoZoZoZoZoZoZoZoZoZoZoZoZoZoZoZoZoZoZoZoZoZoZoZoZoZoZoZoZoZoZoZoZoZoZoZoZoZoZoZoZoZoZoZoZoZoZoZoZ
oZoZoZoZoZoZoZoZoZoZoZoZoZoZoZoZoZoZoZoZoZoZoZoZoZoZoZoZoZUcoZoZoZUcUcUcoZoZoZoZUcoZoZoZoZoZoZoZoZoZoZoZoZoZoZoZoZoZoZoZ
oZoZoZoZoZoZoZoZoZoZoZhQhQoZoZoZoZoZoZoZoZoZoZoZoZoZUcItUcUcoZoZoZItUcUchQKGKGKGoZoZoZoZoZoZoZoZoZoZoZoZoZoZoZoZoZoZoZoZ
oZoZoZhQoZoZoZoZoZWfoZoZoZoZhQoZoZoZoZoZoZoZoZoZoZoZoZytNZNZNZytytytwXytoZoZKGUcoZoZoZoZUcItoZoZoZoZoZWfWfWfWfWfoZoZoZoZ
oZWfWfWfWfWfoZoZoZWfWftMoZoZoZoZoZoZoZoZoZoZoZoZoZoZWfzgJeFDLtipipFFipGkWfoZoZoZoZItoZoZoZoZoZoZoZoZoZoZsnWfsnoZoZoZoZoZ
oZoZsnWfWfsnhQoZoZWfWfsnhQKGoZoZhQoZoZoZoZoZoZoZoZPUNSUyTWzRzRzRMuMufsUyRbDgoZhQhQUcoZUcoZoZoZUcWfWfWfWfWfWfWfWfWfWfWfoZ
oZspWfWfWfWfWfWfWfWfWfWfoZoZhQUcKGUcoZhQoZoZoZoZoZDnNHzRzRWiMumtFUpJzUzRzVDnhQhQoZKGoZoZoZoZoZytWfsnsnsnsnsnsnsnsnsnWfyt
spsppQpQECpQpQpQpQpQWfhkKUhQUchQKGhQoZoZoZoZUcoZoZqgjLUyIczcmqzOkJzRccTeidjWoZhQhQhQKGoZUcItoZRtsnsnsnsnsnsnsnsnsnsnsnRt
sppQpQECECzRzRzRECpQpQSqRtoZoZoZoZUcoZoZoZoZoZoZoZoZtMCeCeCeHXCeCexpCeYjtMhQhQhQoZUcoZoZtitioZCTWfsnsnsnsnsnsnsnsnsnWfCT
spsppQpQECpQpQpQpQpQWfhuSFoZhQUcUcoZItItWfWfWfWfWfoZoZfDCTCTCTCTCTCTCTfDoZoZoZUcoZUcoZtititioZoZWfWfWfWfWfWfWfWfWfWfWfoZ
oZspWfWfWfWfWfWfWfWfWfWfoZoZoZoZoZoZUcUcoZsnWfsnoZUcKGKGUcUcKGoZoZoZoZoZUcoZoZhQhQoZtitititioZoZoZoZoZoZsnWfsnoZoZoZoZoZ
oZoZsnWfWfsnoZUcoZWfWfsnhQhQKGoZoZWfWfWfWfWfWfWfWfWfWfWfoZoZhQhQoZhQUcUcUcoZoZoZtitititititioZoZoZoZoZWfWfWfWfWfoZoZoZoZ
oZWfWfWfWfWfoZoZUcWfWfWfoZKGoZhQytWfsnsnsnsnsnsnsnsnsnWfythQhQKGhQKGhQhQoZUcoZoZtititititioZoZtioZoZoZoZoZoZoZoZoZoZoZoZ
oZoZhQhQhQhQhQoZUcWfoZhQoZUcUcoZRtsnsnsnsnsnsnsnsnsnsnsnRthQhQhQoZoZoZoZoZKGoZoZtitititititititioZoZoZoZoZoZoZoZoZoZoZoZ
oZoZoZoZKGUcoZhQoZoZoZoZoZoZoZUcdFWfsnsnsnsnsnsnsnsnsnWfCToZgKUcoZUcItoZhQhQoZoZtititititititititioZoZoZoZoZoZoZoZoZoZoZ
oZoZoZoZoZoZoZUcoZUcUcoZoZoZoZoZUctMWfWfWfWfWfWfWfWfWfWfhQoZUcoZhQoZWePXAAoZKGItoZtititititititititioZoZoZoZoZoZoZoZoZoZ
oZoZoZoZoZoZoZoZoZUcUcoZoZoZoZoZoZUcoZoZoZsnWfsnoZhQKGUcoZoZoZoZoZWfWfsnWfWfhQKGtitititititititititioZoZoZoZoZoZoZoZoZoZ
oZoZoZoZoZoZoZoZoZoZoZoZoZoZoZoZoZoZoZoZWfWfWfWfWfUcgKYaoZoZhQoZhQWfsnsnsnWfoZoZhQoZtititititititioZoZoZoZoZoZoZoZoZoZoZ
oZoZoZoZoZoZoZoZoZoZoZoZoZoZoZoZoZoZoZoZoZoZoZoZoZoZoZKGhQhQUcoZhQWfsnsnsnWfoZhQKGUcoZtititititioZoZoZoZoZoZoZoZoZoZoZoZ
oZoZoZoZoZoZoZtioZoZoZoZoZoZoZoZoZoZoZoZoZoZoZoZoZoZoZoZKGKGoZWfoZWfsnsnsnWfoZWfhQUcoZoZoZtitioZoZoZoZoZoZoZoZoZoZoZoZoZ
oZoZoZoZoZoZoZtitioZoZoZoZoZoZoZoZoZoZoZoZoZoZoZoZoZoZoZKGUchQWfsnWfsnsnsnWfsnWfUcoZoZoZoZoZoZoZoZoZoZoZoZoZoZoZoZoZoZoZ
oZoZoZoZoZoZtititititioZoZoZoZoZoZoZoZoZoZoZoZoZoZoZoZoZUcItoZWfWfWfsnsnsnWfWfWfUchQoZoZoZoZoZoZoZoZoZoZoZoZoZoZoZoZoZoZ
oZoZoZoZoZtitititititioZoZoZoZoZoZoZoZoZoZoZoZoZoZoZoZoZoZUchQWfsnWfsnsnsnWfsnWfoZhQoZoZoZoZoZoZoZoZoZoZoZoZoZoZoZoZoZoZ
oZoZoZoZoZtitititititioZoZoZoZoZoZoZoZoZoZoZoZoZoZoZoZoZoZhQKGWfoZWfsnsnsnWfhQWfoZKGoZoZoZoZoZoZoZoZoZoZoZoZoZoZoZoZoZoZ
oZoZoZoZtitititititioZoZoZoZoZoZoZoZoZoZoZoZoZoZoZoZoZoZoZoZIthQoZWfsnsnsnWfoZhQhQoZoZoZoZoZoZoZoZoZoZoZoZoZoZoZoZoZoZoZ
oZoZoZoZoZtitititioZoZoZoZoZoZoZtioZoZoZoZoZoZoZoZoZoZoZoZoZoZhQoZWfsnsnsnWfoZhQKGUcoZoZoZoZoZoZoZoZoZoZoZoZoZoZoZoZoZoZ
oZoZoZoZoZoZoZtitioZoZoZoZoZtititioZoZoZoZoZoZoZoZoZoZoZoZoZoZoZoZWfWfsnWfWfUcUcKGoZoZoZoZoZoZoZoZoZoZoZoZoZoZoZoZoZoZoZ
oZoZoZoZoZoZoZoZoZoZoZoZoZoZtitioZoZoZoZoZoZoZoZoZoZoZoZoZoZoZoZoZoZNdPXAAoZoZoZUcoZoZoZoZoZoZoZoZoZoZoZoZoZoZoZoZoZoZoZ
oZoZoZoZoZoZoZoZoZoZoZoZoZtititioZoZoZoZoZoZoZoZoZoZoZoZoZoZoZoZoZoZoZoZUcoZoZoZoZoZoZoZoZoZoZoZoZoZoZoZoZoZoZoZoZoZoZoZ
oZoZoZoZoZoZoZoZoZoZoZoZoZoZoZoZoZoZoZoZoZoZoZoZoZoZoZoZoZoZoZoZoZoZoZoZoZUcoZoZoZoZoZoZoZoZoZoZoZoZoZoZoZoZoZoZoZoZoZoZ
"}
