"aa" = (/turf/template_noop,/area/template_noop)
"ab" = (/turf/unsimulated/floor/exoplanet/concrete,/area/template_noop)
"ac" = (/obj/effect/decal/cleanable/dirt,/turf/unsimulated/floor/exoplanet/concrete/reinforced/road,/area/template_noop)
"ad" = (/obj/effect/decal/cleanable/dirt,/obj/effect/decal/cleanable/dirt,/turf/unsimulated/floor/exoplanet/concrete/reinforced/road,/area/template_noop)
"ae" = (/turf/unsimulated/floor/exoplanet/concrete/reinforced/road,/area/template_noop)
"af" = (/obj/effect/decal/cleanable/dirt,/turf/unsimulated/floor/exoplanet/concrete,/area/template_noop)
"ag" = (/obj/structure/rubble/house,/turf/unsimulated/floor/exoplanet/concrete,/area/template_noop)
"ah" = (/obj/effect/decal/cleanable/generic,/turf/unsimulated/floor/exoplanet/concrete/reinforced/road,/area/template_noop)
"ai" = (/obj/structure/rubble/house,/turf/unsimulated/floor/exoplanet/concrete/reinforced/road,/area/template_noop)
"aj" = (/obj/effect/decal/cleanable/dirt,/obj/structure/rubble/house,/turf/unsimulated/floor/exoplanet/concrete/reinforced/road,/area/template_noop)
"ak" = (/obj/effect/decal/cleanable/dirt,/obj/effect/decal/cleanable/dirt,/obj/effect/decal/cleanable/dirt,/obj/effect/decal/cleanable/dirt,/turf/unsimulated/floor/exoplanet/concrete/reinforced/road,/area/template_noop)
"al" = (/turf/simulated/wall/r_titanium,/area/map_template/shelters_alt)
"am" = (/obj/effect/decal/cleanable/dirt,/turf/simulated/wall/r_titanium,/area/map_template/shelters_alt)
"an" = (/obj/effect/decal/cleanable/dirt,/obj/structure/railing/mapped,/turf/unsimulated/floor/shuttle_ceiling,/area/template_noop)
"ao" = (/obj/effect/decal/cleanable/dirt,/obj/effect/decal/cleanable/dirt,/obj/structure/railing/mapped,/turf/unsimulated/floor/shuttle_ceiling,/area/template_noop)
"ap" = (/obj/structure/rubble/house,/turf/template_noop,/area/template_noop)
"aq" = (/turf/simulated/wall/r_wall,/area/map_template/shelters_alt)
"ar" = (/obj/effect/decal/cleanable/dirt,/turf/simulated/wall/r_wall,/area/map_template/shelters_alt)
"as" = (/obj/effect/decal/cleanable/dirt,/obj/effect/decal/cleanable/dirt,/turf/simulated/wall/r_titanium,/area/map_template/shelters_alt)
"at" = (/obj/structure/railing/mapped{icon_state = "railing_preview"; dir = 4},/turf/unsimulated/floor/shuttle_ceiling,/area/template_noop)
"au" = (/obj/effect/floor_decal/techfloor/orange{icon_state = "techfloororange_edges"; dir = 9},/obj/structure/rubble/house,/turf/simulated/floor/tiled/techfloor/grid,/area/map_template/shelters_alt)
"av" = (/obj/effect/floor_decal/techfloor/orange{icon_state = "techfloororange_edges"; dir = 1},/obj/machinery/power/apc/alien{pixel_y = 27},/obj/structure/ore_box,/turf/simulated/floor/tiled/techfloor/grid,/area/map_template/shelters_alt)
"aw" = (/obj/effect/floor_decal/techfloor/orange{icon_state = "techfloororange_edges"; dir = 1},/obj/structure/lift/panel{pixel_y = 27},/turf/simulated/floor/tiled/techfloor/grid,/area/map_template/shelters_alt)
"ax" = (/obj/effect/floor_decal/techfloor/orange{icon_state = "techfloororange_edges"; dir = 1},/obj/structure/mattress/dirty,/turf/simulated/floor/tiled/techfloor/grid,/area/map_template/shelters_alt)
"ay" = (/obj/effect/floor_decal/techfloor/orange{icon_state = "techfloororange_edges"; dir = 5},/obj/effect/decal/cleanable/cobweb2,/obj/effect/decal/cleanable/dirt,/obj/random/junk,/turf/simulated/floor/tiled/techfloor/grid,/area/map_template/shelters_alt)
"az" = (/obj/effect/decal/cleanable/dirt,/obj/effect/decal/cleanable/dirt,/turf/simulated/wall/r_wall,/area/map_template/shelters_alt)
"aA" = (/obj/structure/railing/mapped{icon_state = "railing0-1"; dir = 8},/turf/unsimulated/floor/shuttle_ceiling,/area/template_noop)
"aB" = (/obj/effect/decal/cleanable/dirt,/obj/effect/decal/cleanable/dirt,/turf/unsimulated/floor/exoplanet/concrete,/area/template_noop)
"aC" = (/obj/effect/decal/cleanable/ash,/turf/unsimulated/floor/exoplanet/concrete/reinforced/road,/area/template_noop)
"aD" = (/obj/effect/floor_decal/techfloor/orange{icon_state = "techfloororange_edges"; dir = 8},/obj/effect/decal/cleanable/dirt,/obj/structure/rubble/house,/turf/simulated/floor/tiled/techfloor/grid,/area/map_template/shelters_alt)
"aE" = (/obj/effect/floor_decal/borderfloorblack/corner{dir = 4},/obj/effect/decal/cleanable/dirt,/turf/simulated/floor/tiled/techmaint,/area/map_template/shelters_alt)
"aF" = (/obj/effect/floor_decal/borderfloorblack{dir = 1},/obj/effect/decal/cleanable/dirt,/turf/simulated/floor/tiled/techmaint,/area/map_template/shelters_alt)
"aG" = (/obj/effect/floor_decal/borderfloorblack{dir = 5},/obj/effect/decal/cleanable/dirt,/turf/simulated/floor/tiled/techmaint,/area/map_template/shelters_alt)
"aH" = (/obj/effect/floor_decal/techfloor/orange{icon_state = "techfloororange_edges"; dir = 4},/obj/structure/rubble/house,/turf/simulated/floor/tiled/techfloor/grid,/area/map_template/shelters_alt)
"aI" = (/obj/effect/decal/cleanable/dirt,/turf/template_noop,/area/template_noop)
"aJ" = (/obj/effect/floor_decal/techfloor/orange{icon_state = "techfloororange_edges"; dir = 8},/obj/effect/decal/cleanable/dirt,/obj/effect/decal/cleanable/dirt,/obj/structure/closet/crate/large,/obj/random/loot,/obj/random/loot,/obj/random/junk,/obj/random/junk,/obj/random/junk,/obj/random/junk,/turf/simulated/floor/tiled/techfloor/grid,/area/map_template/shelters_alt)
"aK" = (/obj/effect/floor_decal/borderfloorblack{icon_state = "borderfloor_white"; dir = 8},/obj/effect/floor_decal/borderfloorblack/corner{dir = 4},/obj/effect/floor_decal/borderfloorblack/corner,/obj/effect/decal/cleanable/dirt,/obj/effect/decal/cleanable/dirt,/obj/effect/decal/cleanable/dirt,/turf/simulated/floor/tiled/techmaint,/area/map_template/shelters_alt)
"aL" = (/obj/effect/floor_decal/borderfloorblack,/obj/effect/floor_decal/borderfloorblack{dir = 1},/obj/effect/decal/cleanable/dirt,/obj/structure/rubble/house,/turf/simulated/floor/tiled/techmaint,/area/map_template/shelters_alt)
"aM" = (/obj/effect/floor_decal/borderfloorblack{dir = 4},/obj/effect/floor_decal/borderfloorblack/corner{icon_state = "borderfloorcorner_white"; dir = 1},/obj/effect/floor_decal/borderfloorblack/corner{icon_state = "borderfloorcorner_white"; dir = 8},/obj/effect/decal/cleanable/dirt,/obj/effect/decal/cleanable/dirt,/obj/structure/rubble/house,/turf/simulated/floor/tiled/techmaint,/area/map_template/shelters_alt)
"aN" = (/obj/effect/floor_decal/techfloor/orange{icon_state = "techfloororange_edges"; dir = 4},/turf/simulated/floor/tiled/techfloor/grid,/area/map_template/shelters_alt)
"aO" = (/obj/effect/decal/cleanable/dirt,/obj/structure/railing/mapped{icon_state = "railing0-1"; dir = 8},/turf/unsimulated/floor/shuttle_ceiling,/area/template_noop)
"aP" = (/obj/effect/decal/cleanable/dirt,/obj/structure/railing/mapped{icon_state = "railing_preview"; dir = 4},/turf/unsimulated/floor/shuttle_ceiling,/area/template_noop)
"aQ" = (/obj/effect/floor_decal/techfloor/orange{icon_state = "techfloororange_edges"; dir = 8},/obj/random/junk,/turf/simulated/floor/tiled/techfloor/grid,/area/map_template/shelters_alt)
"aR" = (/obj/effect/floor_decal/borderfloorblack{icon_state = "borderfloor_white"; dir = 10},/turf/simulated/floor/tiled/techmaint,/area/map_template/shelters_alt)
"aS" = (/obj/effect/floor_decal/borderfloorblack,/turf/simulated/floor/tiled/techmaint,/area/map_template/shelters_alt)
"aT" = (/obj/effect/floor_decal/borderfloorblack/corner{icon_state = "borderfloorcorner_white"; dir = 8},/obj/effect/decal/cleanable/dirt,/obj/structure/rubble/house,/turf/simulated/floor/tiled/techmaint,/area/map_template/shelters_alt)
"aU" = (/obj/effect/floor_decal/techfloor/orange{icon_state = "techfloororange_edges"; dir = 4},/obj/effect/decal/cleanable/dirt,/obj/random/junk,/turf/simulated/floor/tiled/techfloor/grid,/area/map_template/shelters_alt)
"aV" = (/obj/effect/floor_decal/techfloor/orange{icon_state = "techfloororange_edges"; dir = 10},/obj/structure/rubble/house,/turf/simulated/floor/tiled/techfloor/grid,/area/map_template/shelters_alt)
"aW" = (/obj/effect/floor_decal/techfloor/orange,/turf/simulated/floor/tiled/techfloor/grid,/area/map_template/shelters_alt)
"aX" = (/obj/effect/floor_decal/techfloor/orange,/obj/effect/decal/cleanable/dirt,/obj/effect/decal/cleanable/dirt,/obj/effect/decal/cleanable/dirt,/obj/random/junk,/obj/random/junk,/turf/simulated/floor/tiled/techfloor/grid,/area/map_template/shelters_alt)
"aY" = (/obj/effect/floor_decal/techfloor/orange,/obj/effect/decal/cleanable/dirt,/obj/effect/decal/cleanable/dirt,/turf/simulated/floor/tiled/techfloor/grid,/area/map_template/shelters_alt)
"aZ" = (/obj/effect/floor_decal/techfloor/orange{icon_state = "techfloororange_edges"; dir = 6},/obj/structure/ore_box,/turf/simulated/floor/tiled/techfloor/grid,/area/map_template/shelters_alt)
"ba" = (/obj/effect/decal/cleanable/ash,/obj/structure/railing/mapped{icon_state = "railing0-1"; dir = 8},/turf/unsimulated/floor/shuttle_ceiling,/area/template_noop)
"bb" = (/obj/effect/floor_decal/techfloor{dir = 1},/obj/effect/floor_decal/techfloor,/obj/machinery/door/airlock/external/bolted_open{icon_state = "open"},/turf/simulated/floor/tiled/techfloor/grid,/area/map_template/shelters_alt)
"bc" = (/obj/effect/floor_decal/techfloor{dir = 1},/obj/effect/floor_decal/techfloor,/obj/machinery/door/airlock/external/bolted,/turf/simulated/floor/tiled/techfloor/grid,/area/map_template/shelters_alt)
"bd" = (/obj/effect/decal/cleanable/dirt,/obj/effect/decal/cleanable/dirt,/obj/structure/rubble/house,/turf/unsimulated/floor/exoplanet/concrete/reinforced/road,/area/template_noop)
"be" = (/obj/structure/railing/mapped{icon_state = "railing_preview"; dir = 1},/turf/unsimulated/floor/shuttle_ceiling,/area/template_noop)
"bf" = (/turf/unsimulated/floor/shuttle_ceiling,/area/template_noop)
"bg" = (/obj/structure/rubble/house,/turf/unsimulated/floor/shuttle_ceiling,/area/template_noop)
"bh" = (/obj/structure/lift/button{pixel_y = 32},/obj/structure/rubble/house,/turf/unsimulated/floor/exoplanet/concrete,/area/template_noop)
"bi" = (/obj/effect/decal/cleanable/generic,/turf/unsimulated/floor/exoplanet/concrete,/area/template_noop)
"bj" = (/obj/effect/decal/cleanable/dirt,/obj/effect/decal/cleanable/dirt,/obj/structure/rubble/house,/turf/unsimulated/floor/exoplanet/concrete,/area/template_noop)
"bk" = (/obj/effect/decal/cleanable/dirt,/obj/structure/rubble/house,/turf/unsimulated/floor/exoplanet/concrete,/area/template_noop)

(1,1,1) = {"
aaaaaaaaaaaaaaaaabacadaeabaaaaaaaaaaaaaaaa
aaabafafababagababaeacacafababababaaaaafaa
aaabaeacaaaeaeahaiacaeadacaeaaaaaaaeaeafaa
aaafaeacaiaiajaeaeacacakacaeaaaeaeaeaeafaa
aaabaaacacacaiaiaeaeaeaeaiaeaeaeaaaeacabaa
aaabacaaaaabagabababababababababaeadaeabaa
aaabacaaaaabalamananaoananalalabaeadaeabaa
aaabaeaeapabamaqaqaqaqaraqaqasafacacaaabaa
agabaeaaaeabatarauavawaxayazaAaBacaeaeabab
aeaCacaeaeabataraDaEaFaGaHaraAafaeaaaeaead
acaeaIacaeabataqaJaKaLaMaNaqaOabacaeaeacae
aeacaeaaaiabaParaQaRaSaTaUaraOabacajaaaaaa
abafaeaaacagaParaVaWaXaYaZaqbaabaeacaiaaab
aaafaeaIacagalaqaqbbbcbcaqaqalabaibdaaabaa
aaafaiaaaeabamasbebfbgbgbealalabaaajaiabaa
aaabaaaaaeabagagafababagaabhaaabaeajaeabaa
aaabaaaeaeaiajacadaeaeaeaaaaapaaaeaeaeafaa
aaaaaeaaaeacajacaeaeaeaiadaeapapaeahaeabaa
aaaaaaaeaeadacacaiaeaaaeacajajaiaeacaeabaa
aaabafaBbiabababaaaaaaaeaaafbjafababababaa
aaaaaaaaaaaaaaaaabaaaaaabkaaaaaaaaaaaaaaaa
"}
